ぼ	戊	惚	牡	姆	坊	慕	呆	母	模	謨	姥	募	簿	菩	墓	暮	保	拇	暈
べ	邊	倍	部	辺	可	邉
ぶ	歩	撫	撲	葡	嘸	廡	部	憮	悔	舞	毋	侮	奉	蕪	分	振	武	錻	不	打	撃	蒲	無	誣
び	微	麋	毘	寐	濔	比	弭	眉	美	糜	縻	備	嵋	瀰	琵	引	未	贔	枇	糒	靡	鼻	媚	日	火	尾
ば	張	刃	刄	芭	場	塲	羽	馳	化	這	罵	婆	葉	馬	庭
ぼん	盆	煩	本	梵	凡
ぼろ	ボロ	襤褸
ぼり	堀
ぼら	鰡	鯔
ぼや	小火	暮夜
ぼふ	母父
ぼひ	墓碑
ぼば	牡馬
ぼつ	勃	沒	渤	没	歿
ぼっ	坊	沒	没
ぼち	墓地
ぼし	母趾	拇趾	母子	星	母指	墓誌	拇指
ぼご	母語
ぼこ	凹
ぼけ	惚け	木瓜
ぼく	撲	墨	瀑	僕	攵	目	牧	木	樸	朴	攴	濮	睦	卜	穆
ぼき	簿記
ぼか	簿価
ぼう	罔	惘	眸	芒	忙	榜	懋	亡	貿	瀑	茅	卯	黽	防	髦	膀	茫	暴	某	虻	坊	蠎	膨	謗	昴	呆	紡	暮雨	胞	帽	棒	甍	蒡	牟	滂	乏	茆	网	旁	貌	鉾	蟒	儚	妄	袤	望	傍	謀	瑁	旄	房	鋩	剖	氓	妨	尨	厖	冐	鵬	忘	肪	抱	冒
べん	鞭	眄	辨	辯	采	冕	娩	湎	宀	勉	汳	卞	瓣	便	弁	辮	辧	抃
べや	部屋
べふ	別府
べに	紅
べつ	別	蔑	韈	瞥	鼈	捌
べた	下手
べく	可
べき	汨	幎	覓	冪	羃	巾	冖
べえ	兵衛
べい	米
ぶん	蚊	文	馼	分	紊	聞
ぶろ	風呂
ぶり	鰤
ぶよ	蚋
ぶゆ	蚋
ぶび	武備
ぶひ	部費
ぶね	船
ぶな	椈	山毛欅	樗
ぶど	歩留
ぶと	太
ぶつ	仏	佛	勿	物
ぶち	鞭	斑	渕	渊	淵
ぶた	盖	豚	葢	蓋
ぶじ	無事	武事
ぶし	部誌	武士	節
ぶけ	武家
ぶぐ	武具
ぶく	伏
ぶぎ	武技	部議
ぶき	武器
ぶか	部科	部下	深	部課
ぶえ	笛
ぶい	武威	部位
びん	緡	岷	閔	罎	檳	愍	鬢	秤	壜	敏	梹	旻	頻	便	憫	泯	瓶	紊	貧
びわ	琵琶	枇杷
びろ	広
びら	開
びみ	美味
びぶ	尾部
びび	靡靡	微々
びと	人
びつ	謐
びた	鐚
びじ	美辞
びし	微視
びさ	微差
びく	比丘	魚篭	魚籠
びぎ	美妓	美技
びき	美姫	匹	引き	引
びか	美化
びう	微雨	眉宇
びい	微意
ばん	絆	番	万	晩	播	悗	幡	蕃	礬	鷭	鑁	判	坂	板	旙	旛	伴	輓	萬	阪	蠻	版	挽	盤	蛮	磐	塙
ばる	原
ばり	張り	針	罵詈
ばら	拂	払	原	薔薇
ばや	速	早
ばび	馬尾
ばば	馬場	婆
ばね	発条
ばな	鼻	離
ばつ	跋	×	末	閥	罰	拔	抜	魃	罸	伐	筏
ばっ	罰
ばち	罰	鉢	撥	枹	桴	罸
ばた	畑	端
ばし	走	橋
ばこ	箱
ばけ	化け	化
ばぐ	馬具
ばく	駁	瀑	博	暴	縛	幕	麦	漠	莫	獏	麥	爆	貘	驀	藐	寞	曝
ばか	莫迦	魅	馬鹿	許
ばう	芒
ばい	苺	倍	売	媒	黴	賣	陪	煤	吠	貝	唄	買	霾	培	梅	賠	焙	Ｂｙ	狽	憊	楳
ばあ	場当	婆
ぼんぷ	凡夫
ぼんち	盆地
ぼんだ	凡打
ぼんじ	梵字
ぼんご	梵語
ぼんぐ	凡愚
ぼんあ	盆明
ぼめい	墓銘
ぼへい	募兵
ぼはん	母斑
ぼどう	母堂
ぼてん	母点
ぼつご	没後	歿後
ぼつが	没我
ぼっき	勃起
ぼっか	牧歌
ぼだい	菩提
ぼたん	牡丹	釦	鈕
ぼたい	母胎	母体
ぼぜん	墓前
ぼせん	母線	母船
ぼせき	墓石
ぼせい	母星	母性
ぼすう	母数
ぼしん	戊辰
ぼしょ	墓所	簿書
ぼしき	母式
ぼざい	母材
ぼさん	墓参
ぼさつ	菩薩
ぼさい	募債
ぼこく	母国
ぼこう	母港	母校	母后
ぼけん	母権
ぼけつ	墓穴
ぼけい	母系	母型
ぼくら	僕ら	僕等
ぼくふ	牧夫
ぼくは	僕は
ぼくじ	墨字
ぼくし	牧師	墨子
ぼくが	墨画
ぼくか	墨家
ぼきん	募金
ぼがん	母岩
ぼがい	簿外
ぼかん	母管	母艦
ぼかい	暮改
ぼおん	母音
ぼうん	暮雲
ぼうり	暴利
ぼうよ	棒読
ぼうや	坊屋	坊や
ぼうぼ	亡母
ぼうふ	亡父	亡夫	防腐
ぼうび	防備	棒引
ぼうの	房野	坊野
ぼうと	暴徒
ぼうだ	棒立	滂沱
ぼうず	坊主	坊子
ぼうじ	亡児	房事	防磁
ぼうし	某氏	暴死	望祀	紡糸	亡姉	某紙	帽子	某誌	防止
ぼうさ	防砂
ぼうご	防護
ぼうこ	茫乎
ぼうぐ	防具
ぼうぎ	謀議
ぼうき	棒切
ぼうが	忘我
ぼうか	膨化	防火
ぼうう	暴雨
ぼうい	暴威
ぼいん	母音	拇印
ぼいき	墓域
べんり	弁理	便利
べんむ	弁務
べんぴ	便秘
べんち	弁知	胼胝
べんし	弁士
べんざ	便座
べんご	弁護
べんぎ	便宜
べんき	便器
べんい	便衣	便意
べみん	部民
べにこ	紅粉
べにお	紅緒
べにえ	紅絵
べとつ	べと付
べつり	別離
べつま	別間
べつふ	別布
べつに	別に
べつず	別図	別刷
べつじ	別辞	別字	別事
べつぎ	別儀
べつい	別異
べっぷ	別府
べっぱ	別派
べっと	別途
べっそ	別訴
べっし	蔑視	別使	別紙
べっこ	別個	別箇
べっけ	別家
べっき	別記
べたぬ	べた塗
べたつ	べた付
べえた	β
べいそ	米ソ
べいし	米紙
べいご	米語
べいか	米貨	米菓	米価
べーた	β
ぶんわ	文話
ぶんり	分離	分利	文理
ぶんよ	分与
ぶんや	分野
ぶんぼ	分母
ぶんぷ	分賦	分布
ぶんぶ	文武
ぶんぴ	分泌
ぶんび	文尾
ぶんぱ	分派	分波
ぶんは	分派
ぶんち	聞知	文治	分置
ぶんた	文太
ぶんじ	文辞	文事	文治	文二
ぶんし	分詞	分子	文士	分枝
ぶんご	文語	豊後
ぶんこ	文庫
ぶんけ	分家
ぶんぐ	文具
ぶんく	分区
ぶんぎ	分木	文義
ぶんき	分岐
ぶんか	文華	分果	文科	分化	分科	分課	文化
ぶんい	文意
ぶわり	歩割
ぶわけ	部分け
ぶれつ	武烈
ぶれい	無礼
ぶるい	部類
ぶらさ	ぶら下
ぶらく	部落
ぶらい	無頼
ぶよう	舞踊
ぶゆう	武勇
ぶもん	部門	武門
ぶめん	部面
ぶめい	部名	武名
ぶべつ	侮蔑
ぶへん	武辺
ぶぶん	部分
ぶびき	歩引き
ぶひん	部品
ぶにん	無人
ぶなん	無難	武南
ぶない	部内
ぶどま	歩留
ぶどう	葡萄	武道
ぶとう	舞踏	武闘
ぶでん	舞殿
ぶてい	武帝
ぶつり	物理
ぶつま	仏間
ぶつど	仏土
ぶつだ	仏陀
ぶつじ	仏事	仏寺
ぶつざ	仏座
ぶつご	仏語
ぶつぐ	物具	仏具
ぶつぎ	物議	ぶつ切
ぶつが	仏画
ぶっと	仏徒	打っ飛
ぶっだ	仏陀
ぶっそ	仏祖
ぶっし	仏子	仏師	物資
ぶっこ	ぶっ込	打っ込	物故
ぶっけ	仏家
ぶっか	物価
ぶちぎ	ブチ切
ぶちき	ブチ切
ぶちか	打ち噛
ぶちあ	打ち上
ぶだん	武断
ぶたい	舞台	部隊
ぶぞく	部族	部属
ぶそん	蕪村	武尊
ぶそく	不足
ぶそう	武装
ぶぜん	豊前	憮然
ぶぜい	無勢
ぶせい	部制
ぶすや	附子矢
ぶすう	部数
ぶすい	不粋	無粋
ぶじん	武人
ぶじに	無事に
ぶしょ	部所	部署
ぶしゅ	部首
ぶしや	付子矢
ぶしつ	部室
ぶざま	不様	無様
ぶざつ	蕪雑
ぶざい	部材
ぶさつ	撫擦
ぶさた	無沙汰	不沙汰
ぶさく	部作
ぶこつ	武骨	無骨
ぶこく	誣告
ぶこう	武功
ぶげん	侮言	分限	無限
ぶげい	武芸
ぶけん	武見
ぶくん	武勲
ぶくろ	袋
ぶきや	武器屋
ぶきみ	不気味
ぶきこ	武器庫
ぶきか	武器化
ぶがく	舞楽
ぶがい	部外
ぶかん	武漢	武鑑	武官
ぶかつ	部活
ぶかい	部会
ぶうん	武運
ぶいん	部員	無音
ぶいち	武一
ぶいく	撫育
ぶあつ	分厚	ぶ厚	部厚
ぶあく	武悪
ぶあい	部合	歩合
びんし	鬢糸
びんご	備後
びんぎ	便宜
びんが	頻伽
びわこ	琵琶湖
びわき	琵琶記
びろく	美禄	微禄
びろう	尾籠
びれい	美麗	靡麗
びるま	緬甸
びらん	糜爛
びらき	開き
びより	日和
びよく	尾翼	鼻翼
びよう	美容
びょう	錨	秒	渺	猫	平	票	憑	緲	描	屏	鋲	″	苗	病	杪	眇	藐	廟
びゅう	繆	謬
びやく	媚薬
びゃく	闢	百	辟	帛	白
びもく	眉目
びめい	美名
びまん	瀰漫	靡曼
びぼう	備忘	美貌
びほん	美本
びほろ	美幌
びほう	備砲	彌縫	弥縫
びへい	靡敝	尾柄
びぶん	微分	美文
びふく	微服
びふか	美深
びふえ	美笛
びふう	微風	美風
びびる	ビビる
びひん	美品	備品
びばい	美唄
びはつ	美髪
びはく	美白	靡薄
びねつ	微熱
びなん	美男
びどう	微動	美童
びとく	美徳
びとう	尾灯	尾藤	微糖
びでん	美田
びてん	美点
びてき	美的
びっこ	跛
びちく	備蓄
びだん	美談
びだい	尾大
びたい	媚態
びぞく	美俗
びぞう	微増
びそく	尾側	微速
びそう	美装
びぜん	靡然	備前	美髯
びせん	美泉
びせつ	微雪
びせき	微積
びせい	美星	美声
びすい	微睡	微酔
びじん	美人
びじょ	美女
びじく	糜竺
びしん	美身	微震	美神
びしゅ	美酒
びしつ	美質
びざい	微罪
びさん	靡散
びさい	微細	尾西
びこん	鼻根
びこつ	尾骨
びこう	微光	備荒	尾行	鼻孔	微香	微行	鼻腔	備考
びげん	微減	美言
びけい	美形	美景
びくん	微醺
びくに	比丘尼
びくう	鼻腔
びぎん	微吟
びきょ	美挙
びがん	美顔
びがく	美学
びかん	美観	美感
びおん	微温	美音	微音	鼻音
びえん	鼻炎
びえい	美瑛
びいん	鼻音
びーる	麦酒
ばんり	萬里	万里
ばんや	番屋
ばんめ	番目
ばんば	番場	輓馬	馬場
ばんの	番野	坂野	伴野
ばんて	番手
ばんち	番値	番地	蕃地
ばんだ	万朶
ばんじ	万事
ばんし	万死
ばんご	番後
ばんこ	萬古	盤古	万古	万戸
ばんぎ	板木
ばんき	万機	晩期
ばんか	晩夏	蕃茄	晩歌	挽歌
ばれん	馬連
ばれい	馬齢
ばりき	馬力
ばらま	ばら撒	散蒔
ばらき	原木
ばらか	バラ科
ばやし	林
ばめん	場面
ばめい	馬名
ばぼう	馬房
ばふん	馬糞
ばふだ	場札
ばひつ	馬匹
ばぬし	馬主
ばにく	馬肉
ばなれ	場慣れ	場馴れ	離れ
ばなし	話
ばなか	場中
ばとう	罵倒	馬頭
ばてい	馬蹄	馬丁
ばつだ	罰打
ばつご	跋語
ばっぷ	罰符
ばった	飛蝗
ばっし	抜糸	末子	抜歯
ばっこ	跋扈
ばっき	曝気
ばっか	幕下	麦価
ばちが	場違
ばだい	場代
ばたら	働
ばたや	ばた屋
ばたけ	畑	畠
ばたい	馬体
ばぞく	馬賊	馬族
ばそり	馬橇
ばせん	場銭
ばせき	場席
ばせい	罵声
ばすえ	場末
ばしん	馬身
ばしら	柱
ばしょ	場所
ばしゅ	馬主	馬首
ばしゃ	馬車
ばさん	馬産
ばさら	伐折羅	婆娑羅
ばさし	馬刺し	馬刺
ばげん	罵言
ばけん	馬券
ばぐん	馬群
ばくろ	暴露	曝露
ばくふ	瀑布	幕府
ばくは	爆破
ばくと	博徒
ばくち	博奕	博打	驀地
ばくし	爆死
ばくぎ	博戯
ばくが	麦芽
ばくか	幕下
ばきん	馬琴
ばかん	馬関	馬韓
ばかり	許	許り
ばかよ	馬鹿呼
ばかね	馬鹿値
ばかず	場数
ばかく	馬格
ばいち	培地
ばいた	売女
ばいか	倍化	売価	買価	梅花	倍加
ばいう	梅雨
ばあや	婆や
ばあい	場合
ぼんりょ	凡慮
ぼんよう	凡庸
ぼんみす	凡ミス
ぼんぺい	凡平
ぼんべい	孟買
ぼんぶん	梵文
ぼんのう	煩悩
ぼんてん	梵天
ぼんだて	盆点
ぼんたん	文旦
ぼんたい	凡退
ぼんぞく	凡俗
ぼんそう	凡走
ぼんせん	凡戦
ぼんせき	盆石
ぼんじん	凡人
ぼんしゅ	凡手
ぼんしつ	凡失
ぼんさく	凡作	凡策
ぼんさい	凡才	盆栽
ぼんこつ	凡骨
ぼんけい	盆景
ぼんくれ	盆暮	盆暮れ
ぼんくら	盆暗
ぼんおど	盆踊
ぼろまけ	ぼろ負け	ボロ負け
ぼろくず	ボロ屑
ぼりょう	墓陵
ぼひょう	墓標
ぼひめい	墓碑名	墓碑銘
ぼにゅう	母乳
ぼつらく	没落
ぼつめつ	没滅
ぼつねん	歿年	没年
ぼつぜん	勃然
ぼっぱつ	勃発
ぼっとう	没頭
ぼっしょ	没書
ぼっしゅ	没取
ぼっこん	墨痕
ぼっこう	勃興
ぼっかく	墨客
ぼっかい	渤海
ぼだいじ	菩提寺
ぼたんか	ボタン科	Paeoniaceae
ぼたゆき	ぼた雪
ぼたやま	ぼた山
ぼたもち	牡丹餅
ぼすざる	ボス猿
ぼじょう	慕情
ぼしょく	暮色
ぼしょう	暮鐘
ぼしゅん	暮春
ぼしゅう	募集	暮秋
ぼしづれ	母子連れ
ぼこくご	母国語
ぼくよう	牧羊
ぼくめつ	撲滅
ぼくどう	牧童
ぼくとつ	朴訥
ぼくとう	墨東	木刀
ぼくてき	牧笛
ぼくちく	牧畜	木竹
ぼくたち	僕達
ぼくたく	木鐸
ぼくそう	牧草
ぼくぜい	卜筮
ぼくせん	卜占
ぼくせき	木石
ぼくすい	牧水	墨水
ぼくじん	牧人
ぼくしん	牧神
ぼくしょ	墨書
ぼくしゅ	墨守
ぼくしゃ	卜者	牧舎
ぼくさつ	撲殺
ぼくこう	墨攻
ぼくあて	僕宛
ぼきしき	簿記式
ぼうろん	傍論	暴論
ぼうろう	望楼
ぼうれい	亡霊	暴戻
ぼうらく	暴落
ぼうよみ	棒読み	棒読
ぼうよう	望洋	茫洋	滂洋
ぼうゆう	亡友	暴勇
ぼうもう	紡毛
ぼうめい	亡命
ぼうみん	暴民
ぼうまん	暴慢
ぼうまい	茫昧	亡妹
ぼうぼう	某々	茫茫	茫々
ぼうへき	防壁
ぼうふう	暴風	防風
ぼうびき	棒引き
ぼうひと	某人
ぼうばく	茫漠
ぼうはん	謀判	防犯
ぼうはつ	暴発
ぼうはく	傍白
ぼうはい	暴牌
ぼうのつ	坊津
ぼうねん	忘年
ぼうどく	防毒
ぼうどう	暴動
ぼうとく	冒涜
ぼうとう	暴騰	暴投	冒頭
ぼうてん	傍点	某店
ぼうてつ	耄耋
ぼうてい	亡弟
ぼうだん	防弾
ぼうだら	棒鱈
ぼうだち	棒立ち
ぼうだい	某大	防大	厖大	膨大	尨大	傍題
ぼうたて	棒立て
ぼうそう	房総	暴走
ぼうぜん	茫然	惘然	呆然
ぼうせん	防戦	傍線	棒線
ぼうせつ	防雪
ぼうせき	紡績
ぼうせい	防錆	暴政
ぼうすじ	某筋
ぼうすい	防水	紡錘
ぼうじん	防塵
ぼうじょ	防除
ぼうじゅ	傍受
ぼうじま	棒縞
ぼうじつ	某日
ぼうしん	傍心	冒進	防振
ぼうしょ	防暑	某所
ぼうしゅ	芒種	忙種
ぼうしや	帽子屋
ぼうしゃ	某社
ぼうしつ	房室	亡失	忘失	防湿
ぼうさん	坊さん
ぼうさま	坊様
ぼうさつ	謀殺	忙殺
ぼうさき	棒先
ぼうさい	亡妻	防災
ぼうこん	亡魂
ぼうこく	坊刻	某国	亡國	亡国
ぼうこう	暴行	膀胱
ぼうげん	妄言	暴言
ぼうげつ	某月
ぼうけん	望見	剖検	冒険	傍見
ぼうけい	謀計	傍系	亡兄
ぼうぐみ	棒組
ぼうくん	亡君	傍訓	暴君	某君
ぼうくう	防空
ぼうぎん	棒銀
ぼうぎょ	防禦	防御
ぼうきれ	棒切れ
ぼうきょ	暴挙
ぼうきじ	某記事
ぼうがい	妨害	望外
ぼうかん	傍観	防寒	暴漢	坊間	望観
ぼうおん	忘恩	防音
ぼうおく	茅屋
ぼうえん	望遠	防炎	防煙
ぼうえき	某駅	防疫	貿易
ぼうえい	防衛
ぼういん	暴飲
ぼうあつ	暴圧
ぼうあく	暴悪
ぼいんぶ	母音部
ぼいんじ	母音字
べんろん	弁論
べんれい	勉励
べんりや	便利屋
べんりし	弁理士
べんらん	便覧
べんもう	鞭毛
べんめい	弁明
べんまく	弁膜
べんぽう	便法
べんべん	便々
べんべつ	弁別
べんぱつ	辮髪	弁髪
べんばく	弁駁
べんなん	弁難
べんとう	弁当
べんてん	弁天
べんつう	便通
べんたつ	鞭撻
べんぞう	勉三
べんぜつ	弁舌
べんじょ	便所
べんしつ	弁室
べんしき	弁識
べんさい	弁済	弁才
べんごし	弁護士
べんこう	弁口	弁巧
べんげい	眄睨
べんけい	弁慶
べんがく	勉学
べんかん	弁韓	弁官	冕冠
べんかい	弁解
べんえき	便益
べるりん	伯林
べるけん	ベル研
べるぎー	白耳義
べらぼう	篦棒	箆棒
べにまる	紅丸
べにふで	紅筆
べにばな	紅花
べにはぎ	紅萩
べにづる	紅鶴
べにざら	紅皿
べにざけ	紅鮭
べにがら	紅殻
べにいろ	紅色
べつわく	別枠
べつろく	別録
べつるい	別涙
べつよう	別様
べつやく	別役
べつもの	別物
べつもじ	別文字
べつめん	別面
べつめい	別名	別命
べつむね	別棟
べつみや	別宮
べつべや	別部屋
べつべつ	別々
べつびん	別便
べつばら	別腹
べつばい	別売
べつのう	別納
べつどり	別録り
べつでん	別伝
べつだん	別段
べつだい	別大
べつずり	別刷り	別刷
べつすじ	別筋
べつじん	別人
べつじょ	蔑如
べつこう	別稿
べつげん	別言
べつくち	別口
べつきじ	別記事
べつかい	別海
べつえん	別宴
べつうり	別売り	別売
べついん	別院
べつあん	別案
べっぽん	別本
べっぽう	別報	別法
べっぷう	別封
べっぴん	別嬪	別品
べっとう	別当
べってん	別添
べってい	別邸	別定
べっちん	別珍
べったく	別宅
べったい	別体
べっそう	別荘	別送
べっせん	別線
べっせつ	別節
べっせき	別席
べっせい	別姓	別製
べっしょ	別所
べっしゅ	別種
べっしつ	別室
べっさつ	別冊
べっこん	別懇
べっこう	別項	別敲	鼈甲
べっけん	瞥見	別件
べっけい	別掲
べっきょ	別居
べっかん	別館	別巻
べっかく	別格
べっかい	別解
べたゆき	べた雪
べたぼれ	べた惚れ
べたぼめ	べた褒め	べた賞め
べたぬり	ベタ塗り	べた塗り
べたなぎ	べた凪
べたぐみ	べた組み
べきすう	冪数
べいべつ	袂別
べいへい	米兵
べいふん	米粉
べいばく	米麦
べいはん	米飯
べいどる	米ドル
べいてい	米帝
べいじん	米人
べいじゅ	米寿
べいしゃ	米車
べいさん	米産
べいさく	米作
べいごま	貝独楽
べいこく	米国	米穀
べいぐん	米軍
べいがわ	米側
べいえい	米英
べーたは	β波
ぶんろく	文禄
ぶんれつ	分列	分裂
ぶんれい	分霊	文例
ぶんるい	分類
ぶんりは	分離派
ぶんりど	分離度
ぶんりつ	分立	分率
ぶんりき	分離機	分離器
ぶんりか	分離果
ぶんらん	紊乱
ぶんらく	文楽
ぶんよう	文葉
ぶんゆう	分有
ぶんめん	文面
ぶんめい	文名	文明	分明
ぶんみん	文民
ぶんまつ	文末
ぶんぽう	文法	分封
ぶんぺい	文平
ぶんべん	分娩
ぶんべつ	分別
ぶんぷず	分布図
ぶんぶつ	文物
ぶんぴつ	文筆	分筆	分泌
ぶんぱん	文範
ぶんぱき	分波器
ぶんぱい	分配
ぶんばい	分売
ぶんのう	分納
ぶんにん	分任
ぶんどき	分度器
ぶんとん	分屯
ぶんとう	文頭
ぶんでん	分電
ぶんてん	分店	分点	文典	文展
ぶんつう	文通
ぶんちん	文珍	文鎮
ぶんだん	分断	文壇	分団
ぶんだい	分大	文題
ぶんたん	文旦	分担
ぶんたい	分隊	文体
ぶんそん	分村	分損
ぶんそう	文藻	分奏
ぶんせん	文選
ぶんせつ	分節	文節
ぶんせき	文責	分析
ぶんせい	文勢	文政
ぶんすう	分数
ぶんすい	分水
ぶんじん	文人
ぶんしん	分身	文身
ぶんしょ	文書	分署	分所
ぶんしゃ	分社
ぶんしつ	分室
ぶんざい	分際
ぶんさん	分散
ぶんさつ	分冊
ぶんさく	文作
ぶんさい	文才
ぶんごし	文語詩
ぶんごう	文豪	分合
ぶんこつ	分骨
ぶんこか	文庫化
ぶんこう	分校	分光
ぶんげん	分限	文言
ぶんげい	文藝	文芸
ぶんけん	分遣	分権	文献	文検
ぶんけい	文型	文系
ぶんきん	分近
ぶんきぶ	分岐部
ぶんきひ	分岐比
ぶんきき	分岐器
ぶんがく	文学	文學
ぶんがい	分外
ぶんかん	文官	分館
ぶんかぶ	文化部
ぶんかつ	分割
ぶんかし	文化史	文化誌
ぶんかさ	文化差
ぶんかく	文革	分画
ぶんかい	分界	分会	分解
ぶんおう	文応
ぶんえん	分煙	分園
ぶんえい	文永
ぶんいん	分院
ぶんいち	文一
ぶんいき	分域
ぶんあん	文安	文案
ぶんあつ	分圧
ぶりょく	武力
ぶりょう	無聊
ぶりゃく	武略
ぶりっこ	ぶりっ子
ぶりかえ	ぶり返
ぶらじる	伯剌西爾
ぶようか	舞踊家
ぶもんひ	部門費
ぶぶんわ	部分和
ぶぶんし	部分枝
ぶぶんぎ	部分木
ぶひんや	部品屋
ぶひんと	部品取
ぶひんか	部品化
ぶなもく	Fagales	ブナ目
ぶどまり	歩留まり	歩留り
ぶどうか	武道家	ブドウ科
ぶとうか	武闘家	舞踏家
ぶつりや	物理屋
ぶつりぶ	物理部
ぶつりき	仏力
ぶつりか	物理科
ぶつよく	物欲
ぶつもん	仏門
ぶつもう	勿罔
ぶつめつ	仏滅
ぶつぶつ	勿勿	物々
ぶつのう	物納
ぶつどう	仏堂	仏道
ぶつでん	仏殿	仏伝
ぶつでし	仏弟子
ぶつだん	仏壇
ぶつだい	仏大
ぶつぞう	仏像
ぶつぜん	仏前
ぶつざん	仏山
ぶつぎり	ぶつ切り
ぶつきつ	勿吉
ぶつがん	仏願	仏龕
ぶつがく	仏学
ぶつおん	仏恩
ぶつえん	仏縁
ぶっぽう	仏法
ぶっぴん	物品
ぶっぱん	物販
ぶっとう	仏塔
ぶってん	仏典
ぶってき	物的
ぶったぎ	ぶった斬	打っ手切	ぶった切
ぶったい	物体	仏体
ぶっそん	物損
ぶっそう	仏葬	物騒
ぶっせつ	仏説
ぶっせい	物性	仏性
ぶっしん	物心	仏心	物神	仏身
ぶっしょ	仏書
ぶっしつ	物質
ぶっしき	仏式
ぶっさん	仏参	物産
ぶっさつ	仏刹
ぶっこわ	ぶっ壊
ぶっころ	打っ殺	ぶっ殺	ブッ殺
ぶっこく	仏国
ぶっこう	物工
ぶっけん	物件	物権	物研
ぶっかく	物覚	仏閣
ぶっかき	打っ欠き
ぶっかい	物界	仏界
ぶちょう	部長
ぶちぎれ	ブチ切れ
ぶだいか	舞台化
ぶたばこ	豚箱
ぶたにく	豚肉
ぶたどん	豚丼
ぶたたま	豚玉
ぶたじる	豚汁
ぶたごや	豚小屋
ぶたいか	舞台化
ぶすじま	毒島
ぶじょく	侮辱
ぶじゅん	撫順
ぶじゅつ	撫恤	武術
ぶじうご	無事動
ぶしょう	無精	武将	不精
ぶしどう	武士道
ぶしつけ	不しつけ	不躾
ぶさほう	無作法	不作法
ぶさいく	不細工
ぶけさま	武家様
ぶけがた	武家方
ぶぎょう	奉行
ぶきるい	武器類
ぶきよう	不器用
ぶきょく	舞曲	部局
ぶきてん	武器店
ぶがいひ	部外秘
ぶかめい	部課名
ぶかたち	部下達
ぶおんぷ	分音符
ぶおんな	醜女
ぶおとこ	醜男
ぶあつい	ぶ厚い
ぶあいそ	不愛想	無愛想
びんわん	敏腕
びんらん	紊乱	便覧
びんめい	便名
びんぼう	貧乏
びんほう	便法
びんづめ	瓶詰め	瓶詰
びんだい	瓶代
びんそく	敏速
びんぜん	愍然
びんせん	便箋	便船
びんずる	賓頭盧
びんすう	便数
びんさつ	憫察
びんぐし	鬢櫛
びんかん	敏感
びんかつ	敏活
びんいれ	瓶入
びわじま	枇杷島
びろうど	天鵞絨
びろーど	天鵞絨
びるまご	ビルマ語
びりょく	微力
びりょう	微量	鼻梁
びりゅう	微粒
びようし	美容師
びょうり	病理
びょうよ	秒読
びょうま	病魔
びょうぶ	屏風	廟風	病部
びょうは	描破
びょうち	錨地
びょうし	病死	拍子	病誌	表紙
びょうさ	秒差
びょうご	秒後	病後
びょうく	病苦	病躯
びょうき	病気	病期
びょうが	描畫	描画	病臥
びょうか	病家
びょうう	鋲打
びゃっこ	白狐	白虎
びゃくや	白夜
びゃくえ	白衣
びゃくい	白衣
びみょう	美妙	微妙
びぼいん	鼻母音
びぶんき	微分器
びふうじ	微風時
びびたる	微々たる
びひんひ	備品費
びにゅう	微乳	美乳
びなんし	美男子
びっくり	吃驚	！
びちょう	微調
びちゅう	微衷
びだんし	美男子
びたせん	鐚銭
びすます	Bismuth	Bi
びじょぎ	美女木
びじょう	尾錠
びじゅつ	美術
びじゅう	鼻汁
びじゃく	微弱
びしょく	美食
びしょう	微笑	美称	微少	微傷	微小	媚笑	美粧
びしゅく	糜粥
びしゅう	美醜	尾州
びしてき	微視的
びさいか	微細化
びきょう	鼻鏡
びきゅう	備給
びきゃく	美脚
びがんき	美顔器
びおんか	鼻音化
びいんか	鼻音化
びいしき	美意識
びーふん	米粉
びーだま	ビー玉
ばんらい	万雷
ばんゆう	蛮勇	万有
ばんもく	万目
ばんめん	盤面
ばんめし	晩飯
ばんみん	万民
ばんぺい	番兵
ばんべつ	万別
ばんぷく	万福
ばんぷう	蛮風
ばんぶつ	万物
ばんぱん	万般
ばんぱく	万博
ばんのう	万能
ばんねん	晩年
ばんにん	番人	万人
ばんなん	万難
ばんない	坂内	判内
ばんどう	坂東	阪東
ばんとう	晩唐	晩冬	番頭	蛮刀	晩稲
ばんづけ	番付
ばんちゃ	番茶
ばんだい	番代	番台	万代	磐梯
ばんたん	万端	盤端	播但
ばんたい	万態
ばんぞく	蛮族
ばんそつ	番卒
ばんそう	伴奏	晩霜	伴走
ばんぜん	万全
ばんせん	番線	番宣
ばんせつ	晩節
ばんせい	晩生	蛮声	万世	晩成	伴星
ばんすう	番数
ばんすい	晩翠
ばんじん	蛮人	万人
ばんじょ	磐女
ばんしょ	番所	板書
ばんしゃ	万謝
ばんしつ	盤質
ばんざい	万歳
ばんさん	晩餐
ばんさく	万策
ばんさい	磐西
ばんごや	番小屋
ばんごう	番号
ばんこん	盤根	晩婚
ばんこつ	蛮骨	万骨
ばんこく	盤谷	万斛	万国
ばんこう	蛮行	磐高
ばんけん	番犬
ばんけい	晩景
ばんぐみ	番組
ばんくる	番狂
ばんくみ	版組
ばんぎく	晩菊
ばんきん	鈑金	板金
ばんきょ	蟠踞
ばんがた	晩方
ばんがく	晩学
ばんがい	番街	番外
ばんかん	万感
ばんかず	番数
ばんかい	挽回
ばんえつ	磐越
ばるかん	巴爾幹
ばりきさ	馬力差
ばりうむ	Ba	Barium
ばらもん	婆羅門
ばらもく	Rosales	バラ目
ばらにく	バラ肉
ばらぞく	薔薇族
ばらうり	散売り	バラ売り	ばら売り
ばらいろ	薔薇色
ばふんし	馬糞紙
ばばない	馬場内
ばばじる	婆汁
ばばさき	馬場先
ばばぐち	馬場口
ばとうご	罵倒語
ばてれん	伴天連
ばつよう	末葉
ばつぼく	伐木
ばつぶん	跋文
ばつばつ	××
ばつたい	罰退
ばつぞく	閥族
ばつぐん	抜群
ばつえい	末裔
ばっぽん	抜本
ばっとう	伐倒	抜刀
ばってん	罰点
ばってき	抜てき	抜擢
ばってい	末弟
ばったい	罰退
ばっそん	末孫
ばっそく	罰則
ばっせん	抜染
ばっせき	末席
ばっすい	抜粋	抜萃
ばっしじ	抜歯時
ばっさつ	抜刷
ばっさい	伐採	伐裁
ばっけん	抜剣
ばっきん	罰金
ばっきょ	抜去
ばっかん	麦稈
ばっかく	麦角	幕閣
ばちゅう	馬柱
ばちがい	場違い
ばたくさ	バタ臭
ばすはば	バス幅
ばすてい	バス停
ばじょう	馬乗	馬上
ばじゅつ	馬術
ばしょく	馬謖	馬食
ばしょう	芭蕉
ばしゃく	馬借
ばさんち	馬産地
ばけもの	化物	化け物
ばけねこ	化猫	化け猫
ばけがく	化学
ばけかた	化け方
ばくろん	駁論
ばくろう	博労	馬喰	伯楽	伯労
ばくれつ	爆裂
ばくらい	爆雷
ばくやく	爆薬
ばくまつ	幕末
ばくふう	爆風
ばくはん	麦飯
ばくはつ	爆発
ばくちん	爆沈
ばくちく	爆竹
ばくだん	爆弾	爆彈
ばくだい	莫大
ばくそう	爆装	爆走	麦草
ばくぜん	漠然	驀然
ばくせん	瀑泉
ばくせつ	駁説
ばくせい	幕政
ばくすい	爆睡
ばくしん	爆心	爆進	驀進	幕臣
ばくしょ	曝書
ばくしゃ	幕舎
ばくさつ	爆殺
ばくさい	爆砕	博才
ばくげき	駁撃	爆撃
ばくおん	爆音
ばくえん	爆炎
ばくえき	博奕
ばくえい	幕営
ばぎょう	ば行	バ行
ばきゃく	馬脚
ばかやす	馬鹿安
ばかもの	馬鹿者
ばかばか	馬鹿馬鹿
ばかとの	馬鹿殿
ばかづら	馬鹿面
ばかたれ	馬鹿たれ
ばかくさ	馬鹿臭
ばかがい	馬鹿貝
ばいりん	梅林
ばいりつ	倍率
ばいよう	培養
ばいゆう	培雄
ばいやく	売薬	売約
ばいめい	売名
ばいまん	倍満
ばいぼく	売卜
ばいぶん	売文
ばいひん	売品
ばいばら	莪原
ばいばい	倍々	売買
ばいはば	倍幅
ばいにん	売人
ばいにく	梅肉
ばいどく	梅毒
ばいてん	売店
ばいちか	倍近
ばいだい	倍大
ばいたい	媒体
ばいぞう	倍増
ばいそく	倍速
ばいせん	煤煎	媒染	焙煎
ばいせき	陪席
ばいせい	媒精
ばいすう	倍数
ばいじん	煤塵
ばいしん	陪臣	陪審
ばいしつ	媒質
ばいざい	媒材
ばいごま	貝独楽
ばいごう	媒合
ばいこく	売国
ばいけん	買券
ばいけつ	売血
ばいきん	黴菌
ばいがく	倍額
ばいかん	陪観	売勘
ばいかく	倍角
ばいかい	媒介
ばいおん	倍音
ばいえん	煤煙	梅園
ばいいん	売淫
ばあたり	場当り	場当たり
ばあさん	婆さん
ばあさま	婆様
ばあいわ	場合分
ぼんやすみ	盆休み
ぼんぴゃく	凡百
ぼんしょう	梵鐘	凡小
ぼんおどり	盆踊り	盆踊
ぼろもうけ	ぼろ儲け	ボロ儲け
ぼへいきん	母平均
ぼぶんさん	母分散
ぼてんたい	母天体
ぼつにゅう	没入
ぼつこせい	没個性
ぼっちゃん	坊っちゃん	坊ちゃん
ぼっしゅみ	没趣味
ぼっしゅう	没収
ぼっこせい	没個性
ぼっこうき	勃興期
ぼっきょう	木強
ぼっきゃく	没却
ぼっかてき	牧歌的
ぼだいじゅ	菩提樹
ぼたんもく	Paeoniales	ボタン目
ぼたんなべ	牡丹鍋
ぼたんこう	牡丹江
ぼたいない	母体内
ぼせいてき	母性的
ぼせいあい	母性愛
ぼしりょう	母子寮
ぼしかてい	母子家庭
ぼごわしゃ	母語話者
ぼごいがい	母語以外
ぼけんせい	母権制
ぼくひとり	僕一人
ぼくにょう	攴繞
ぼくそうち	牧草地
ぼくじょう	牧場	卜定
ぼくじゅう	墨汁
ぼくじしん	僕自身
ぼくしょく	墨色
ぼくこじん	僕個人
ぼくぎゅう	牧牛
ぼくいがい	僕以外
ぼきんがく	募金額
ぼかんない	母艦内
ぼかんすう	母関数
ぼうりょく	暴力
ぼうりょう	坊領
ぼうりゅう	傍流
ぼうりゃく	謀略
ぼうふざい	防腐剤
ぼうふうう	暴風雨
ぼうひょう	暴評
ぼうはてい	防波堤
ぼうにょう	乏尿
ぼうでんき	某電器
ぼうちょう	膨張	傍聴	防長	膨脹	防潮	防諜
ぼうちゅう	傍注	防虫	忙中
ぼうたおし	棒倒し
ぼうすいふ	防水布
ぼうじょう	暴状	坊城	棒状
ぼうじゅつ	棒術
ぼうしよう	防止用
ぼうしょく	暴食	望蜀	紡織
ぼうしょう	帽章	傍証
ぼうしゅく	防縮
ぼうしゅう	房州	防臭
ぼうしほう	防止法
ぼうしそう	防止層
ぼうしざい	防止剤
ぼうしさく	防止作	防止策
ぼうざっし	某雑誌
ぼうさりん	防砂林
ぼうさっか	某作家
ぼうごへき	防護壁
ぼうごてん	防護点
ぼうけんき	冒険記
ぼうけんか	冒険家
ぼうぐらふ	棒グラフ
ぼうぎょじ	防御時
ぼうぎょご	防御後
ぼうぎゃく	暴虐
ぼうきょく	某局
ぼうきょう	防共	望郷
ぼうきゃく	忘却
ぼうがしら	棒頭
ぼうかんぐ	防寒具
ぼうかんぎ	防寒着
ぼうかへき	防火壁
ぼうかふく	防火服
ぼうかでん	某家電
ぼうえいひ	防衛費
ぼうあんき	棒暗記
ぼいんかん	母音間
ぼいどりつ	ボイド率
ぼーるばん	ボール盤
ぼーるばこ	ボール箱
ぼーるがみ	ボール紙
ぼーりうむ	Bohrium	Bh
べんりゅう	冕旒
べんりひん	便利品
べんむかん	弁務官
べんぴやく	便秘薬
べんとうや	弁当屋
べんちゅう	鞭虫
べんしょう	弁償
べんしゅつ	娩出
べんごにん	弁護人
べんごだん	弁護団
べんごがわ	弁護側
べんぎてき	便宜的
べんぎそち	便宜措置
べんきょう	勉強
べりりうむ	Beryllium	Be
べふちょう	別府町
べびーよう	ベビー用
べにやいた	ベニヤ板
べにばやし	紅林
べにばなゆ	紅花油
べにじゃけ	紅鮭
べにしゃけ	紅鮭
べにうこん	紅鬱金
べとなむご	ベトナム語
べつろせん	別路線
べつようそ	別要素
べつみょう	別名
べつぶんや	別分野
べつそしき	別組織
べつせかい	別世界
べつじょう	別状	別条
べつじげん	別次元
べつしょり	別処理
べつしほん	別資本
べつけいろ	別経路
べつけいゆ	別経由
べつぎょう	別業
べつきかく	別規格
べつかんり	別管理
べつかいひ	別会費
べついけん	別意見
べつあつか	別扱
べっぴょう	別表
べっとうや	別当家
べってんち	別天地
べっちゅう	別注
べっちゃく	別役
べっそうち	別荘地
べっせかい	別世界
べっしょう	別証	別称	蔑称
べっしゅう	別集
べっしやま	別子山
べすとばん	ベスト盤
べくとるち	ベクトル値
べくとるか	ベクトル化
べきじょう	羃乗	冪乗	べき乗	巾乗
べいちょう	米朝
べいちゅう	米駐
べいせいふ	米政府
べいしょく	米食
べいしゅん	米春
べいしゅう	米収
べいさんち	米産地
べいこくご	米国語
べいぐんき	米軍機
べいくうぼ	米空母
べいぎかい	米議会
べいえいが	米映画
べーたばん	β版
べーたせん	β線
ぶんれつか	分裂果
ぶんるいぎ	分類木
ぶんるいき	分類器
ぶんるいか	分類化
ぶんりよう	分離用
ぶんりょう	分量	分領
ぶんりゅう	分流	分留	分溜
ぶんりもじ	分離文字
ぶんりまえ	分離前
ぶんりのう	分離脳
ぶんりだい	文理大
ぶんりたい	分離帯
ぶんりせい	分離性
ぶんりすう	分離数
ぶんりがた	分離型
ぶんりあん	分離案
ぶんらくざ	文楽座
ぶんやめい	分野名
ぶんやべつ	分野別
ぶんやがい	分野外
ぶんやかん	分野間
ぶんめいし	文明史
ぶんめいか	文明化
ぶんみゃく	文脈
ぶんぽうか	文法化
ぶんぼうぐ	文房具
ぶんぴぶつ	分泌物
ぶんぴつか	文筆家
ぶんぱいひ	分配比
ぶんぱいき	分配器
ぶんのいち	分の１
ぶんちょう	文鳥	文調
ぶんちゅう	分注	文中
ぶんたいし	分隊士
ぶんせきき	分析器
ぶんせきか	分析家
ぶんじょう	分譲	分乗
ぶんじたい	文自体
ぶんしょこ	文書庫
ぶんしょく	文飾
ぶんしょか	文書化
ぶんしょう	文相	文章	分掌
ぶんしゅん	文春
ぶんしゅつ	分出
ぶんしゅく	分宿
ぶんしゅう	文集	分周
ぶんしゃか	分社化
ぶんしめい	分子名
ぶんししき	分子式
ぶんしけん	分子研
ぶんしかん	分子間
ぶんさんど	分散度
ぶんさんち	分散値
ぶんさんか	分散化
ぶんごやく	文語訳
ぶんごほう	文語法
ぶんごぶん	文語文
ぶんごふう	文語風
ぶんごたい	文語体
ぶんこめい	文庫名
ぶんこぼん	文庫本
ぶんこばん	文庫版	文庫判
ぶんことも	文庫共
ぶんこかん	文庫刊
ぶんこうき	分光器
ぶんげいぶ	文芸部
ぶんげいし	文芸誌
ぶんげいざ	文芸座	文芸坐
ぶんげいか	文芸家
ぶんぐてん	文具店
ぶんぐかん	文具館
ぶんぎょう	分業	文業
ぶんきよう	分岐用
ぶんきょく	分極
ぶんきょう	文京	文教
ぶんきゅう	文久
ぶんきてん	分岐点
ぶんきせん	分岐線
ぶんきすう	分岐数
ぶんきさき	分岐先
ぶんきえき	分岐駅
ぶんがっか	文学科
ぶんがくぶ	文学部
ぶんがくし	文学史	文学誌
ぶんかろん	文化論
ぶんからん	文化欄
ぶんかめん	文化面
ぶんかむら	文化村
ぶんかまち	文化町
ぶんかのひ	文化の日
ぶんかどう	文化堂	文華堂
ぶんかてき	文化的
ぶんかつは	分割派
ぶんかつず	分割図
ぶんかつご	分割後
ぶんかじん	文化人
ぶんかざい	文化財
ぶんかさい	文化祭
ぶんかけん	文化圏
ぶんかけい	文科系	文化系
ぶんかかい	文化会	分科会
ぶんえんか	分煙化	分煙可
ぶろっくか	ブロック化
ぶれいもの	無礼者
ぶれいこう	無礼講
ぶるがりあ	勃牙利
ぶらくみん	部落民
ぶらいかん	無頼漢
ぶようどう	武揚堂
ぶようじん	無用心	不用心
ぶようげき	舞踊劇
ぶゆうでん	武勇伝
ぶもんめい	部門名
ぶもんべつ	部門別
ぶもんない	部門内
ぶもんすう	部門数
ぶもんごと	部門毎
ぶもんかん	部門間
ぶぶんれつ	部分列
ぶぶんよく	部分浴
ぶぶんひん	部分品
ぶぶんてき	部分的
ぶぶんしき	部分式
ぶぶんこう	部分項
ぶぶんけい	部分系
ぶぶんぐん	部分群
ぶぶんおん	部分音
ぶひんめい	部品名
ぶひんだい	部品代
ぶひんすう	部品数
ぶないしゃ	部内者
ぶどうとう	ブドウ糖	葡萄糖
ぶどうじょ	武道所
ぶどうしゅ	葡萄酒	ブドウ酒	ぶどう酒
ぶどうかん	武道舘	武道館
ぶどういろ	葡萄色
ぶとうてき	舞踏的
ぶとうだん	舞踏団
ぶとうかい	舞踏会	武闘会
ぶつりょう	物量	物療
ぶつりゅう	物流
ぶつりめい	物理名
ぶつりてき	物理的
ぶつりそう	物理層
ぶつりせい	物理性
ぶつりけん	物理研
ぶつりけい	物理系
ぶつりきじ	物理記事
ぶつりがく	物理学	物理學
ぶつりかい	物理界
ぶつみょう	仏名
ぶつじょう	物情
ぶつぐてん	仏具店
ぶっせいや	物性屋
ぶっしょく	物色
ぶっしょう	物象	物証
ぶっしゃり	仏舎利
ぶっしつば	物質場
ぶっしつは	物質波
ぶっしつか	物質化
ぶっこしゃ	物故者
ぶっこくど	仏国土
ぶっけんひ	物件費
ぶっきょう	佛教	仏教	物狂
ぶっかだか	物価高
ぶたまんや	豚饅屋
ぶたしゃぶ	豚しゃぶ
ぶたいよう	舞台用
ぶたいゆか	舞台床
ぶたいそで	舞台袖
ぶたいすう	部隊数
ぶたいげき	舞台劇
ぶたいがわ	舞台側
ぶたいうら	舞台裏
ぶじとっぱ	無事突破
ぶじつうか	無事通過
ぶじきこく	無事帰国
ぶじきかん	無事帰還
ぶしょめい	部署名	部所名
ぶしょない	部署内
ぶしょがい	部署外
ぶしゅめい	部首名
ぶしゅうぎ	不祝儀
ぶこくざい	誣告罪
ぶこうやわ	武功夜話
ぶげいしゃ	武芸者
ぶけやしき	武家屋敷
ぶぐいがい	武具以外
ぶきりょう	不器量
ぶきはかい	武器破壊
ぶききんゆ	武器禁輸
ぶがいしゃ	部外者
ぶかつどう	部活動
ぶかっこう	不恰好	不格好
ぶかちょう	部課長
ぶかいせい	部会制
ぶえんりょ	無遠慮
ぶいんすう	部員数
ぶあんない	不案内
ぶあいそう	無愛想
びんちょう	備長
びんじょう	便乗
びんしょう	敏捷	憫笑
びんざさら	編木
びわほうし	琵琶法師
びわこせん	琵琶湖線
びるしゃな	毘盧遮那
びるいかん	鼻涙管
びりゅうし	微粒子
びようしつ	美容室
びようげか	美容外科
びよういん	美容院
びょうれき	病歴
びょうるい	病羸
びょうりい	病理医
びょうよみ	秒読	秒読み
びょうゆう	病友
びょうめい	病名
びょうぼつ	病没
びょうへん	病変
びょうへき	病癖
びょうへい	病弊
びょうぶえ	屏風絵
びょうはく	錨泊
びょうにん	病人
びょうなん	病難
びょうどく	病毒
びょうどう	廟堂	平等
びょうとう	病棟
びょうてき	病的
びょうたい	病体	病態
びょうぞう	描像
びょうそく	秒速
びょうそう	病巣
びょうせい	病勢
びょうすう	秒数
びょうじつ	病日
びょうしん	秒針	病身
びょうしょ	廟所
びょうしゃ	描写	病者	病舎
びょうしつ	病室
びょうしき	病識
びょうさつ	秒殺
びょうごと	秒毎
びょうこん	病根
びょうげん	病源	病原
びょうけつ	病欠
びょうきん	病菌
びょうがじ	描画時
びょうがい	病害
びょうかん	秒間	病間	病患
びょういん	病因	病院
びゅうまち	別府町
びゃくろく	白緑
びゃくれん	白蓮
びゃくだん	白檀
びゃくごう	白毫
びまんせい	瀰漫性
びぼうろく	備忘録
びほうさく	弥縫策
びぶんほう	微分法
びぶんしょ	美文書
びぶんこう	微分項
びぶんきか	微分幾何
びぶんがく	微分学
びふういき	微風域
びねんまく	鼻粘膜
びっちゅう	備中
びだくおん	鼻濁音
びだいそつ	美大卒
びぜんやき	備前焼
びせきぶん	微積分
びせいぶつ	微生物
びじんろん	美人論
びじんふう	美人風
びじんぞう	美人像
びじれいく	美辞麗句
びじょうふ	美丈夫
びじゅつぶ	美術部
びじゅつし	美術史
びじゅつか	美術家
びしょぬれ	びしょ濡れ
びしょくか	美食家
びしゃもん	毘沙門
びこうらん	備考欄
びこうせい	微光星
びこうけん	美工研
びげいこう	美藝公
びけいやく	美形役
びけいすう	微係数
びくしょう	微苦笑
びおんとう	微温湯
びおとーぷ	Biotop	biotope	ビオトープ
びえんやく	鼻炎薬
びーるばら	ビール腹
びーるけん	ビール券
ばんりょく	蛮力	万緑
ばんりゅう	伴流
ばんりばし	万里橋
ばんばやし	番囃子
ばんなぐろ	花畔
ばんどころ	番所
ばんちょう	番長	番丁	番町
ばんそうぶ	伴奏部
ばんじょう	番匠	盤上	万丈
ばんじゅく	晩熟
ばんじゃく	磐石	盤石
ばんしょく	伴食
ばんしょう	万障	番匠	晩鐘	万象
ばんしゅん	晩春
ばんしゅう	磐州	播州	晩秋
ばんしゃく	晩酌
ばんごはん	晩御飯	晩ご飯
ばんごうぼ	番号簿
ばんごうづ	番号付
ばんこんか	晩婚化
ばんこっき	万国旗
ばんぐみか	番組化
ばんきんや	板金屋
ばんがいち	番外地
ばれいしょ	馬鈴薯
ばめんごと	場面毎
ばぼうさく	馬防柵
ばふんうに	馬糞海胆
ばぬしめい	馬主名
ばなはかん	バナハ環
ばなじうむ	V	Vanadium
ばとうきん	馬頭琴
ばていけい	馬蹄形
ばつりゅう	末流
ばつびょう	抜錨
ばつげーむ	罰ゲーム
ばっしょう	跋渉
ばっしゅつ	伐出
ばちすもく	バチス目	Batidales
ばしょわり	場所割り
ばしょまえ	場所前
ばしょてき	場所的
ばしょだい	場所代
ばしょせつ	場所説
ばしょがら	場所柄
ばしょうふ	芭蕉布
ばしょいり	場所入り
ばしゃみち	馬車道
ばしゃうま	馬車馬
ばけんてき	馬券的
ばけんだい	馬券代
ばけのかわ	化けの皮
ばくろぼん	暴露本
ばくりょう	曝涼	幕僚
ばくりゅう	瀑流
ばくふぐん	幕府軍
ばくにゅう	爆乳
ばくちゃく	縛着
ばくちうち	博打打ち
ばくだんや	爆弾屋
ばくしんち	爆心地
ばくしょう	爆笑
ばくしゅう	麦秋
ばくげきき	爆撃機
ばくがとう	麦芽糖
ばかわらい	馬鹿笑い
ばかやろう	馬鹿野郎
ばかばやし	馬鹿囃子
ばかばなし	馬鹿話
ばかぢから	馬鹿力
ばかじから	馬鹿力
ばかさわぎ	馬鹿騒ぎ
ばかおんな	馬鹿女
ばいりょう	倍量
ばいりつき	倍率器
ばいようど	培養土
ばいようき	培養器	培養基
ばいとだい	バイト代
ばいとすう	バイト数
ばいとさき	バイト先
ばいていど	倍程度
ばいちょう	倍長	倍調	陪聴
ばいせいど	倍精度
ばいじょう	陪乗
ばいじゅう	陪従
ばいしょく	売色	陪食
ばいしょう	賠償	焙焼	売笑
ばいしゅん	買春	売春
ばいしゅう	買収
ばいしゃく	媒酌	倍尺	媒妁
ばいこくど	売国奴
ばいくらい	倍位
ばいくとう	バイク盗
ばいきゅう	倍旧
ばいきゃく	売却
ばいがえし	倍返し
ばいうころ	梅雨頃
ばいいない	倍以内
ばあいわけ	場合分け
ばあいなど	場合等
ぼんわじてん	梵和辞典
ぼたんざくら	牡丹桜
ぼせいげんり	母性原理
ぼしゅうだん	母集団
ぼしゅうきじ	募集記事
ぼしてちょう	母子手帳
ぼしかんせん	母子感染
ぼけろうじん	ボケ老人
ぼくようしん	牧羊神
ぼくねんじん	朴念仁
ぼきょくめん	母曲面
ぼきょくせん	母曲線
ぼきかいけい	簿記会計
ぼがいしさん	簿外資産
ぼうれいたち	亡霊達
ぼうゆうめい	某有名
ぼうゆうじん	某友人
ぼうめいしゃ	亡命者
ぼうまんがか	某漫画家
ぼうほうめん	某方面
ぼうふうりん	防風林
ぼうふうせい	防風性
ぼうふうけん	暴風圏
ぼうふういき	暴風域
ぼうばんぐみ	某番組
ぼうはんよう	防犯用
ぼうはんとう	防犯灯
ぼうねんかい	忘年会
ぼうだんよう	防弾用
ぼうだいがく	某大学
ぼうたかとび	棒高飛び
ぼうたいほう	暴対法
ぼうそうぞく	暴走族
ぼうそうそし	暴走阻止
ぼうそうじこ	暴走事故
ぼうそうしゃ	暴走車
ぼうそうきじ	暴走記事
ぼうせんもう	防潜網
ぼうせんぱい	某先輩
ぼうせつりん	防雪林
ぼうせつえん	傍接円
ぼうせいまる	望星丸
ぼうせいとう	某政党
ぼうずあたま	坊主頭
ぼうすいせい	防水性
ぼうすいけい	紡錘形	紡錘型
ぼうすいえき	防水液
ぼうじむしょ	某事務所
ぼうしんぶん	某新聞
ぼうしょてん	某書店
ぼうしつざい	防湿剤
ぼうしきのう	防止機能
ぼうしきこう	防止機構
ぼうしかのう	防止可能
ぼうさくひん	某作品
ぼうごむせん	防護無線
ぼうごししん	防護指針
ぼうこうざた	暴行沙汰
ぼうこうざい	暴行罪
ぼうこうこう	某高校
ぼうこうがん	膀胱癌
ぼうこうえん	膀胱炎
ぼうげんしゃ	暴言者
ぼうげいにん	某芸人
ぼうけんもの	冒険物
ぼうけんてき	冒険的
ぼうけんたん	冒険譚
ぼうけんしん	冒険心
ぼうけんしゃ	冒険者
ぼうけんおう	冒険王
ぼうくうごう	防空壕
ぼうくうがた	防空型
ぼうぎんこう	某銀行
ぼうぎょりつ	防御率
ぼうぎょてん	防御点
ぼうぎょがわ	防御側
ぼうきぎょう	某企業
ぼうがっけん	某学研
ぼうがっかい	某学会
ぼうがくしゃ	某学者
ぼうがいおん	妨害音
ぼうかんふく	防寒服
ぼうかんしゃ	傍観者
ぼうかとびら	防火扉
ぼうかちいき	防火地域
ぼうかいしゃ	某会社
ぼうおんへき	防音壁
ぼうおんだい	某音大
ぼうおんせい	防音性
ぼうおんしつ	防音室
ぼうおんざい	防音材
ぼうえんぞく	暴煙族
ぼうえんしゃ	暴煙者
ぼうえんけい	望遠系
ぼうえんがわ	望遠側
ぼうえきふう	貿易風
ぼうえいよう	防衛用
ぼうえいもう	防衛網
ぼうえいだい	防衛大
ぼうえいたい	防衛隊
ぼうえいせん	防衛戦	防衛線
ぼうえいさく	防衛策
ぼうえいぐん	防衛軍
ぼういざかや	某居酒屋
ぼいんぶぶん	母音部分
ぼいんちょう	母音長
ぼいんきごう	母音記号
べんりちょう	便利帖	便利帳
べんりこうし	弁理公使
べんりきのう	便利機能
べんべつてき	弁別的
べんべつげん	弁別限
べんぴしょう	便秘症
べんとうばこ	弁当箱
べんとうだい	弁当代
べんてんじま	弁天島
べんしんろん	弁神論
べんざいてん	弁財天
べんごしほう	弁護士法
べんごしかい	弁護士会
べんぎじょう	便宜上
べんきょうか	勉強家
べにしょうが	紅生姜
べつれっしゃ	別列車
べつもんだい	別問題
べつめいれい	別命令
べつめいあて	別名宛
べつほうこう	別方向
べつぶんしょ	別文書
べつばんごう	別番号
べつばんぐみ	別番組
べつどうたい	別働隊	別動隊
べつとうこう	別投稿
べつだんたい	別団体
べつたいしき	別体式
べつたいけい	別体系
べつそんざい	別存在
べつせんめい	別線名
べつせっけい	別設計
べつずりだい	別刷代
べつじんぶつ	別人物
べつじんかく	別人格
べつじょけん	別除権
べつしんぱん	別審判
べつしんごう	別信号
べつしゃしゅ	別車種
べつさくひん	別作品
べつこうほち	別候補地
べつこうどう	別行動
べつけいやく	別契約
べつけいとう	別系統
べつけいしき	別形式
べつけいえい	別経営
べつがっこう	別学校
べつがいねん	別概念
べつがいしゃ	別会社
べつかいけい	別会計
べつうちゅう	別宇宙
べつあつらえ	別誂え
べつあつかい	別扱い
べっぷちょう	別府町
べっとふたん	別途負担
べっとぎろん	別途議論
べったらづけ	べったら漬け
べっそうひん	別送品
べっしいしき	蔑視意識
べっさつもの	別冊物
べっさつてき	別冊的
べっさつごう	別冊号
べっこうあめ	鼈甲飴
べっけんこん	別乾坤
べすとでんき	ベスト電器
べくとるせき	ベクトル積
べくさかずき	可杯
べいほんごく	米本国
べいだいがく	米大学
べいこくばん	米国版	米国盤
べいこくはつ	米国発
べいこくない	米国内
べいこくてき	米国的
べいこくだい	米国大
べいこくせい	米国製
べいこくじん	米国人
べいこくしき	米国式
べいこくさん	米国産
べいこくさい	米国債
べいこくけい	米国系
べいこくぎら	米国嫌
べいこくがわ	米国側
べいこくがた	米国型
べいこくがい	米国外
べいぐんよう	米軍用
べいぐんきち	米軍基地
べいかんたい	米艦隊
べいえいらん	米英蘭
べいえいぐん	米英軍
ぶんれつまえ	分裂前
ぶんれつせい	分裂性
ぶんれつしつ	分裂質
ぶんれつしき	分列式
ぶんるいめい	分類名
ぶんるいほう	分類法
ぶんるいけい	分類系
ぶんるいぐん	分類群
ぶんるいがく	分類学
ぶんりゅうき	分流器
ぶんりふのう	分離不能
ぶんりしんぎ	分離審議
ぶんりこうり	分離公理
ぶんりきそく	分離規則
ぶんりかのう	分離可能
ぶんりかぜい	分離課税
ぶんやみてい	分野未定
ぶんめいどう	文明堂
ぶんめいてき	文明的
ぶんめいじん	文明人
ぶんめいこく	文明国
ぶんみんほご	文民保護
ぶんぽうろん	文法論
ぶんぽうてき	文法的
ぶんぽうしょ	文法書
ぶんぼうぐや	文房具屋
ぶんぴつぶつ	分泌物
ぶんぴつえき	分泌液
ぶんぱいりつ	分配律
ぶんぱいそく	分配束
ぶんばんごう	文番号
ぶんでんばん	分電盤
ぶんたんりつ	分担率
ぶんたんせい	分担制
ぶんたんしゃ	分担者
ぶんたんきん	分担金
ぶんたいろん	文体論
ぶんたいおう	文対応
ぶんそうおう	分相応
ぶんぜんたい	文全体
ぶんせんめい	文鮮明
ぶんせんどう	文泉堂
ぶんせつせい	文節性	分節性
ぶんせつすう	文節数
ぶんせつくぎ	文節区切
ぶんせつぎり	文節切
ぶんせきほう	分析法
ぶんせきてき	分析的
ぶんせきしゃ	文責者	分析者
ぶんせききじ	分析記事
ぶんせきがく	分析学
ぶんせいどう	文盛堂
ぶんせいせい	文生成
ぶんすうしき	分数式
ぶんすいれい	分水嶺
ぶんすいかい	分水界
ぶんじょうち	分譲地
ぶんしりょう	分子量
ぶんしょない	文書内
ぶんしょけい	文書型
ぶんしょかん	文書館
ぶんしょうご	文章語
ぶんしょうか	文章家	文章化
ぶんしゅうひ	分周比
ぶんしもけい	分子模型
ぶんしどうし	分子同士
ぶんしでんし	分子電子
ぶんしげんし	分子原子
ぶんしきどう	分子軌道
ぶんさんてき	分散的
ぶんさんだい	分散大
ぶんさんせい	分散性
ぶんさんけん	分散研
ぶんさんがた	分散型
ぶんごちょう	文語調
ぶんごたかだ	豊後高田
ぶんこうほう	分光法
ぶんこうぞう	文構造
ぶんこうがく	分光学
ぶんこいがい	文庫以外
ぶんげいてき	文芸的
ぶんげいしょ	文芸書
ぶんげいがく	文芸学
ぶんけんなど	文献等
ぶんけんとう	文献等
ぶんけんてき	分権的
ぶんけんちず	分県地図
ぶんけんたい	分遣隊
ぶんけんがく	文献学
ぶんぎょうか	分業化
ぶんきりろん	分岐理論
ぶんきよそく	分岐予測
ぶんきょくか	分極化
ぶんきょうぶ	文教部
ぶんきょうく	文京区	文教区
ぶんきそうち	分岐装置
ぶんがくろん	文学論
ぶんがくてき	文学的
ぶんがくしゃ	文学者
ぶんがくかい	文学界
ぶんかんすう	文関数
ぶんかまさつ	文化摩擦
ぶんかつめい	分割名
ぶんかつほう	分割法
ぶんかつばら	分割払
ぶんかつてん	分割点
ぶんかつすう	分割数
ぶんかつさき	分割先
ぶんかつきじ	分割記事
ぶんかつがわ	分割側
ぶんかつがた	分割型
ぶんかつあん	分割案
ぶんかちょう	文化庁
ぶんかじょし	文華女子
ぶんかしょう	文化省	文化賞
ぶんかしはい	文化支配
ぶんかこゆう	文化個有
ぶんかきごう	文化記号
ぶんかがっか	文化学科
ぶんかいほう	分解法
ぶんかいのう	分解能
ぶんかいてん	分界点
ぶんかいせき	文解析
ぶんかいせい	分解性
ぶんかいしき	文化意識
ぶんかいさん	文化遺産
ぶんえんどう	文苑堂
ぶんえいどう	文永堂
ぶれんどまい	ブレンド米
ぶらんどまい	ブランド米
ぶらんどひん	ブランド品
ぶらくさべつ	部落差別
ぶらうんかん	ブラウン管
ぶぶんりろん	部分理論
ぶぶんほうき	部分放棄
ぶぶんぶぶん	部分部分
ぶぶんひてい	部分否定
ぶぶんどうし	部分同士
ぶぶんしょく	部分食
ぶぶんしてい	部分指定
ぶぶんけっか	部分結果
ぶぶんけいろ	部分経路
ぶぶんいがい	部分以外
ぶふうりゅう	無風流
ぶひんひょう	部品表
ぶひんたんい	部品単位
ぶひんごかん	部品互換
ぶひんかかく	部品価格
ぶばいがわら	分倍河原
ぶなもくぐん	ブナ目群
ぶどうばたけ	葡萄畑
ぶどうねずみ	葡萄鼠
ぶどうじょう	葡萄状	武道場
ぶつりりろん	物理理論
ぶつりりょう	物理量
ぶつりようご	物理用語
ぶつりせかい	物理世界
ぶつりさよう	物理作用
ぶつりこうぎ	物理講義
ぶつりげんり	物理原理
ぶつりがっか	物理学科
ぶつりがくし	物理学史
ぶつりかてい	物理過程
ぶつりかがく	物理化学
ぶつりいがい	物理以外
ぶつえんほう	仏炎苞
ぶっぽうそう	仏法僧
ぶっぴんだい	物品代
ぶっぴんぜい	物品税
ぶったいない	物体内
ぶったいがわ	物体側
ぶっそんじこ	物損事故
ぶっそくせき	仏足石
ぶっせいろん	物性論
ぶっせいけん	物性研
ぶっせいけい	物性系
ぶっせいがく	物性学
ぶっしょうか	物象化
ぶっしょうえ	仏生会
ぶっしょうい	仏正意
ぶっしつめい	物質名
ぶっしつてき	物質的
ぶっしつけん	物質研
ぶっしつかん	物質間
ぶっさんてん	物産店	物産展
ぶっけんほう	物権法
ぶっきょうと	仏教徒
ぶっきょうし	仏教史
ぶっかつろん	物活論
ぶっかしすう	物価指数
ぶちょうほさ	部長補佐
ぶちょうほう	不調法
ぶちょうづき	部長付
ぶちょうせき	部長席
ぶちょうしつ	部長室
ぶちょうかい	部長会
ぶたたまてん	豚玉天
ぶたじるふう	豚汁風
ぶたいちょう	部隊長
ぶたいたんい	部隊単位
ぶたいそうち	舞台装置
ぶたいじょう	舞台上
ぶたいこうか	舞台効果
ぶたいげいこ	舞台稽古
ぶじょくてき	侮辱的
ぶじょくざい	侮辱罪
ぶじはっけん	無事発見
ぶじかいけつ	無事解決
ぶしょうもの	不精者
ぶしょうひげ	不精髭	無精髭
ぶげいちょう	武芸帳
ぶけしゃかい	武家社会
ぶくうじゅつ	舞空術
ぶぎょうしょ	奉行所
ぶきょくめい	部局名
ぶきょくかん	部局間
ぶきゆしゅつ	武器輸出
ぶきとりひき	武器取引
ぶきえんじょ	武器援助
ぶあいきょう	無愛敬
ぶあいきゅう	歩合給
びんぼうにん	貧乏人
びんぼうけん	貧乏県
びんぼうくじ	貧乏籤
びんぼうがみ	貧乏神
びんかんはだ	敏感肌
びわこきせん	琵琶湖汽船
びわかじゅう	枇杷果汁
びようじゅつ	美容術
びょうりがく	病理学
びょうびょう	渺渺	眇々	渺々	眇眇
びょうどうか	平等化
びょうちゅう	病中
びょうたんい	秒単位
びょうじょう	病状	苗条
びょうじゃく	病弱
びょうしょう	病床	病症
びょうしゅつ	描出
びょうししゃ	病死者
びょうがいち	描画位置
びゃっこたい	白虎隊
びほろちょう	美幌町
びぶんそうさ	微分操作
びぶんしょう	美文章
びぶんかのう	微分可能
びてきりゆう	美的理由
びてきはいち	美的配置
びっくりみず	びっくり水
びっくりばこ	びっくり箱
びちょうせい	微調整
びちゅうかく	鼻中隔
びたみんるい	ビタミン類
びたいちもん	鐚一文
びせいちょう	美星町
びじんひしょ	美人秘書
びじょざくら	美女桜
びじゅつひん	美術品
びじゅつてん	美術展
びじゅつだい	美術大
びじゅつしょ	美術書
びじゅつしつ	美術室
びじゅつしか	美術史家
びじゅつけい	美術系
びじゅつかん	美術館
びしょうねん	美少年
びしょうじょ	美少女
びしょうかく	微小角
びさんちほう	備讃地方
びさいかこう	微細加工
びがくじょう	美学上
びかこうどう	美化行動
ばんれいしか	バンレイシ科	Annonaceae
ばんぷふとう	万夫不当
ばんばんじー	棒棒鶏	棒々鶏
ばんばんざい	万々歳	万万歳
ばんのうやく	万能薬
ばんのうせい	万能性
ばんのうざお	万能竿
ばんのうきぐ	万能器具
ばんのうがた	万能型
ばんのうかぎ	万能鍵
ばんづけがい	番付外
ばんちぶぶん	番地部分
ばんだいさん	磐梯山
ばんたんせん	播但線
ばんそうばん	伴奏版
ばんそうしゃ	伴奏者
ばんそうこう	ばん創膏	絆創膏
ばんしんどう	板振動
ばんさんかい	晩餐会
ばんごうわく	番号枠
ばんごうらん	番号欄
ばんごうごと	番号毎
ばんこふえき	万古不易
ばんけんもと	版権元
ばんぐみらん	番組欄
ばんぐみめい	番組名
ばんぐみはつ	番組初
ばんぐみない	番組内
ばんぐみだい	番組第
ばんくるわせ	番狂わせ
ばんくーばー	晩香坡
ばんがいへん	番外編
ばるさみこす	バルサミコ酢
ばりぞうごん	罵詈雑言
ばりざんぼう	罵詈讒謗
ばらもくぐん	バラ目群
ばらじゅうじ	薔薇十字
ばめいへいき	馬名併記
ばばてきせい	馬場適正
ばばかいぞう	馬場改造
ばつとうばん	罰当番
ばついっぱん	罰一般
ばっぽんてき	抜本的
ばっちしょり	バッチ処理
ばっすいおわ	抜粋終
ばっくよらく	抜苦与楽
ばっきんせい	罰金制
ばっきんけい	罰金刑
ばっきんがく	罰金額
ばたいじゅう	馬体重
ばじとうふう	馬耳東風
ばしょみてい	場所未定
ばしょふめい	場所不明
ばしょちゅう	場所中
ばしょこくち	場所告知
ばしょいどう	場所移動
ばしょいがい	場所以外
ばしゃじだい	馬車時代
ばけがくしゃ	化学者
ばくろれべる	暴露レベル
ばくろばなし	暴露話
ばくろちょう	馬喰町
ばくれつだん	爆裂弾
ばくらいせん	爆雷戦
ばくはつぶつ	爆発物
ばくはつてき	爆発的
ばくはつおん	爆発音
ばくはじけん	爆破事件
ばくだんはつ	爆弾発
ばくだんきじ	爆弾記事
ばくげきたい	爆撃隊
ばかばかしい	馬鹿馬鹿しい	バカバカしい
ばかていねい	馬鹿丁寧
ばいようえき	培養液
ばいやくまん	倍役満
ばいやくずみ	売約済み
ばいやくしょ	売約書
ばいめいしん	売名心
ばいふうかん	培風館
ばいばいだか	売買高
ばいばいえき	売買益
ばいぞうかん	倍増管	倍増感
ばいせいどか	倍精度化
ばいすうけい	倍数系
ばいしんにん	陪審人
ばいしんせい	陪審制
ばいしんいん	陪審員
ばいしょうろ	焙焼炉
ばいしょうふ	売笑婦
ばいしゅんふ	売春婦
ばいきゃくじ	売却時
ばいかくもじ	倍角文字
ばいかいてき	媒介的
ばいおんれつ	倍音列
ばいおんそく	倍音速
ばいういこう	梅雨以降
ばいいじょう	倍以上
ばあたりてき	場当たり的
ばあいいがい	場合以外
ばーくりうむ	Bk	Berkelium
ぼんじひっけい	梵字必携
ぼんがいちにょ	梵我一如
ぼつれきしてき	没歴史的
ぼつりぬすきん	ボツリヌス菌
ぼつふうりゅう	没風流
ぼつじょうしき	没常識
ぼつこうしょう	没交渉
ぼっこせいてき	没個性的
ぼっきょうかん	木強漢
ぼたんどうろう	牡丹灯籠
ぼたいほごほう	母体保護法
ぼせいほんのう	母性本能
ぼしんせんそう	戊辰戦争
ぼしゅうちゅう	募集中
ぼしゅうこくち	募集告知
ぼしゅうきかん	募集期間
ぼきんかつどう	募金活動
ぼうりょくてき	暴力的
ぼうりょくだん	暴力団
ぼうりょくせい	暴力性
ぼうりょくざた	暴力沙汰
ぼうりゃくせつ	謀略説	某略説
ぼうようりょう	望洋寮
ぼうめいじけん	亡命事件
ぼうはんじょう	防犯上
ぼうはんしそう	防犯思想
ぼうはんかめら	防犯カメラ
ぼうどうじんし	某同人誌
ぼうとうぶぶん	冒頭部分
ぼうでんきてん	某電気店
ぼうちょうりつ	膨張率
ぼうちょうへき	防潮壁
ぼうちょうにん	傍聴人
ぼうちょうせき	傍聴席
ぼうちょうざい	膨張剤
ぼうちゅうざい	防虫剤
ぼうちゅうがく	某中学
ぼうたいしゅう	某大衆
ぼうそうちゅう	暴走中
ぼうそうかいし	暴走開始
ぼうぜんじしつ	茫然自失	呆然自失
ぼうせいしょり	防錆処理
ぼうすいちゅう	紡錘虫
ぼうすいしよう	防水仕様
ぼうすいこうか	防水効果
ぼうすいかこう	防水加工
ぼうじょうれん	某常連
ぼうしょくざい	防食剤
ぼうしょうよう	某商用
ぼうしゅうざい	防臭剤
ぼうしたいさく	防止対策
ぼうこひょうが	暴虎馮河
ぼうこうじけん	暴行事件
ぼうけんやろう	冒険野郎
ぼうくうずきん	防空頭巾
ぼうぎょりょく	防御力
ぼうぎょきこう	防御機構
ぼうぎゃくてき	暴虐的
ぼうきょうじゅ	某教授
ぼうきゅうだん	某球団
ぼうがっきてん	某楽器店
ぼうがいこうい	妨害行為
ぼうかんちょう	某官庁
ぼうおんこうか	防音効果
ぼうえんきょう	望遠鏡
ぼうえきまさつ	貿易摩擦
ぼうえきふうさ	貿易封鎖
ぼうえきしょう	貿易商
ぼうえきくろじ	貿易黒字
ぼうえきあかじ	貿易赤字
ぼうえいちょう	防衛庁
ぼうえいそうち	防衛装置
ぼうえいきせい	防衛期成
ぼうえいいだい	防衛医大
ぼいんにんしき	母音認識
ぼいんだつらく	母音脱落
ぼいんおんせつ	母音音節
べんりじむしょ	弁理事務所
べんべつきのう	弁別機能
べんとうりょう	弁当料
べんとうぶくろ	弁当袋
べんとうじさん	弁当持参
べんてんちょう	弁天町
べんじょそうじ	便所掃除
べんしょうほう	弁証法
べんしょうきん	弁償金
べんごしひよう	弁護士費用
べんきょうよう	勉強用
べんきょうほう	勉強法
べんきょうかい	勉強会
べびーようひん	ベビー用品
べにてんぐたけ	紅天狗茸
べにじゃけいろ	紅鮭色
べにくじらだん	紅鯨団
べつりょうきん	別料金
べつとうひょう	別投票
べつじゅうしょ	別住所
べつしょうひん	別商品
べつぎょうしゅ	別業種
べっとれんらく	別途連絡
べっとひょうじ	別途表示
べっとひつよう	別途必要
べっととうこう	別途投稿
べっとそうだん	別途相談
べっときょうぎ	別途協議
べっせんくかん	別線区間
べっさつふろく	別冊付録
べっこひつよう	別個必要
べっけんたいほ	別件逮捕
べくとるりょう	ベクトル量
べきしゅうごう	冪集合
べいたいしかん	米大使館
べいじょういん	米上院
べいさくのうか	米作農家
べいこくほんど	米国本土
べいこくなんぶ	米国南部
べいこくせいふ	米国政府
べいこくしよう	米国仕様
べいこくぎかい	米国議会
べいこくきしゃ	米国記者
べいこくきかく	米国規格
べいこくえいが	米国映画
べいぐんへいし	米軍兵士
べいぐんあとち	米軍跡地
べいぐんあいて	米軍相手
べーたほうかい	β崩壊
ぶんれつびょう	分裂病
ぶんれつそしき	分裂組織
ぶんれつしょう	分裂症
ぶんるいぶぶん	分類部分
ぶんるいふめい	分類不明
ぶんりょうてき	分量的
ぶんりもんだい	分離問題
ぶんりほうこう	分離方向
ぶんりぶんかつ	分離分割
ぶんりふかのう	分離不可能
ぶんりどくりつ	分離独立
ぶんりていすう	分離定数
ぶんりさくせい	分離作成
ぶんりきゅうゆ	分離給油
ぶんやたんとう	分野担当
ぶんめんじょう	文面上
ぶんめいふうし	文明風刺
ぶんめいひはん	文明批判
ぶんめいかいか	文明開化
ぶんみゃくてき	文脈的
ぶんぽうりろん	文法理論
ぶんぽうようご	文法用語
ぶんぽうていぎ	文法定義
ぶんぽうじょう	文法上
ぶんぽうしこう	文法指向
ぶんぽうきそく	文法規則
ぶんぽうきごう	文法記号
ぶんぽういしき	文法意識
ぶんぼうぐてん	文房具店
ぶんぷらんすう	分布乱数
ぶんぷとくせい	分布特性
ぶんぷちょうさ	分布調査
ぶんぷかんすう	分布関数
ぶんぴつぎょう	文筆業
ぶんぴつきこう	分泌機構
ぶんちゅうじょ	分駐所
ぶんだんかしょ	分断箇所
ぶんたんひょう	分担表
ぶんたんはんい	分担範囲
ぶんたいちょう	分隊長
ぶんせつちょう	文節長
ぶんせつちゅう	分節中	文節中
ぶんせついどう	文節移動
ぶんせきりょく	分析力
ぶんせきそうち	分析装置
ぶんせきじすう	分析次数
ぶんせきけっか	分析結果
ぶんせききこう	分析機構
ぶんせきかのう	分析可能
ぶんせきかがく	分析化学
ぶんじょうしゃ	分乗車
ぶんしょりょく	文書力
ぶんしょちゅう	文書中
ぶんしょしょり	文書処理
ぶんしょしそう	文書思想
ぶんしょごかん	文書互換
ぶんしょがぞう	文書画像
ぶんしょうほう	文章法
ぶんしょうない	文章内
ぶんしょうだい	文章題
ぶんしょいがい	文書以外
ぶんしゅうりつ	分周率
ぶんしせっけい	分子設計
ぶんしせいぎょ	分子制御
ぶんししんどう	分子振動
ぶんしこうぶん	分詞構文
ぶんしこうぞう	分子構造
ぶんしこうがく	分子工学
ぶんしうんどう	分子運動
ぶんさんめもり	分散メモリ
ぶんさんはいち	分散配置
ぶんさんしょり	分散処理
ぶんさんきのう	分散機能
ぶんさんきおく	分散記憶
ぶんさんかんり	分散管理
ぶんごすいどう	豊後水道
ぶんこもくろく	文庫目録
ぶんげいがくぶ	文芸学部
ぶんげいえいが	文芸映画
ぶんけんひょう	文献表
ぶんけんしゅう	文献集
ぶんけいりけい	文系理系
ぶんけいがっか	文系学科
ぶんぎょうせい	分業制
ぶんきょうだい	文教大
ぶんきょうぞく	文教族
ぶんきめいれい	分岐命令
ぶんきせんたく	分岐選択
ぶんきかいせん	分岐回線
ぶんがくはかせ	文学博士
ぶんがくしょう	文学賞
ぶんがくざっし	文学雑誌
ぶんがくこうぎ	文学講義
ぶんかほうそう	文化放送
ぶんかはいけい	文化背景
ぶんかてきさい	文化的差異
ぶんかつろんぎ	分割論議
ぶんかつりゆう	分割理由
ぶんかつばらい	分割払い
ぶんかつぜんご	分割前後
ぶんかつじかん	分割時間
ぶんかつぎろん	分割議論
ぶんかついどう	分割移動
ぶんかついがい	分割以外
ぶんかかくめい	文化革命
ぶんかかいかん	文化会館	文化会舘
ぶんかかいいん	分科会員
ぶんかいそうじ	分解掃除
ぶんかいせいび	分解整備
ぶんかいげんり	分解原理
ぶんかいかのう	分解可能
ぶんえんしせつ	分煙施設
ぶれつてんのう	武烈天皇
ぶりょくこうし	武力行使
ぶらすばんどぶ	ブラスバンド部
ぶらくもんだい	部落問題
ぶもんたんにん	部門担任
ぶもんせつりつ	部門設立
ぶぶんもんだい	部分問題
ぶぶんもじれつ	部分文字列
ぶぶんへんこう	部分変更
ぶぶんひょうか	部分評価
ぶぶんはいれつ	部分配列
ぶぶんはいしご	部分廃止後
ぶぶんそっこう	部分測光
ぶぶんぜんたい	部分全体
ぶぶんせいげん	部分制限
ぶぶんしんくう	部分真空
ぶぶんこうぞう	部分構造
ぶぶんけいさん	部分計算
ぶぶんくうかん	部分空間
ぶぶんきょうか	部分強化
ぶぶんかんすう	部分関数
ぶぶんかくてい	部分確定
ぶぶんかいてい	部分改訂	部分改定
ぶぶんかいつう	部分開通
ぶぶんおんれつ	部分音列
ぶぶんいんよう	部分引用
ぶぶんいったい	部分一体
ぶひんてんすう	部品点数
ぶひんだいきん	部品代金
ぶひんこうかん	部品交換
ぶなもくあぐん	ブナ目亜群
ぶないりょこう	部内旅行
ぶどうたいかい	武道大会
ぶどうかんとも	武道館共
ぶとうたいかい	武闘大会
ぶとうおんがく	舞踏音楽
ぶつりりろんか	物理理論家
ぶつりゅうめん	物流面
ぶつりもんだい	物理問題
ぶつりほうそく	物理法則
ぶつりとくせい	物理特性
ぶつりてきいみ	物理的意味
ぶつりてきいち	物理的位置
ぶつりていすう	物理定数
ぶつりそんざい	物理存在
ぶつりせんこう	物理専攻
ぶつりせいぶつ	物理生物
ぶつりせいげん	物理制限
ぶつりすうがく	物理数学
ぶつりじっけん	物理実験
ぶつりこうげき	物理攻撃
ぶつりげんそく	物理原則
ぶつりけいさん	物理計算
ぶつりがっかい	物理学会
ぶつりがくてき	物理学的
ぶつりがくしょ	物理学書
ぶつりがくしゃ	物理学者
ぶつりかんけい	物理関係
ぶってんちゅう	仏典中
ぶっちょうづら	仏頂面
ぶっちょうずら	仏頂面
ぶったいないぶ	物体内部
ぶっせいりろん	物性理論
ぶっしつゆそう	物質輸送
ぶっしつめいし	物質名詞
ぶっしつぶんぷ	物質分布
ぶっしつちゅう	物質中
ぶっしつしゅぎ	物質主義
ぶっしつかがく	物質科学
ぶっけんこうい	物権行為
ぶっきょうだい	仏教大
ぶっきょうしき	仏教式
ぶっきょうこく	仏教国
ぶっきょうけい	仏教系
ぶっきょうがく	仏教学
ぶっかじじょう	物価事情
ぶっかかんかく	物価感覚
ぶたいへんせい	部隊編成
ぶたいびじゅつ	舞台美術
ぶたいはつおん	舞台発音
ぶたいはいゆう	舞台俳優
ぶたいぜんたい	舞台全体
ぶたいせってい	舞台設定
ぶたいさつえい	舞台撮影
ぶたいこうえん	舞台公演
ぶたいいしょう	舞台衣装
ぶたいあいさつ	舞台挨拶
ぶそうがったい	武装合体
ぶそうかいじょ	武装解除
ぶじょくこうい	侮辱行為
ぶじょくいがい	侮辱以外
ぶじにゅうしゅ	無事入手
ぶじとうちゃく	無事到着
ぶじさいこうふ	無事再交付
ぶじこれめいば	無事是名馬
ぶしゅさくいん	部首索引
ぶしかいきゅう	武士階級
ぶきょくちょう	部局長
ぶきょくじゅん	部局順
ぶきしょうにん	武器商人
ぶかいしゅさい	部会主催
ぶーるだいすう	ブール代数
びんぼうしょく	貧乏食
びんぼうしょう	貧乏性	貧乏症
びんちょうたん	備長炭
びんじょうねあ	便乗値上
びんしょうせい	敏捷性
びんごおちあい	備後落合
びわこほうめん	琵琶湖方面
びわことうがん	琵琶湖東岸
びわこすいけい	琵琶湖水系
びわこおおはし	琵琶湖大橋
びるしゃなぶつ	毘盧遮那仏
びりょうげんそ	微量元素
びようせいけい	美容整形
びょうりがっか	病理学科
びょうどうかん	平等観
びょうどういん	平等院
びょうげんたい	病源体	病原体
びょうげんきん	病原菌	病源菌
びょうきよぼう	病気予防
びょうきじたい	病気自体
びょうきいぜん	病気以前
びょうがそくど	描画速度
びょうがしょく	描画色
びょうがきのう	描画機能
びょうがかてい	描画過程
びゃくだんもく	ビャクダン目	Santalales
びぶんほうそく	微分法則
びぶんせきぶん	微分積分
びぶんさようそ	微分作用素
びぶんけいすう	微分係数
びぶんけいしき	微分形式
びぶんきかがく	微分幾何学
びふぃずすきん	ビフィズス菌
びはっぽうせい	微発泡性
びにーるぶくろ	ビニール袋
びてきかんかく	美的感覚
びそくぜんしん	微速前進
びせきぶんがく	微積分学
びじんはくめい	美人薄命
びじゅつじてん	美術辞典
びじゅつしょう	美術商
びじゅつさっか	美術作家
びじゅうりょく	微重力
びじゃくでんぱ	微弱電波
びしょうりょう	微少量	微小量
びしょうへんか	微少変化
びしょうへんい	微小変位
びしょうぶぶん	微小部分
びしょうせかい	微少世界	微小世界
びしょうじしん	微小地震
びしょうくかん	微小区間
びしょうきょり	微小距離
びしゃもんどう	毘沙門堂
びしゃもんてん	毘沙門天
びさいこうぞう	微細構造
びーしーへいき	BC兵器
ばんりどうふう	万里同風
ばんぶつるてん	万物流転
ばんのうきかい	万能機械
ばんどうたろう	坂東太郎
ばんづけよそう	番付予想
ばんづけひょう	番付表
ばんだいふえき	万代不易
ばんだいちょう	磐梯町
ばんだいくぶん	番台区分
ばんたむきゅう	バンタム級
ばんじきゅうす	万事休す
ばんしゅうじん	播州人
ばんごうひょう	番号表
ばんごうはんい	番号範囲
ばんごうつうち	番号通知
ばんごうじゅん	番号順
ばんごうしてい	番号指定
ばんごうかんり	番号管理
ばんごういがい	番号以外
ばんぐみよやく	番組予約
ばんぐみひょう	番組表
ばんぐみどうし	番組同士
ばんぐみちゅう	番組中
ばんぐみじょう	番組上
ばんぐみじたい	番組自体
ばんぐみしょき	番組初期
ばんぐみざっし	番組雑誌
ばんあれんたい	バンアレン帯
ばらもくあぐん	バラ目亜群
ばらのぷすもく	バラノプス目	Balanopales
ばらきなかやま	原木中山
ばめんてんかん	場面転換
ばめんせってい	場面設定
ばばんれんふく	馬番連複
ばばじょうたい	馬場状態
ばなはくうかん	バナハ空間
ばとうようごは	罵倒用語派
ばとうせいうん	馬頭星雲
ばとうかんのん	馬頭観音
ばっとうじゅつ	抜刀術
ばっそくきてい	罰則規定
ばっきんせいど	罰金制度
ばっかんさなだ	麦稈真田
ばっかすきほう	バッカス記法
ばしょせんてい	場所選定
ばけんじょうず	馬券上手
ばけんさくせん	馬券作戦
ばけんうりあげ	馬券売上
ばくろうちょう	馬喰町
ばくりゅうしゅ	麦粒腫
ばくはつりょく	爆発力
ばくだんりょう	爆弾量
ばくだんとうか	爆弾投下
ばくだんおとこ	爆弾男
ばくしょうもの	爆笑物
ばくしょうへん	爆笑編
ばくげきせいど	爆撃精度
ばかしょうじき	馬鹿正直
ばいようりょう	倍容量
ばいばいしゅん	売買春
ばいはばいんじ	倍幅印字
ばいたいふもん	媒体不問
ばいしんせいど	陪審制度
ばいしょうきん	賠償金
ばいしょうがく	賠償額
ばいしゅんやど	買春宿
ばいしゃくにん	媒酌人
ばいしつちゅう	媒質中
ばいきゃくさき	売却先
ばいおんじょう	倍音上
ばいうぜんせん	梅雨前線
ばあいさくせい	場合作成
ぼっきしょうがい	勃起障害
ぼしゅうようこう	募集要項	募集要綱
ぼしゅうにんずう	募集人数
ぼしゅうていいん	募集定員
ぼしゅうせつりつ	募集設立
ぼしゅうじんいん	募集人員
ぼしゅうしめきり	募集締切
ぼしゅうこうこく	募集広告
ぼくちくみんぞく	牧畜民族
ぼくじょうちょう	牧場長
ぼうれいしゃしん	亡霊写真
ぼうゆうめいじん	某有名人
ぼうめいせいけん	亡命政権
ぼうはんばいてん	某販売店
ぼうはんだいがく	某阪大学
ぼうはんたいさく	防犯対策
ぼうどうすんぜん	暴動寸前
ぼうそうほうめん	房総方面
ぼうそうはんとう	房総半島
ぼうそうとうせん	房総東線
ぼうそうぞくよう	暴走族用
ぼうそうかくせん	房総各線
ぼうそううんてん	暴走運転
ぼうせんいっぽう	防戦一方
ぼうすいぼうかん	防水防寒
ぼうすいたいさく	防水対策
ぼうすいせいのう	防水性能
ぼうじゃくぶじん	傍若無人
ぼうしんぶんしゃ	某新聞社
ぼうしゅうかんし	某週刊誌
ぼうざっしじょう	某雑誌上
ぼうさいくんれん	防災訓練
ぼうさいかぎけん	防災科技研
ぼうけんりょこう	冒険旅行
ぼうけんりつだい	某県立大
ぼうけんしゃたち	冒険者達
ぼうけいしんぞく	傍系親族
ぼうけいけつぞく	傍系血族
ぼうぎょよういん	防御要員
ぼうぎょこうどう	防御行動
ぼうがいしんごう	妨害信号
ぼうがいざつおん	妨害雑音
ぼうがいこうさく	妨害工作
ぼうかんぼうすい	防寒防水
ぼうかんたいさく	防寒対策
ぼうおんたいさく	防音対策
ぼうえんさつえい	望遠撮影
ぼうえんきょうや	望遠鏡屋
ぼうえんきょうざ	望遠鏡座
ぼうえきせいげん	貿易制限
ぼうえきしゅだん	貿易手段
ぼうえきしゅうし	貿易収支
ぼうえきかんけい	貿易関係
ぼうえいはくしょ	防衛白書
ぼうえいだいそつ	防衛大卒
ぼうえいせいさく	防衛政策
ぼうえいせいこう	防衛成功
ぼうえいうんてん	防衛運転
ぼーりんぐじょう	ボーリング場
べんろんたいかい	弁論大会
べんべつじっけん	弁別実験
べんとうがいしゃ	弁当会社
べんぎてきていぎ	便宜的定義
べんぎちせきせん	便宜置籍船
べんぎさいりょう	便宜裁量
べんきょうぶそく	勉強不足
べんきょうちゅう	勉強中
べんきょうじかん	勉強時間
べるぬじょうやく	ベルヌ条約
べにばないんげん	紅花隠元
べとなむせんそう	ベトナム戦争
べつにゅうじょう	別入場
べつだいまいにち	別大毎日
べっとにゅうしゅ	別途入手
べっとさんしょう	別途参照
べっとこうにゅう	別途購入
べってんようしき	別添様式
べっせいけっこん	別姓結婚
べっさつほうせき	別冊宝石
べくとるくうかん	ベクトル空間
べくとるかいせき	ベクトル解析
べいせいせんそう	米西戦争
べいじょうほうぶ	米情報部
べいしゅうきこう	米州機構
べいこくほうめん	米国方面
べいこくほうじん	米国法人
べいこくないせん	米国内線
べいこくせんしゅ	米国選手
べいこくしゅどう	米国主導
べいこくけんぽう	米国憲法
べいぐんとうちか	米軍統治下
べいぐんきちあと	米軍基地跡
べいかしんぎかい	米価審議会
ぶんれつこうしん	分列行進
ぶんるいもんだい	分類問題
ぶんるいほうほう	分類方法
ぶんるいばんごう	分類番号
ぶんるいぜんたい	分類全体
ぶんるいさいけん	分類債権
ぶんるいこんなん	分類困難
ぶんるいこうもく	分類項目
ぶんるいきじゅん	分類基準
ぶんりのうりょく	分離能力
ぶんりじゅちょう	分離受聴
ぶんめんいじょう	文面以上
ぶんめいひひょう	文明批評
ぶんめいしゃかい	文明社会
ぶんみんとうせい	文民統制
ぶんみゃくじょう	文脈上
ぶんみゃくじゆう	文脈自由
ぶんみゃくしょり	文脈処理
ぶんみゃくこうか	文脈効果
ぶんみゃくいぞん	文脈依存
ぶんぽうとうろく	文法登録
ぶんぽうぞくせい	文法属性
ぶんぽうごうりか	文法合理化
ぶんぽうこうぞう	文法構造
ぶんぽうきじゅつ	文法記述
ぶんぽうかいせき	文法解析
ぶんぼぶんりけい	分母分離形
ぶんぼうぐがかり	文房具係
ぶんべつけいすう	分別係数
ぶんぷけいじょう	分布形状
ぶんぶりょうどう	文武両道
ぶんぶくちゃがま	文福茶釜
ぶんぴつせいかつ	文筆生活
ぶんぴつこうぞう	分泌構造
ぶんぱいほうほう	分配方法
ぶんぱいほうそく	分配法則
ぶんぱいかんすう	分配関数
ぶんだんせいかつ	分断生活
ぶんだんしょうじ	分段生死
ぶんたんほうしき	分担方式
ぶんせつゆうせん	文節優先
ぶんせつへんかん	文節変換
ぶんせきほうほう	分析方法
ぶんせきてつがく	分析哲学
ぶんせきじっけん	分析実験
ぶんじんぼっかく	文人墨客
ぶんしょわりつけ	文書割付け
ぶんしょぶんるい	文書分類
ぶんしょでんしか	文書電子化
ぶんしょぜんたい	文書全体
ぶんしょせいしょ	文書清書
ぶんしょさくせい	文書作成
ぶんしょこうぞう	文書構造
ぶんしょこうかん	文書交換
ぶんしょうりょく	文章力
ぶんしょうりょう	文章量
ぶんしょうりかい	文章理解
ぶんしょうちゅう	文章中
ぶんしょうじょう	文章上
ぶんしょうげんご	文章言語
ぶんしゅんぶんこ	文春文庫
ぶんしゅつこうり	分出公理
ぶんしつひんぴん	文質彬彬
ぶんしじょうたい	分子状態
ぶんしこうぞうず	分子構造図
ぶんしきどうほう	分子軌道法
ぶんさんほうこう	分散方向
ぶんさんぶんせき	分散分析
ぶんさんでんげん	分散電源
ぶんさんそうじき	分散掃除機
ぶんさんせいぎょ	分散制御
ぶんさんしすてむ	分散システム
ぶんさんこうぞう	分散構造
ぶんさんけいさん	分散計算
ぶんさんかんけい	分散関係
ぶんさんえいぞく	分散永続
ぶんこうがくてき	分光学的
ぶんげいさくひん	文芸作品
ぶんけんもくろく	文献目録
ぶんけんちょうさ	文献調査
ぶんけんけんさく	文献検索
ぶんけんあんない	文献案内
ぶんけいしょくば	文系職場
ぶんきょうちょう	文京町
ぶんきょうじょう	分教場
ぶんきょうくみん	文京区民
ぶんきげんしょう	分岐現象
ぶんがくてきひゆ	文学的比喩
ぶんがくせいねん	文学青年
ぶんがくさくひん	文学作品
ぶんかつもんだい	分割問題
ぶんかつほうほう	分割方法
ぶんかつほうしき	分割方式
ぶんかつへいごう	分割併合
ぶんかつはんたい	分割反対
ぶんかつていこう	分割抵抗
ぶんかつていあん	分割提案
ぶんかつさんせい	分割賛成
ぶんかつうんよう	分割運用
ぶんかじょしだい	文化女子大
ぶんかじょうほう	文化情報
ぶんかしんりゃく	文化侵略
ぶんかしゃったー	文化シャッター
ぶんかげんしょう	文化現象
ぶんかくんしょう	文化勲章
ぶんかいほうほう	分解方法
ぶんかいしゅうり	分解修理
ぶんかいしゃしん	分解写真
ぶんかいさぎょう	分解作業
ぶんかいこうてい	分解工程
ぶんかいかくにん	分解確認
ぶりょくふんそう	武力紛争
ぶりょくせいさい	武力制裁
ぶりょくしんこう	武力進攻	武力侵攻
ぶりょくこうげき	武力攻撃
ぶりょくかくめい	武力革命
ぶりょうとうげん	武陵桃源
ぶらうんうんどう	ブラウン運動
ぶもんゆうしょう	部門優勝
ぶぶんろんりしき	部分論理式
ぶぶんりょういき	部分領域
ぶぶんにっしょく	部分日食
ぶぶんしゅうごう	部分集合
ぶぶんけいさんき	部分計算器
ぶぶんきょくひつ	舞文曲筆
ぶぶんかいぎょう	部分開業
ぶひんていきょう	部品提供
ぶひんきょうはん	部品共販
ぶばいがわらえき	分倍河原駅
ぶどうきゅうきん	葡萄球菌
ぶつりりょうほう	物理療法
ぶつりゅうぶもん	物流部門
ぶつりにゅうもん	物理入門
ぶつりてきじげん	物理的次元
ぶつりてきしてん	物理的視点
ぶつりてきしせつ	物理的施設
ぶつりてきさよう	物理的作用
ぶつりてきこうい	物理的行為
ぶつりてききょり	物理的距離
ぶつりてきかてい	物理的過程
ぶつりてきかこう	物理的加工
ぶつりちゅうしん	物理中心
ぶつりじょうたい	物理状態
ぶつりじょうすう	物理定数
ぶつりじっけんや	物理実験屋
ぶつりげんしょう	物理現象
ぶつりぎょうかい	物理業界
ぶつりきょうしつ	物理教室
ぶつりきょういく	物理教育
ぶつりがっかいし	物理学会誌
ぶつりがくじてん	物理学辞典
ぶつりがくしょう	物理学賞
ぶつぶつこうかん	物々交換
ぶつじょうだいい	物上代位
ぶってきしょうこ	物的証拠
ぶっだしゃくそん	仏陀釈尊
ぶったいにんしき	物体認識
ぶっせいきそろん	物性基礎論
ぶっしょくちゅう	物色中
ぶっしつでんそう	物質伝送
ぶっしつたいしゃ	物質代謝
ぶっしつこうぞう	物質構造
ぶっきょうようご	仏教用語
ぶっきょういせき	仏教遺跡
ぶたいちゅうけい	舞台中継
ぶたいちゅうおう	舞台中央
ぶたいげいじゅつ	舞台芸術
ぶたいおんきょう	舞台音響
ぶたいえんしゅつ	舞台演出
ぶたいいっきせい	部隊一期生
ぶそうしゅうだん	武装集団
ぶじしゅうりょう	無事終了
ぶげいひゃっぱん	武芸百般
ぶきゆしゅつこく	武器輸出国
ぶーどぅーきょう	ブードゥー教
びんぼうりょこう	貧乏旅行
びんぼうせいかつ	貧乏生活
びんぼうがくせい	貧乏学生
びんごふちゅうし	備後府中市
びわこほくせいぶ	琵琶湖北西部
びょうりかいぼう	病理解剖
びょうはくちゅう	錨泊中
びょうどうしゅぎ	平等主義
びょうちゅうがい	病虫害
びょうじゃくしゃ	病弱者
びょうしゃりょく	描写力
びょうがほうほう	描画方法
びょうがかんすう	描画関数
びょうがいちゅう	病害虫
びゃくやしょぼう	白夜書房
びぶんかのうせい	微分可能性
びじゅつしょてん	美術書店
びじゅつさくひん	美術作品
びじゅつがっこう	美術学校
びじゅつかんとく	美術監督
びじゅつかんてん	美術館展
びじゅつかんけい	美術関係
びしょうりゅうし	微小粒子
びしょうめんせき	微小面積
びしょうしんごう	微小信号
びしょううんどう	微小運動
ばんめんみぎうえ	盤面右上
ばんのうえんざん	万能演算
ばんちょうこっか	番長国家
ばんせいいっけい	万世一系
ばんすいそうどう	晩翠草堂
ばんしゅうちほう	播州地方
ばんしゅうあこう	播州赤穂
ばんごうひょうじ	番号表示
ばんごうとくてい	番号特定
ばんごうたいけい	番号体系
ばんごうあんない	番号案内
ばんこんさくせつ	盤根錯節
ばんぐみらんがい	番組欄外
ばんぐみほんたい	番組本体
ばんぐみほうそう	番組放送
ばんぐみへんせい	番組編成
ばんぐみへんこう	番組変更
ばんぐみひひょう	番組批評
ばんぐみばんごう	番組番号
ばんぐみないよう	番組内容
ばんぐみちゅうし	番組中止
ばんぐみたいこう	番組対抗
ばんぐみぜんぱん	番組全般
ばんぐみぜんたい	番組全体
ばんぐみせんでん	番組宣伝
ばんぐみせいさく	番組製作
ばんぐみこうせい	番組構成
ばんぐみかいへん	番組改編	番組改変
ばんぐみあんない	番組案内
ばんえつとうせん	磐越東線
ばんえつさいせん	磐越西線
ばろっくおんがく	バロック音楽
ばつざんがいせい	抜山蓋世
ばっぽんそくげん	抜本塞源
ばっすいえんそう	抜粋演奏
ばしょちょくぜん	場所直前
ばけんはつばいご	馬券発売後
ばけんこうにゅう	馬券購入
ばくりょうちょう	幕僚長
ばくはんたいせい	幕藩体制
ばくはつすんぜん	爆発寸前
ばくだんはつげん	爆弾発言
ばくげきぎじゅつ	爆撃技術
ばくがいんりょう	麦芽飲料
ばいりつかくだい	倍率拡大
ばいばいだいきん	売買代金
ばいばいけいやく	売買契約
ばいそくさいせい	倍速再生
ばいきゃくねだん	売却値段
ばいがくいじょう	倍額以上
ばいかくひょうじ	倍角表示
ばいかいへんすう	媒介変数
ばあいぜんじゅつ	場合前述
ぼんのうそくぼだい	煩悩即菩提
ぼんてんたいしゃく	梵天帝釈
ぼるつまんていすう	ボルツマン定数
ぼつこうしょうてき	没交渉的
ぼしゅうようりょう	募集要領
ぼしゅうたいしょう	募集対象
ぼしゅうじょうけん	募集条件
ぼかんすうけいすう	母関数係数
ぼうりょくだんいん	暴力団員
ぼうとうちんじゅつ	冒頭陳述
ぼうちゅうおうりん	某中央輪
ぼうちほうとくさん	某地方特産
ぼうそうとっきゅう	房総特急
ぼうそうぞくいがい	暴走族以外
ぼうそうじょうたい	暴走状態
ぼうしゅっぱんしゃ	某出版社
ぼうさいじょうほう	防災情報
ぼうけんしょうせつ	冒険小説
ぼうけんきゅうしょ	某研究所
ぼうくうのうりょく	防空能力
ぼうぎょのうりょく	防御能力
ぼうおおてきぎょう	某大手企業
ぼうえきしょうへき	貿易障壁
ぼうえきしょうにん	貿易商人
ぼうえいたいしょう	防衛対象
ぼうえいせんりゃく	防衛戦略
べんべつのうりょく	弁別能力
べんべつたいしょう	弁別対象
べんきょうほうほう	勉強方法
べんきょうねっしん	勉強熱心
べつきじさんしょう	別記事参照
べっさつたからじま	別冊宝島
べいだいとうりょう	米大統領
べいこくぼうしょう	米国防省
べいこくだいひょう	米国代表
べいぐんしゅくしゃ	米軍宿舎
べいぐんしせつない	米軍施設内
ぶんるいがくじょう	分類学上
ぶんるいがくしゅう	分類学習
ぶんりふかのうせい	分離不可能性
ぶんりきゅうゆよう	分離給油用
ぶんみゃくどくりつ	文脈独立
ぶんたんしゃかいぎ	分担者会議
ぶんせつしゅうたん	文節終端
ぶんせつがくしゅう	文節学習
ぶんしょへんしゅう	文書編集
ぶんしょがたていぎ	文書型定義
ぶんしょうもんだい	文章問題
ぶんしょうはつおん	文章発音
ぶんしょうないよう	文章内容
ぶんしょうぜんたい	文章全体
ぶんしめんえきがく	分子免疫学
ぶんしないしんどう	分子内振動
ぶんしせいぶつがく	分子生物学
ぶんしきどうりろん	分子軌道理論
ぶんしかがくこうざ	分子科学講座
ぶんさんひょうげん	分散表現
ぶんさんどうりょく	分散動力
ぶんさんとうかせい	分散透過性
ぶんさんたじゅうか	分散多重化
ぶんさんしょりてき	分散処理的
ぶんさんきょうゆう	分散共有
ぶんさんかんきょう	分散環境
ぶんげいひょうろん	文芸評論
ぶんけんじょうほう	文献情報
ぶんけんしょうかい	文献紹介
ぶんけんさんしょう	文献参照
ぶんぎょうたいせい	分業体制
ぶんきょうだいがく	文教大学
ぶんきょうがくえん	文京学園
ぶんきょうかんけい	文教関係
ぶんがくぶせんよう	文学部専用
ぶんがくぜんしゅう	文学全集
ぶんがくしょうねん	文学少年
ぶんがくしょうじょ	文学少女
ぶんかてきよういん	文化的要因
ぶんかてきはいけい	文化的背景
ぶんかてきせいかつ	文化的生活
ぶんかつみんえいか	分割民営化
ぶんかつはんたいは	分割反対派
ぶんかつたいしょう	分割対象
ぶんかつじょうほう	分割情報
ぶんかつさんせいは	分割賛成派
ぶんかだいかくめい	文化大革命
ぶんかたいいくかん	文化体育館
ぶんかじんるいがく	文化人類学
ぶんかざいほごほう	文化財保護法
ぶんかけいだいがく	文科系大学
ぶんかけいがくせい	文科系学生
ぶんかかいほうこく	分科会報告
ぶんかかいかつどう	分科会活動
ぶんかいかいしゅう	分解回収
ぶりょくかんしょう	武力干渉
ぶりょくかいにゅう	武力介入
ぶぶんけいさんほう	部分計算法
ぶぶんくうかんほう	部分空間法
ぶひんゆそうりょう	部品輸送料
ぶひんきょうきゅう	部品供給
ぶどうかんたいかい	武道館大会
ぶどうかんこうえん	武道館公演
ぶつりてきよういん	物理的要因
ぶつりてきほうそく	物理的法則
ぶつりてきとくせい	物理的特性
ぶつりてきそんざい	物理的存在
ぶつりてきせいげん	物理的制限
ぶつりてきじつざい	物理的実在
ぶつりてきじったい	物理的実体
ぶつりてきしひょう	物理的指標
ぶつりてきこうぞう	物理的構造
ぶつりてきげんかい	物理的限界
ぶつりてきけいたい	物理的形態
ぶつりじょうほうぶ	物理情報部
ぶつりじっけんしつ	物理実験室
ぶつりしりょうしつ	物理資料室
ぶつりけんきゅうぶ	物理研究部
ぶつりがくじっけん	物理学実験
ぶつりあいこうしゃ	物理愛好者
ぶったいひょうめん	物体表面
ぶっせいぶつりがく	物性物理学
ぶっせいけんきゅう	物性研究
ぶっしつふくせいき	物質複製機
ぶっしつげんしょう	物質現象
ぶっけんしょうけん	物権証券
ぶっきょうぜんぱん	仏教全般
ぶっきょうせいてん	仏教聖典
ぶしゅべつさくいん	部首別索引
ぶしゅにゅうりょく	部首入力
びんじょうしつもん	便乗質問
びわこはくぶつかん	琵琶湖博物館
びょうしゃせいのう	描写性能
びょうきりょうよう	病気療養
びょうがへんしゅう	描画編集
びょうがじょうほう	描画情報
びょうがかいしいち	描画開始位置
びゃくやものがたり	白夜物語
びぶんほうていしき	微分方程式
びぶんだんめんせき	微分断面積
びぶんせきぶんほう	微分積分法
びぶんせきぶんがく	微分積分学
びぶんきかがくてき	微分幾何学的
びせいぶつばいよう	微生物培養
びじゅつぜんしゅう	美術全集
びじゅつけいがくぶ	美術系学部
びじゅつきょういく	美術教育
びじゅつかんちょう	美術館長
びじゅつかんしょう	美術観賞
びじゅつあいこうか	美術愛好家
びしょうでんきょく	微小電極
びしょうじょまんが	美少女漫画
びしょうじょせんし	美少女戦士
ばんゆういんりょく	万有引力
ばんめんひだりうえ	盤面左上
ばんにんびょうどう	万人平等
ばんにんきょうつう	万人共通
ばんざいさんしょう	万歳三唱
ばんこくきょうつう	万国共通
ばんぐみほうえいじ	番組放映時
ばんぐみへんせいき	番組編成期
ばんぐみはいきゅう	番組配給
ばんぐみかいへんき	番組改編期
ばんがいこうしえん	番外甲子園
ばりうむかごうぶつ	バリウム化合物
ばけんはつばいまえ	馬券発売前
ばいばいこうしょう	売買交渉
ばいぞうかんていど	倍増感程度
ばいせいどひょうじ	倍精度表示
ばいせいどじっすう	倍精度実数
ばいせいどえんざん	倍精度演算
ばいしんいんせいど	陪審員制度
ばいしょうせきにん	賠償責任
ぼうりょくだんしきん	暴力団資金
ぼうりょくしょうせつ	暴力小説
ぼうはんれんらくじょ	防犯連絡所
ぼうすいだんねつせい	防水断熱性
ぼうこくりつだいがく	某国立大学
ぼうえんきょうぶぶん	望遠鏡部分
ぼうえききゅうすいぶ	防疫給水部
ぼうえいだいがっこう	防衛大学校
ぼうえいしせつちょう	防衛施設庁
ぼうあいがんどうぶつ	某愛玩動物
べいはんきゅうしょく	米飯給食
べいしきしゅうきゅう	米式蹴球
べいこくにゅうこくじ	米国入国時
べいこくしょてんめい	米国書店名
べいこくしゅっこくじ	米国出国時
べいこくおろししょう	米穀卸商
ぶんれつしょうきしつ	分裂症気質
ぶんみゃくじょうほう	文脈情報
ぶんみゃくいぞんせい	文脈依存性
ぶんぽうてきたいおう	文法的対応
ぶんぽうてきせっきん	文法的接近
ぶんぽうてききじゅつ	文法的記述
ぶんべつしゅうしゅう	分別収集
ぶんせきてきしゅほう	分析的手法
ぶんしょがぞうしょり	文書画像処理
ぶんしょうひょうげん	文章表現
ぶんしょうちゅうしん	文章中心
ぶんしどうりょくがく	分子動力学
ぶんしでんしこうがく	分子電子工学
ぶんししゅうごうたい	分子集合体
ぶんさんとうめいせい	分散透明性
ぶんさんしょりもでる	分散処理モデル
ぶんさんしょりきのう	分散処理機能
ぶんさんきょうちょう	分散協調
ぶんさんかんけいしき	分散関係式
ぶんさんかそうきおく	分散仮想記憶
ぶんげいひょうろんか	文芸評論家
ぶんげいしゅんじゅう	文藝春秋	文芸春秋
ぶんかてきよっきゅう	文化的欲求
ぶんかてきふうしゅう	文化的風習
ぶんかつしんぎちゅう	分割審議中
ぶんかじょしこうこう	文華女子高校
ぶりょくこうしけつぎ	武力行使決議
ぶらくしゅっしんしゃ	部落出身者
ぶぶんどうちかんけい	部分同値関係
ぶぶんてきさいてきか	部分的最適化
ぶひんさいりようほう	部品再利用法
ぶつりてきたいしょう	物理的対象
ぶつりてきじょうしき	物理的常識
ぶつりてきじょうけん	物理的条件
ぶつりてきしょうがい	物理的障害
ぶつりてきげんしょう	物理的現象
ぶつりてきかんきょう	物理的環境
ぶつりてきかいしゃく	物理的解釈
ぶつりていこくしゅぎ	物理帝国主義
ぶつりがっかいゆうし	物理学会有志
ぶつりがくけんきゅう	物理学研究
ぶつりがくきょうしつ	物理学教室
ぶつりがくきょういく	物理学教育
ぶつりがくえんしゅう	物理学演習
ぶっしつてきほしょう	物質的補償
ぶっきょうきょうてん	仏教教典
ぶきかんれんゆしゅつ	武器関連輸出
びゃくやしょぼうばん	白夜書房版
びせいぶつぞうしょく	微生物増殖
びじゅつはくぶつかん	美術博物館
びじゅつしにゅうもん	美術史入門
びじゅつかんしょぞう	美術館所蔵
びじゅつかんいんよう	美術館員用
びしょうりったいかく	微小立体角
びしょうじょまんがか	美少女漫画家
びしょうじゅうりょく	微小重力
ばんりのちょうじょう	万里の長城
ばんどうたまさぶろう	坂東玉三郎
ばんこくはくらんかい	万国博覧会
ばんぐみめいへんこう	番組名変更
ばんぐみせいさくしゃ	番組制作者	番組製作者
ばんぐみじょうほうし	番組情報誌
ばんぐみしゅうりょう	番組終了
ばんぐみかんけいしゃ	番組関係者
ばらじゅうじうんどう	薔薇十字運動
ばくはつしょうじょう	爆発症状
ばくしょうげきじょう	爆笑劇場
ばいばいしょうこきん	売買証拠金
ばいせきさいばんかん	陪席裁判官
ばいせいどふくそすう	倍精度複素数
ばいしょうせいきゅう	賠償請求
ばいしゅんぼうしほう	売春防止法
ばいしゅうきょうそう	買収競争
ばいかたんきだいがく	梅花短期大学
ぼしゅうようこうちゅう	募集要項中
ぼしゅうけっかほうこく	募集結果報告
ぼくじょうかんけいしゃ	牧場関係者
ぼうりょくだんしんぽう	暴力団新法
ぼうだいがくこうがくぶ	某大学工学部
ぼうじどうしゃがいしゃ	某自動車会社
ぼうえいちょうかいはつ	防衛庁開発
べんきょうふじゅうぶん	勉強不十分
べんきょうきかんちゅう	勉強期間中
べつりょうきんたいけい	別料金体系
べいこくりょこうちゅう	米国旅行中
べいこくないしゅうゆう	米国内周遊
べいこくかがくがっかい	米国科学学会
ぶんみゃくじゆうげんご	文脈自由言語
ぶんぱいきしゅつりょく	分配器出力
ぶんしょさくせいちゅう	文書作成中
ぶんしょいんさつきのう	文書印刷機能
ぶんしゅんまんがしょう	文春漫画賞
ぶんさんれんそうきおく	分散連想記憶
ぶんさんへいれつしょり	分散並列処理
ぶんさんじんこうちのう	分散人工知能
ぶんさんしょりこうぞう	分散処理構造
ぶんさんかんりほうしき	分散管理方式
ぶんがくさいにゅうもん	文学再入門
ぶんかつじょうしゃけん	分割乗車券
ぶんかちょうちょうかん	文化庁長官
ぶらくかいほうどうめい	部落解放同盟
ぶらくかいほううんどう	部落解放運動
ぶぶんでんかかいぎょう	部分電化開業
ぶぶんそうかんけいすう	部分相関係数
ぶつりてきじょうきょう	物理的状況
ぶつりてきさいげんせい	物理的再現性
ぶつりてきあんていせい	物理的安定性
ぶつりがくてきほうそく	物理学的法則
ぶつじょうほしょうにん	物上保証人
ぶっしつてきじゅうそく	物質的充足
ぶっしつせいめいかがく	物質生命科学
ぶっけんこうにゅうしゃ	物件購入者
ぶじょくてきひょうげん	侮辱的表現
びょうりがくきょうしつ	病理学教室
びょうげんたいかんせん	病原体感染
びじゅつしゅっぱんしゃ	美術出版社
びしょうじゅうりょくか	微小重力下
ばんだいあたみおんせん	磐梯熱海温泉
ばんぐみひょういちらん	番組表一覧
ばんぐみしゅうりょうご	番組終了後
ばんぐみかいしとうしょ	番組開始当初
ばんえつじどうしゃどう	磐越自動車道
ばくはつてきりゅうこう	爆発的流行
ばいきゃくきぼうかかく	売却希望価格
ぼうえいちょうちょうかん	防衛庁長官
ぶんろくけいちょうのえき	文禄慶長の役
ぶんみゃくじゆうぶんぽう	文脈自由文法
ぶんみゃくいぞんぶんぽう	文脈依存文法
ぶんぽうがくしゅうきのう	文法学習機能
ぶんせきごうせいふごうか	分析合成符号化
ぶんしょへんしゅうちゅう	文書編集中
ぶんしょこうぞうかきやく	文書構造化規約
ぶんしょけんさくほうしき	文書検索方式
ぶんしせいぶつじょうほう	分子生物情報
ぶんさんひょうげんもでる	分散表現モデル
ぶんさんしょりかんきょう	分散処理環境
ぶんさんきょうゆうめもり	分散共有メモリ
ぶんさんかんきょうちゅう	分散環境中
ぶんげいしゅんじゅうしゃ	文芸春秋社
ぶんきょうじょしたんだい	文京女子短大
ぶんかじょしだいすぎなみ	文化女子大杉並
ぶつりてきたいしょうせい	物理的対称性
ぶつりてきけいぞくじかん	物理的継続時間
ぶつりがくけんきゅうしょ	物理学研究所
ぶつりがくけんきゅうかい	物理学研究会
びじゅつしょせんもんてん	美術書専門店
びじゅつかんれんぜんぱん	美術関連全般
びさいこうぞうけんきゅう	微細構造研究
ばんこくゆうびんれんごう	万国郵便連合
ばんぐみしゅうろくちゅう	番組収録中
ばいしょうせいきゅうけん	賠償請求権
ばいかいへんすうひょうじ	媒介変数表示
ぼしゅうようこうせいきゅう	募集要項請求
ぼうりょくだんたいさくほう	暴力団対策法
べいこくにゅうしゅっこくじ	米国入出国時
べいこくしんぞうきょうかい	米国心臓協会
べいこくこくぼうそうしょう	米国国防総省
ぶんしょさくせいかんきょう	文書作成環境
ぶんしょうりかいのうりょく	文章理解能力
ぶんしょうひょうげんりょく	文章表現力
ぶんししんけいせいぶつがく	分子神経生物学
ぶんいちそうごうしゅっぱん	文一総合出版
ぶつりがくてきそくていほう	物理学的測定法
ぶっけんてきせいきゅうけん	物権的請求権
ばんゆういんりょくていすう	万有引力定数
ばっきんとうりんじそちほう	罰金等臨時措置法
ぶんしょうぎじゅつきょういく	文章技術教育
ぶんさんきょうぶんさんぎょうれつ	分散共分散行列
ぶんかじょしだいすぎなみこうこう	文化女子大杉並高校
