
を	惡	雄	牡	緒	男	惜	小	汚	悪	尾
ゐ	居
わ	琶	侘	話	割	倭	沸	羽	訳	詫	萵	把	分	破	輪	涌	我	湧	啝	杷	吾	環	和
をう	翁
わん	綰	万	彎	湾	豌	腕	萬	王	弯	椀	灣	碗
われ	我	吾
わる	惡	悪	÷
わり	割	割り
わら	嗤	藁	笑	稿	和良	原
わや	和谷
わめ	叫	喚
わび	侘	詫	佗
わの	輪乗
わに	王仁	鰐	和邇
わな	輪投	罠
わと	和綴
わて	和手
わち	和智	和知
わだ	和田
わた	綿	亘	腸	緜	渡	航	渉	棉	亙
わせ	早稲	早生
わず	微	僅	毫	纔
わす	忘
わじ	和字
わし	和紙	儂	鷲
わざ	態	伎	術	技	業
わご	和語
わけ	理由	分け	和気	譯	訳	分
わく	惑	枠	或
わぎ	和議	和木	輪切
わき	和氣	沸き	腋	和気	脇	和紀
わが	我	和賀
わか	理解	別	頒	判	解	和歌	觧	分	若
わう	皇	黄	王	往	横
わい	歪	猥	隈	矮	薈	賄	淮
をんな	女
わんず	万子
われら	我等	我們	我ら
われめ	割れ目
われし	我知
われき	和暦
わるよ	悪酔
わるび	悪怯
わるさ	悪さ
わるぎ	悪気
わるお	悪男
わりめ	割目
わりふ	割振	割符	割り振
わりび	割引	割り引
わりに	割に
わりと	割と
わりつ	割付	割り付
わりだ	割り出	割出
わりこ	割込	割り込
わりき	割り切	割切
わりい	割り入
わりあ	割り合	割り当	割当	割合
わらわ	童	妾
わらべ	童
わらぶ	藁葺
わらび	藁火	蕨
わらじ	草鞋	鞋
わらし	童
わらく	和楽
わらい	笑	笑い	\(笑\)	（笑）
わよう	和洋	和様
わやく	和訳
わもの	倭物	和物
わめい	和名
わむし	輪虫
わぼく	和睦
わほん	和本
わほう	話法
わへい	和平	話柄
わぶん	和文
わふつ	和仏
わふく	和服
わふう	和風
わびね	侘寝
わびし	侘
わはん	和版
わぬけ	輪抜け
わなな	戦慄
わなげ	輪投げ
わどめ	輪留め	輪止め
わどく	和独
わどう	和銅
わとじ	和綴じ
わづら	煩
わづか	和束
わつじ	和辻
わっぷ	割賦
わっか	輪っか
わだち	和達	轍
わだい	話題
わたる	弥	亘	渡	航	渉	道	亙
わたり	亘	渡り	渡	亘理
わたや	渡谷	綿屋
わたべ	渡部
わただ	和多田
わたせ	渡瀬	綿瀬
わたし	私	渡し
わたげ	綿毛
わぞく	倭族
わそう	和装
わせん	和船	和戦
わせだ	早稲田
わせき	和積
わせい	和生	和声	和製	話声
わずら	煩	患
わすれ	忘れ
わすう	話数
わじん	和人	倭人
わじま	和嶋	輪島	和島
わじき	鷲敷
わしん	和親
わしょ	和書
わしゅ	和種
わしゃ	話者
わしみ	鷲見
わしま	和島
わしづ	鷲津
わしつ	和室
わしず	鷲巣
わしざ	鷲座
わしき	和式
わしか	鷲家
わしお	鷲尾
わざわ	和沢	災	禍	厄
わざら	和皿
わざと	態と
わざし	業師
わさん	和讃	和算
わさび	山葵
わさい	和裁
わごん	和琴
わごむ	輪ゴム
わごう	和合
わこん	和魂
わこく	倭国
わこう	和寇	和孝	和幸	倭寇	若生	和光
わげい	話芸
わけめ	分け目
わけべ	分部
わけな	訳無
わけし	訳知
わけぎ	分葱
わけい	和敬	分け入
わけあ	分け合
わくり	和久利	和栗
わくら	和倉
わくや	涌谷
わくだ	和久田
わくた	和久田
わくぐ	枠組
わくい	和久井	涌井
わぎり	輪切り
わきん	和金	和巾
わきろ	脇艪
わきや	脇谷
わきめ	脇目
わきみ	わき見	脇見
わきま	弁
わきで	湧き出
わきて	脇手
わきづ	脇付
わきた	脇田	沸き立
わきじ	脇侍	脇士
わきし	脇師
わきこ	和貴子
わきげ	脇毛	腋毛
わきが	腋臭
わきお	湧き起
わきあ	沸き上
わがや	我家	我が家
わがみ	我身	我が身
わがな	我名
わがし	和菓子
わがこ	吾子
わがく	和楽
わかん	和姦	和漢
わかれ	別れ
わかめ	若布	若芽
わかみ	若美
わかば	若葉
わかな	若菜	和佳奈
わかと	若戸
わかて	若手
わかた	若田
わかせ	若瀬
わかす	若洲
わかさ	若さ	若狭	若佐
わかこ	和歌子	和佳子
わかげ	若気
わかぎ	若木	若気
わかき	若木
わかお	稚郎
わかい	和諧	若井	和解	和賀井
わおん	和音
わえい	和英
わいろ	賄賂
わいど	歪度
わいく	矮躯
わいが	淮河
わいか	矮化	猥歌
わんぱく	腕白
わんぱい	王牌
わんない	湾内
わんとう	湾頭
わんだね	椀種
わんたん	雲呑
わんこつ	腕骨
わんこう	湾口
わんぎり	ワン切り
わんがん	湾岸
わんがた	碗型
わんがい	湾外
われわれ	我々	我我
われもの	割れ物
われひと	我人
われなべ	破れ鍋	割れ鍋
われさき	我先
われごえ	破れ声
われから	割殻
わるよい	悪酔い
わるやく	悪役
わるもの	悪者	悪物
わるのり	悪ノリ	悪乗り
わるどめ	悪止め
わるぢえ	悪知恵
わるだま	悪玉
わるだく	悪巧
わるずれ	悪擦れ
わるじえ	悪知恵
わるぐち	悪口
わるくち	悪口
わるがき	悪餓鬼	悪ガキ
わるいこ	悪い子
わりやす	割安
わりもど	割り戻	割戻
わりまし	割増	割増し
わりまえ	割前
わりふり	割り振り
わりびき	割り引き	割引
わりばし	割り箸	割箸
わりつけ	割り付け	割付	割付け
わりだし	割出し	割り出し
わりだか	割高
わりした	割下
わりざん	割り算	割算
わりこみ	割込み	割込	割り込み
わりがき	割書
わりかん	割勘	割り勘
わりかた	割方
わりいん	割り印	割印
わりいし	割石
わりあて	割当て	割当	割り当て
わりあい	割合
わらわべ	童部
わらぶき	藁葺き
わらなわ	藁縄
わらしや	藁谷
わらぐつ	藁沓
わらくず	藁屑
わらがみ	藁紙
わらがい	藁谷
わらいだ	笑い出
わめきち	喚き散
わめきた	喚き立
わびちゃ	侘び茶	侘茶
わびずま	侘住
わびごと	詫び言
わのうち	輪之内
わにぐち	鰐口
わにがわ	鰐皮
わどまり	和泊
わっさむ	和寒
わちゅう	話中
わだやま	和田山
わだつみ	海童	海神
わだけん	和田研
わだかま	蟠
わだいこ	和太鼓
わたりあ	渡り合
わたらい	度会
わたゆき	綿雪
わたもり	渡森
わたむら	綿村
わたびき	綿引
わたのは	渡波
わたぬき	綿貫
わたなべ	渡邉	渡邊	渡辺	渡部
わたどの	渡殿
わたたに	綿谷
わたしら	私等
わたしゃ	私ゃ
わたしば	渡し場
わたしの	私の
わたしこ	渡し込
わたごみ	綿ゴミ
わたぐも	綿雲
わたくり	綿繰り
わたくし	私
わたがし	棉菓子	綿菓子
わたかべ	渡壁
わたうち	綿打ち
わたいれ	綿入れ
わたあめ	綿飴
わせいや	和声屋
わせいか	和声化
わずらい	患い	煩い
わすれさ	忘れ去
わじるし	わ印
わじゅん	和順
わじゅつ	話術
わじゅう	輪中
わしょく	和食
わしみや	鷲宮
わしばな	鷲鼻
わしのぎ	鷲之樹
わしづか	鷲掴
わしさか	鷲坂
わざわい	禍	災い	災
わざもの	業物
わざせん	技戦
わこうど	若人
わこうし	和光市
わけまえ	分け前
わけどり	分け取り
わけしり	訳知り
わけがら	訳柄
わけかた	分け方
わけあた	分け与
わくれん	枠連
わくらん	惑乱
わくらば	病葉
わくもん	或問
わくべつ	湧別
わくばん	枠番
わくなし	枠無し
わくない	枠内
わくでき	惑溺
わくせん	枠線
わくせい	惑星	枠制
わくぐみ	枠組	枠組み
わくきん	枠金
わくがい	枠外
わくおち	枠落
わくいり	枠入り
わぎょう	わ行	ワ行
わぎゅう	和牛
わぎほう	和議法
わきょう	和協
わきやま	脇山
わきやく	脇役
わきもん	脇門
わきもと	脇本
わきむら	脇村
わきみち	脇道
わきみず	湧き水
わきまえ	弁え
わきばら	わき腹	脇腹
わきはま	脇浜
わきのう	脇能
わきでら	脇寺
わきづけ	脇付
わきだて	脇楯
わきだち	脇立
わきすじ	脇筋
わきざし	脇差
わきさか	脇坂
わきがた	脇固
わきかた	脇方	ワキ方
わきかえ	沸き返
わがもの	我が物
わがまま	我がまま	我侭	我儘
わがはい	我輩	吾輩	我が輩	吾が輩
わがとう	我が党
わがつま	我妻
わがっき	和楽器
わがしや	和菓子屋
わがしゃ	我社	我が社
わがこと	我がこと
わがくに	わが国	我が国	我が國
わかわか	若々
わかれめ	分かれ目
わかりき	分かり切
わかやま	若山	和歌山
わかやく	若役
わかもり	若森
わかもの	若者
わかむら	若村
わかむき	若向き
わかみや	若宮
わかみず	若水
わかまつ	若松
わかはら	若原
わかはげ	若禿
わかどり	若鶏
わかとの	若殿
わかづま	若妻
わかづく	若作
わかつき	若月	若槻
わかちあ	分かち合
わかたべ	若田部
わかたに	若谷
わかたけ	若竹
わかたか	若貴
わかぞう	若僧	若造
わかすぎ	若杉
わかじに	若死に
わかじし	若獅子
わかしゆ	沸かし湯
わかしゅ	若衆
わかしま	若島
わかざり	輪飾り
わかさま	若様
わかさと	若里
わかさぎ	公魚	若鷺
わかさき	若桜木
わかごま	若駒
わかくわ	若桑
わかくさ	若草
わかぎみ	若君
わかがき	若書き
わかがえ	若返
わかえだ	若枝
わかいろ	若色
わかあゆ	若鮎
わいろう	矮陋
わいほん	猥本
わいない	和井内
わいだん	猥談
わいだて	脇楯
わいせつ	猥褻
わいせい	矮星	矮性
わいじん	矮人
わいざつ	猥雑
わいおく	矮屋
をことてん	乎古止点
わんりょく	腕力
わんりゅう	湾流
わんにゅう	湾入	彎入
わんちゃい	湾仔
わんじょう	椀状
わんしょう	腕章
わんこそば	椀子蕎麦
わんきょく	彎曲	湾曲	弯曲
われながら	我ながら	我乍ら
われしらず	我知らず
わるだくみ	悪巧み
わるがしこ	悪賢
わるあそび	悪遊び
わるあがき	悪足掻き
わりもどし	割り戻し	割戻し
わりこみじ	割り込み時
わらべうた	童歌
わらぶとん	藁蒲団
わらばんし	藁半紙
わらじむし	草鞋虫
わらじばき	草鞋履
わらいもの	笑い者	笑い物
わらいつづ	笑い続
わらいごと	笑い事
わらいごえ	笑い声
わらいころ	笑い転
わらいぐさ	笑い種
わらいくず	笑い崩
わらいがお	笑い顔
わらいかた	笑い方
わらいかえ	笑い返
わやくぶん	和訳文
わめきごえ	喚き声
わへいあん	和平案
わぶんもじ	和文文字
わびずまい	侘住い	侘び住まい
わびじょう	詫状
わっかない	稚内
わだいぬし	話題主
わだいせい	話題性
わだいさく	話題作
わたりもの	渡り者
わたりどり	渡り鳥
わたりぞめ	渡り初め
わたりぐん	亘理郡
わたりがに	渡蟹
わたりある	渡り歩
わたぼうし	綿帽子
わたしもり	渡し守
わたしぶね	渡船	渡し船
わたしども	私供
わたしたち	私達	私たち
わたしこみ	渡し込み
わたしかた	渡し方
わたしあて	私宛
わたくしぎ	私儀
わそうぼん	和装本
わせだどお	早稲田通
わせだだい	早稲田大
わせだじん	早稲田陣
わせださい	早稲田祭
わせだぐち	早稲田口
わせいほう	和声法
わせいてき	和声的
わせいがく	和声学
わすれもの	忘れ物
わじんでん	倭人伝
わじまぬり	輪島塗
わしんとん	華盛頓
わしょっき	和食器
わしゃない	話者内
わしゃすう	話者数
わしゃかん	話者間
わしづかみ	鷲掴み
わさんぼん	和三盆
わさびづけ	山葵漬
わごんしゃ	ワゴン車
わこくぼん	和刻本
わこうまえ	和光前
わこうどう	和光堂
わけへだて	別け隔て
わくじゅん	枠順
わきばしら	脇柱
わきのさわ	脇野沢
わきづくえ	脇机
わがしよう	和菓子用
わがしてん	和菓子店
わかんよう	和漢洋
わかんやく	和漢薬
わかんしょ	和漢書
わかれみち	別れ道
わかりやす	分かり易	理解り易	判り易
わかやまし	和歌山市
わかやなぎ	若柳
わかむしゃ	若武者
わかみどり	若緑
わかまつく	若松区
わかふうふ	若夫婦
わかばやし	若林
わかばだい	若葉台
わかはなだ	若花田
わかのはな	若乃花	若ノ花
わかてきし	若手棋士
わかてかい	若手会
わかづくり	若作り
わかちがき	わかち書き	分かち書き
わかだんな	若旦那
わかたけに	若竹煮
わかせがわ	若瀬川
わかしらが	若白髪
わかしゅう	若衆
わかしまづ	若嶋津
わかさわん	若狭湾
わかさだに	若狭谷
わかがしら	若頭
わかおんな	若女
わかいもの	若い者
わかいずみ	和解済
わいしょう	矮小
わいきょく	歪曲
わんりょくは	腕力派
わんたんめん	ワンタン麺	雲呑麺
わんそくるい	腕足類
わんがんせん	湾岸線
わりやすかん	割安感
わりましきん	割増金
わりびきりつ	割引率
わりびきさい	割引債
わりびきけん	割引券
わりつけがく	割付額
わりだかかん	割高感
わりじょうゆ	割り醤油
わりぐりいし	割栗石
わりあてせい	割当制
わらいばなし	笑い話
わようちゅう	和洋中
わようじょし	和洋女子
わようくだん	和洋九段
わぼうちょう	和包丁
わへいかいぎ	和平会議
わふうきっさ	和風喫茶
わにりょうり	鰐料理
わどくじてん	和独辞典
わていしょく	和定食
わたりろうか	渡り廊下
わたりちょう	亘理町
わたりぜりふ	渡り台詞
わたらせがわ	渡良瀬川
わたしりゅう	私流
わたしひとり	私一人
わたしじしん	私自身
わたしこじん	私個人
わたしいがい	私以外
わたくしりつ	私立
わたくしばん	私版
わたくしども	私共
わたくしごと	私事
わたくしあて	私宛
わせだりこう	早稲田理工
わせだぶつり	早稲田物理
わせだきかい	早稲田機械
わせいりろん	和声理論
わせいえいご	和製英語
わすれなぐさ	勿忘草
わすれがたみ	忘れ形見
わしょくどう	和食堂
わしゅうざん	鷲羽山
わしゅうごう	∪	和集合
わくせいめい	惑星名
わくせいけい	惑星系
わくせいかん	惑星間
わきあいあい	和気藹藹	和気藹々
わがものがお	我が物顔
わかれわかれ	別れ別れ
わかればなし	別れ話
わかやまだい	和歌山大
わかやません	和歌山線
わかやまけん	和歌山県
わかやまかん	和歌山間
わかものやく	若者役
わかものむき	若者向
わかものたち	若者達
わかむらさき	若紫
わかばやしく	若林区
わかばまーく	若葉マーク
わかばちょう	若葉町
わかなえいろ	若苗色
わかどしより	若年寄
わかてさっか	若手作家
わかしゅどう	若衆道
わかくさいろ	若草色
わかおくさま	若奥様
わえいじてん	和英辞典
わえいじしょ	和英辞書
わいせつぶつ	猥褻物
わいしょうか	矮小化
わいしかんぎ	矮子看戯
わりびきりょう	割引料
わりびきてがた	割引手形
わりびきせいど	割引制度
わりびきしょう	割引証
わりびききっぷ	割引切符
わりびきかかく	割引価格
わりあてかのう	割当て可能
わらにんぎょう	藁人形
わらいじょうご	笑い上戸
わぶんろんぶん	和文論文
わぶんでんしん	和文電信
わぶんだいもく	和文題目
わふうけんちく	和風建築
わどうかいほう	和同開宝	和同開珎
わどうかいちん	和同開珎
わっかないかん	稚内間
わっかないえき	稚内駅
わだいまんさい	話題満載
わだいふっとう	話題沸騰
わだいそうぜん	話題騒然
わだいこうかん	話題交換
わだいげんてい	話題限定
わたなべかずお	渡辺一夫
わたなべかざん	渡辺崋山
わたしたちあて	私達宛
わせだほうこう	早稲田方向
わせだだいがく	早稲田大学
わせだこうけん	早稲田工研
わせだおうぶつ	早稲田応物
わせいじゅつご	和製術語
わせいしんこう	和声進行
わしゃにんしき	話者認識
わしゃどうてい	話者同定
わしゃてきおう	話者適応
わさびじょうゆ	山葵醤油
わこんようさい	和魂洋才
わこんかんさい	和魂漢才
わこうどうじん	和光同塵
わくらおんせん	和倉温泉
わきみうんてん	脇見運転
わきはまちょう	脇浜町
わかものことば	若者言葉
わかまつちょう	若松町
わかまつしでん	若松市電
わかとおおはし	若戸大橋
わかてぶつりや	若手物理屋
わかてたんとう	若手担当
わかてたいけつ	若手対決
わかてせんしゅ	若手選手
わかてげいにん	若手芸人
わかだいしょう	若大将
わおんれんけつ	和音連結
わおんにんしき	和音認識
わおうぶんかん	和欧文間
わーるどかっぷ	Ｗ杯
わんがんふんそう	湾岸紛争
わんがんせんそう	湾岸戦争
わんがんしょこく	湾岸諸国
わんがんかいはつ	湾岸開発
わるものだんたい	悪者団体
わりましうんちん	割増運賃
わりびきはんばい	割引販売
わりびきうんちん	割引運賃
わりだかうんちん	割高運賃
わようせっちゅう	和洋折衷
わようじょしだい	和洋女子大
わへいすいしんは	和平推進派
わへいこうしょう	和平交渉
わっかないしない	稚内市内
わだいていきょう	話題提供
わせだこしょがい	早稲田古書街
わしつちゅうしん	和室中心
わこうしょうけん	和光証券
わくせいたんさき	惑星探査機
わくせいかんじん	惑星間塵
わかやまぼくすい	若山牧水
わかやまほうめん	和歌山方面
わかやまてつどう	和歌山鉄道
わかやまだいがく	和歌山大学
わかやなぎちょう	若柳町
わかもとせいやく	わかもと製薬
わかてちゅうしん	若手中心
わかてがいやしゅ	若手外野手
わかしおこくたい	若潮国体
わいせつぶんしょ	猥褻文書
わんがんせんそうじ	湾岸戦争時
わりびきりょうきん	割引料金
わりだかりょうきん	割高料金
わぶんつうわひょう	和文通話表
わっかないこうえん	稚内公園
わちゅうきょうどう	和衷協同
わたなべじゅんいち	渡辺淳一
わたくししょうせつ	私小説
わこんようさいてき	和魂洋才的
わくじゅんかくてい	枠順確定
わぎゅうしょうほう	和牛商法
わかやまけんちょう	和歌山県庁
わかまつつうしょう	若松通商
わかくさものがたり	若草物語
わいきょくしゅうさ	歪曲収差
わりびきこうくうけん	割引航空券
わだいふっとうちゅう	話題沸騰中
わだいていきょうしゃ	話題提供者
わせいしんこうじょう	和声進行上
わくじゅんはっぴょう	枠順発表
わかんろうえいしゅう	和漢朗詠集
わかやませんごじょう	和歌山線五条
わかてけんきゅうしゃ	若手研究者
わりびきちょうせいがく	割引調整額
わくせいじょうせいうん	惑星状星雲
わかんたいしょうひょう	和漢対照表
