お	乎	終	於	帯	苧	圧	押	桜	降	雄	捺	牡	下	逐	墮	緒	御	淤	壓	穂	将	推	男	落	唹	起	惜	嗚	夫	小	勇	生	汚	老	織	墜	負	塢	折	帶	追	悪	怖	怒	朗	麻	置	尾	堕	擱	措	郎	央	居	和
え	選	囘	会	笑	恵	画	榎	餌	杖	柄	重	會	依	回	獲	惠	慧	猥	衣	繪	江	枝	畫	懷	荏	絵	得	衛	衞
う	浮	迂	膿	産	売	兎	撲	齲	失	搏	享	卯	賣	芋	倦	射	于	攵	烏	飢	菟	承	饂	盂	傴	紆	右	胡	羽	討	生	泛	茹	受	夘	有	攴	嫗	績	熟	鵜	請	植	得	宇	打	雨	撃	挧	埋	憂	禹
い	囗	容	尉	堰	去	異	鰄	遺	維	意	苡	亥	帷	謂	鋳	痿	肄	揖	好	椅	出	凍	良	萎	頤	矣	詑	射	胆	爲	伊	行	慰	井	逸	依	癒	貽	渭	怡	李	夷	五	畏	偉	可	鮪	移	斐	幃	倚	已	衣	猪	蔚	為	易	活	惟	以	彝	恚	生	善	胃	淹	莞	唯	韋	緯	逶	煎	彜	忌	僞	如	入	懿	威	詒	往	矮	言	醫	饐	熨	要	彙	炒	ゐ	圍	云	囲	委	痍	鑄	医	逝	噫	偽	猗	姨	居	違	位	洟
あ	當	惡	会	飽	遇	亜	宛	蓬	椏	揚	亞	合	倦	飫	會	擧	該	充	厭	安	娃	褪	敢	嗚	逢	遭	挙	相	有	唖	浴	痾	襾	空	荒	悪	韲	開	明	併	在	編	阿	上	当	婀	哇	或	和
おん	恩	穩	御	穏	音	園	怨	遠	瘟	温	隱
おわ	御座	終	尾羽	終わ	在
おろ	下	卸	悪露	疎	愚
おれ	俺	折れ
おり	澱	檻	織	折
おら	己
およ	泳	及	游	御読	凡
おゆ	お湯
おや	親
おも	想	面	重	御持	お持	主	思
おめ	御目
おみ	臣	尾美	麻績
おま	御負	お待
おぼ	憶	溺	覚	覺	思
おほ	覆	被	凡
おぺ	手術
おぶ	負
おび	誘	帯	脅	怯	帶	飫肥	小尾
おば	叔母	伯母	尾羽	小母	小場
おは	尾羽
おの	自	己	尾野	斧	小野
おね	尾根
おに	鬼
おな	女	同
おど	戯	躍	縅	脅	威	踊	踴
おと	劣	音	落	訪	乙
おて	御手	お手
おづ	小津
おつ	榲	膃	乙	御告
おっ	追っ
おち	尾知	墜ち	落ち	陥	落	堕ち	越智	越知
おだ	織田	穩	小田	穏	纓田	煽
おた	織田
おぞ	悍	鈍
おそ	遅	憶	恐	教	惧	畏	臆	虞	遲	怖	懼	襲
おぜ	小瀬	尾瀬
おせ	尾瀬
おず	小津
おす	雄	牡	♂	お酢
おじ	叔父	伯父	小父	怖
おし	鴛	教	忍	御知	お知	惜し	唖	押し
おざ	尾座
おさ	収	收	抑	圧	押	壓	修	長	納	治
おご	奢	傲	驕
おこ	痴	遣	行	起こ	起	熾	怒	興
おけ	桶	於け
おく	遅	憶	奧	奥	臆	檍	屋	邑久	億	送	尾久	遲	贈	後
おぎ	小城	小木	蒹	荻	尾木
おき	沖	起き	置き	隠岐	熈	お気	熾	お聞	澳	興	燠	煕	御聞
おが	拝	拜	男鹿
おか	可笑	陵	奇	丘	侵	阜	峻	崗	岡	陸	岳	犯	冒
おお	蔽	覆	應	多	被	雄々	大	応	夛	仰	奄
おえ	小江	汚穢
おう	惶	汪	鴎	鏖	蓊	襖	瓮	皇	應	櫻	閘	嘔	泱	鞅	押	桜	殴	媼	黄	懊	悒	墺	欧	凹	嚶	奧	奥	泓	鴬	翁	怏	邑	殃	旺	罌	鴨	枉	徃	凰	王	浤	往	謳	秧	応	澳	横	姶	歐	鸚	甌	央	毆
おい	於	美味	及	笈	追	老い	甥
おあ	御会
えん	鴛	堰	艷	薗	蜿	偃	掩	魘	焉	宛	焔	閼	渕	轅	渊	閹	悁	嚥	櫞	圓	寃	燕	冤	厭	沿	簷	園	讌	鉛	蜒	湲	衍	宴	縁	援	筵	怨	炎	塩	嫣	婉	烟	遠	淹	篶	煙	黶	覃	￥	捐	爰	媛	檐	臙	垣	猿	鹽	閻	艶	延	円	演	淵	鳶	圜	掾	袁	奄	苑
えろ	エロ
えり	絵理	枝里	恵利	惠理	絵里	衿	英理	愛莉	衣里	愛理	襟	恵里	絵莉	恵理	江利	衣理
えら	選	江良	腮	択	偉	鰓
えみ	笑	映見	江民	笑み	絵美	恵美	栄美	恵実	江見
えま	絵麻	江馬	絵馬
えぽ	ＥＰＯ
えべ	江辺
えび	海老	蝦	鰕	蛯
えの	榎
えに	縁
えな	絵奈	恵那	胞衣
えど	江戸	穢土
えと	干支	江渡	絵解
えて	得手
えづ	餌付
えつ	粤	咽	越	戉	噎	鉞	悦	絵付	閲	謁
えち	乢
えだ	江田	枝	荏田
えた	穢多
えぞ	蝦夷
えそ	狗母魚	壊疽
えせ	似非	似而非
えず	絵図
えじ	江地	衛士
えし	画師	絵師	壊死
えさ	餌
えこ	依怙
えげ	会下
えぐ	刳	刔	抉
えぎ	江木
えき	役	繹	疫	駅	掖	液	腋	蜴	依帰	亦	易	懌	益	伯	奕	驛
えが	描
えか	絵描
えい	鋭	泳	縊	瑛	蠑	穎	栄	暎	塋	営	榮	楹	咏	郢	瑩	營	叡	翳	英	映	衡	嬰	珱	詠	贏	潁	瓔	永	睿	盈	洩	瀛	頴	曵	裔	纓	絵入	殪	頴娃	衛	影	曳	衞
うん	紜	蘊	黄	慍	曇	繧	運	褞	吽	雲	耘	云	薀	暈
うわ	浮	宇和	上
うろ	雨露	空洞	迂路	空
うれ	末	愁	嬉	憂
うる	潤	宇留	得る
うり	瓜
うら	占	麗	恨	怨	裏	浦	裡錙
うよ	紆余	紆餘
うや	礼
うも	芋
うめ	梅	呻	楳
うむ	有無	孳
うみ	膿	海	生	宇美
うま	午	美味	巧	旨	生	上手	馬
うべ	宜	宇部
うぶ	産	初心	初
うば	奪	乳母	姥
うは	右派
うの	宇能	宇野	鵜飲	う飲	鵜呑	鵜野
うね	疇	有年	畝	畦	畆	畴	宇根
うぬ	己
うに	雲丹	海胆
うな	魘	項	唸	鰻
うど	独活
うと	宇土	疎	宇都	踈
うで	腕
うて	右手
うづ	宇津
うつ	暎	欝	映	移	蔚	寫	鬱	遷	伝染	空	写	虚	冩
うち	内	欝	中	家	鬱	打ち
うだ	宇陀	宇田
うた	謌	謡	歌	唄	詠	謳	宇田	唱	謠	詩
うそ	鷽	嘘	嘯
うず	疼	右図	渦	埋
うす	碓	薄	臼	有珠
うじ	蛆	宇治	氏
うし	失	丑	牛	齲歯	後
うざ	ウザ
うさ	右左	宇佐	憂さ
うご	動	雨後	羽後
うけ	槽	有卦	筌	食
うぐ	迂愚
うく	宇久
うき	浮	憂き	泛子	右記	雨季	雨期	浮き	浮子
うが	穿	鑿
うか	浮	浮か	合格	雨下	羽化
うお	宇夫	魚
うえ	↑	飢え	植	上
うぇ	ヱ
うい	宇井	初	有為
うぃ	ヰ
いん	婬	蔭	員	咽	贇	院	允	茵	尹	隕	韵	韻	音	飮	姻	胤	酳	氤	寅	湮	引	飲	殞	陰	蚓	廴	隱	慇	印	隠	殷	淫	霪	堙	因
いわ	岩	祝	巖	謂	違和	言わ	曰	磐
いろ	艷	色
いれ	入れ
いり	伊理	入	入り	杁	圦
いら	苛	貸	弄	答	応
いよ	伊予	壱与	伊代
いや	弥	否	癒	厭	嫌	卑	賤	祖谷	彌
いも	芋	妹	藷	薯
いめ	夢
いむ	諱	医務	異夢
いみ	意味
いま	未	今	在	居間
いぼ	贅	異母	疣	揖保	肬
いべ	井部	伊部
いぶ	威武	息吹	気吹	ＥＶＥ	伊武	慰撫	燻
いふ	委付	畏怖	異父	依附
いび	依微	揖斐
いば	伊庭	威張	射場	井場
いは	伊波
いの	祈	井野	猪	猪野	伊野
いね	伊根	禾	稻	稲
いぬ	射貫	狗	居抜	犬	戌
いな	伊那	否	稻	伊奈	稲	伊南
いど	緯度	井戸	挑	異土
いと	異図	愛	意図	厭	糸	絲	縷	伊都	射止
いで	出澤	出	井出	井手
いて	射手
いづ	伊津
いつ	軼	一	何時	聿	逸	厳	弌	五	壱	鴪	鎰	居着	佚	壹	乙	伍	溢	稜威
いっ	行	逸	言
いち	市	一	弌	壱	１	Ｉ	位置	伊知	壹	1	依遅
いだ	伊田	懐	委佗	井田	抱
いた	傷	到	痛	致	慯	板	愴	悼	炒	至	労
いぞ	居反
いそ	磯	急	五十	勤
いせ	伊勢
いず	伊豆	伊津	孰	何
いす	椅子	倚子
いじ	異字	苛	遺児	依次	弄	維持	意地	依恃	医事
いし	遺志	縊死	遺子	医師	遺址	意思	石	遺思	意志
いざ	膝行	躄
いさ	諌	異差	諫	伊佐	勇
いご	以後	囲碁	動	伊語
いこ	憇	射込	依怙	憩	鋳込
いけ	不可	池
いぐ	伊具
いく	幾	粥	毓	礇	育	鬻	生	燠	畏懼	郁
いぎ	異義	威儀	異議	意義	猪木
いき	位記	委棄	行	行き	息	生	遺棄	域	囲気	意気	生き	熱	閾	粹	粋	壱岐
いが	啀	伊賀	毬
いか	伊香	如何	何如	医家	厳	≦	烏賊	位下	異化	忿	怒	以下	医科
いお	魚
いえ	家	伊江	癒え	彌
いい	伊井	謂	猪井	依依	依違	猪	依倚	井伊	飯	唯々
いあ	依阿	居合
あん	鮟	餡	暗	庵	闇	編ん	杏	諳	晏	閼	行	罨	鞍	安	按	案	黯	菴
あわ	閔	安房	淡	合	周章	泡	粟	憐	阿波	哀	併	慌
あれ	荒れ
ある	歩	亜留	或る	或
あり	袵	阿梨	蟻	有	衽
あら	麁	粗	洗	新	表	現	荒	非
あゆ	阿諛	歩	鮎
あや	絢	亜也	文	殺	怪	亜矢	彩	礼	彪	危	妖	恠	禮	綾	亜弥
あも	母	餅
あめ	天	飴	雨
あむ	虻
あみ	罔	醤蝦	阿見	亜美	網	网	阿弥
あま	海士	天	甘	尼	餘	海女	海人	余	雨	蜑	塰	亜麻
あぼ	英保	安保	阿母
あほ	阿呆
あべ	阿武	阿部	阿倍	安部	安倍
あぶ	阿武	炮	虻	炙	危	焙	溢
あふ	押	凹	亜父	阿父	溢
あび	浴	阿比	阿鼻
あば	暴	網端	発	阿波	浮子
あね	姐	姉
あに	阿仁	兄	豈
あな	坑	穴	孔
あど	亜土
あと	踪	痕	跡	atto	蹟	後
あで	艶
あて	宛	当て	貴
あつ	乢	篤	蒐	集	遏	纂	圧	閼	壓	輯	扱	敦	斡	淳	軋	熱	暑	惇	聚	厚
あっ	圧
あち	閼	窪地	阿智
あだ	讎	徒	讐	仇	婀娜
あた	邊	与	與	新	辺	能	邉	中	当
あそ	安蘇	阿蘇	阿曽	遊	游
あぜ	畦	畔
あせ	阿瀬	焦	汗
あず	預
あす	明日
あじ	味	鰺	庵治	鯵
あし	脚	惡	芦	葦	足	悪	悪し	蘆
あざ	字	痣	鮮
あさ	安佐	淺	浅	厚狭	朝	麻	阿佐	漁
あご	阿児	顎
あこ	亜古	赤	亜子
あげ	揚げ	揚	安芸	上	上げ
あけ	明け	暁	曉	朱	明
あぐ	倦
あく	惡	阿久	軛	握	灰汁	齷	渥	空	悪	幄	堊	明く
あぎ	阿木	亜木
あき	晢	昭	煥	顕	晃	光	呆	穐	亜希	暁	朖	空き	秋	章	彬	亜樹	安芸	龝	亜紀	璋	空	彰	哲	安岐	朗	晶	明	晰	晶紀	亜季	晄	亮
あが	騰	足掻	崇	挙が	上が	揚が	上
あか	證	亜科	絳	赫	赤	紅	垢	淦	明	閼伽	灯	明か
あお	青	蒼	呷	碧	煽	仰
あえ	喘	敢	敢え	阿江
あう	櫻	桜	媼	奧	奥	央
あい	亜衣	藹	会	愛	合	欸	埃	阨	穢	娃	靉	曖	相	藍	挨	間	隘	哀	饗	瞹	姶	噫
ああ	嗚呼	噫
おんわ	穏和	温和
おんる	遠流
おんり	遠離	厭離
おんよ	音読
おんみ	御身
おんぷ	音譜	音符	♪
おんび	音引	音尾
おんひ	音飛
おんぱ	音波	恩波
おんば	穏婆	音場
おんな	恩名	同	音奈	♀	女	恩納
おんど	音戸	温度	音頭
おんと	音吐
おんち	音痴	恩地
おんだ	音田	恩田
おんそ	音素
おんじ	音字	陰地
おんし	恩師	恩旨	恩賜	恩私
おんざ	穏座
おんさ	音叉
おんこ	恩顧
おんぎ	恩義	恩誼	御義	音義
おんき	遠忌	恩紀
おんが	遠賀	温雅
おんか	恩暇	恩仮	恩化	音価
おんい	恩威
おわり	終	尾張	終り	終わり
おわら	お笑
おわび	お詫び
おわだ	小和田
おわた	お渡
おわせ	尾鷲
おわす	お忘
おわか	お若	お別
おわい	汚穢	浄穢
おろち	大蛇
おろそ	疎
おろし	卸	颪
おろか	疎か	愚か
おれら	俺ら
おれめ	折れ目
おれま	折れ曲
おれい	御礼	お礼
おりや	織屋
おりも	織茂	折茂
おりめ	折目	織り目	折り目	織目
おりま	織り交	折り曲
おりべ	織部
おりば	降り場
おりな	織り成
おりど	折戸
おりた	降り立	織田	下り立
おりこ	織り込	折り込	折込	織込
おりき	織機
おりお	折尾
おりい	折り入
おりあ	折合	折り合	折悪
および	及	及び
およそ	凡そ
おゆび	拇
おやみ	小止み
おやま	女形	雄山	尾山	御山	小山
おやべ	小矢部
おやど	御宿
おやだ	親田
おやす	お安	お休
おやじ	親字	親爺	親父
おやご	親御
おやこ	母子	親子
おやけ	小宅
おやく	御役	お役
おやき	親機	親器
おもわ	面輪
おもり	お守り	重り	錘
おもゆ	重湯
おもや	母屋
おもも	面持
おもめ	重め
おもむ	赴	趣
おもみ	重み	重味
おもは	面映
おもね	阿
おもに	主に	重荷
おもな	主な
おもと	御許
おもて	面	表
おもだ	主立	重立
おもす	重過
おもし	重石
おもざ	面差
おもさ	重さ
おもご	面河
おもい	想い	思い	重茂	思
おめし	御召
おめが	Ω	ω
おめい	汚名
おむろ	御室
おむな	嫗
おむつ	繦
おみま	御見舞
おみね	小峰
おみな	女	嫗
おみせ	御店	お店
おみず	お水
おみき	お神酒	御神酒
おまも	御守
おまち	雄町	お待ち
おまた	尾又	尾股	小俣
おまえ	御前	お前
おまい	御参	御前
おぼん	お盆
おぼろ	朦	朧
おぼし	思し	男星
おぼえ	覚え	憶え
おへや	お部屋
おぶね	小舟
おぶつ	汚物
おぶち	小渕	尾駮
おぶせ	小布施
おぶさ	綬
おぶき	小吹
おふろ	お風呂
おふれ	御触れ
おふる	お古
おふゆ	雄冬
おふみ	御文
おふだ	御札
おふせ	御布施
おびれ	尾鰭
おびら	小平
おびや	脅
おびと	首
おびつ	帯津	小櫃
おびじ	帯地
おびえ	怯え
おひれ	尾鰭	尾ひれ
おひる	お昼
おひや	御冷や
おひま	お暇	御暇
おひつ	御櫃
おひさ	御久	お久
おばら	小原
おばま	小浜
おばな	尾花	雄花
おばた	小畑	小俣	小幡
おばけ	お化け
おばか	おバカ
おはら	尾原	小原	大原
おはな	お花
おはつ	お初
おはせ	生長谷	小長谷
おはし	御箸
おはこ	十八番
おはぎ	御萩
おのれ	己
おのぼ	御上
おのの	戦
おのだ	小野田
おのず	自
おのこ	男子
おのぎ	小野木
おのき	小野木
おのお	小野尾
おのえ	尾上
おねが	お願	御願
おぬま	小沼
おにび	鬼火
おにば	鬼歯
おにし	鬼石
おにご	鬼子
おにく	お肉	尾肉
おなり	御成
おなみ	男波
おなべ	小鍋
おなじ	同じ	ゝ	〃	々
おなご	女子
おなが	尾長	翁長
おなか	お腹
おない	尾内	小内
おどろ	棘	驚	愕
おどれ	己
おどり	踊り
おどし	脅し	縅
おどけ	戯け
おどき	男時
おとわ	音羽
おとろ	衰
おとり	劣り	囮
おとも	お伴	御供	御伴	お供
おとめ	夫妻	夫婦	少女	乙女
おとべ	乙部
おとは	乙葉
おとな	訪	大人
おとど	御届	お届
おとと	弟
おとだ	音田	音出
おとそ	お屠蘇
おとず	訪
おとし	落とし	落し	お年	貶
おとこ	漢	♂	男
おとぎ	音切	御伽
おでん	御田
おでら	小寺
おでし	御弟子
おでき	御出来
おでい	汚泥
おてん	汚点
おてら	お寺
おてま	お手間
おてあ	御手上	お手上
おづつ	尾筒
おづき	小月
おつり	お釣
おつゆ	御汁
おつや	お通夜	御通夜
おつつ	現
おつじ	尾辻
おつげ	お告げ	御告げ
おつか	お疲	お使
おっと	夫
おって	追っ手	追手	追って
おっつ	追っ付
おった	押っ立	追っ立	おっ立
おっか	追っ掛
おぢや	小千谷
おちゃ	御茶	お茶
おちめ	落ち目
おちぼ	落穂	落ち穂
おちぶ	零落	落魄
おちば	落葉	落ち葉
おちの	落ち延
おちど	落ち度	落度	越度
おちつ	落着	落ち着
おちち	お乳
おちご	御稚児
おちこ	落ち込
おちえ	御知恵
おちい	陷	陥
おちあ	落ち合
おだん	オ段
おだや	穏
おだべ	小田部
おだに	小谷
おだて	煽て
おだけ	織田家	雄竹
おだく	汚濁
おだぎ	小田木
おだか	尾高	小高
おだい	御題	お題	お代	小田井
おたる	小樽
おたり	小谷
おたま	御玉	お玉
おたべ	小田部
おたび	御旅
おたち	お発ち
おたず	お尋
おたけ	雄叫
おたく	お宅
おたが	お互	御互
おたか	御高
おぞま	悍	鈍	悍ま
おぞけ	怖気
おそん	汚損
おそろ	恐
おそれ	恐れ	怐	畏れ	虞
おそる	惶
おそめ	遅目	遅め
おそま	遅蒔
おそば	御側	遅場
おそで	遅出
おそし	遅し
おそざ	遅咲
おそい	襲
おぜん	お膳
おぜき	小関	尾関
おせん	汚染
おせわ	お世話	御世話
おせち	御節
おせじ	お世辞	御世辞
おすみ	お済み
おすだ	小須田
おすす	お勧
おすし	お寿司
おすき	お好き
おすい	汚水
おじろ	尾白
おじま	尾島	小島
おじけ	怖気
おじぎ	御辞儀
おじき	伯父貴	叔父貴
おじか	牡鹿	小値賀
おしん	悪心
おしろ	お城
おしり	お尻
おしよ	押し寄
おしや	押し遣
おしめ	押目	繦	押し目	襁
おしま	小島	渡島	押し曲
おしべ	雄蕊
おしば	押葉	押し葉
おしの	忍野	押し退
おしね	晩稲
おしな	押し並
おして	押手
おしつ	押し付
おしだ	押し出	押田
おした	押し立
おしさ	押し下
おしこ	押し込
おしげ	惜しげ
おしき	折敷	押し切	御仕着
おしか	牡鹿	押し掛
おしお	押尾
おしえ	押絵	教え
おしう	押し売
おしい	押し入	押井
おしあ	押し開	押し合	押し当	押し上
おざわ	小澤	尾沢	小沢
おざさ	小笹
おざく	小作
おざき	尾前	小崎	尾崎
おさん	お産
おさら	お皿
おさめ	納め
おさむ	理	収	治虫	修	御寒	納	治
おさみ	修美
おさべ	長部
おさな	幼
おさと	長都
おさつ	お札
おさっ	御察
おさだ	長田
おさげ	お下げ	御下げ
おさけ	お酒
おさぎ	兎
おさき	御先	お先
おさか	小坂	苧坂	尾坂
おさえ	抑え
おごり	奢り	驕り	傲り
おごと	雄琴
おごそ	嚴	厳
おごせ	越生
おごし	生越
おこわ	御強
おこり	瘧
おこめ	お米	御米
おこの	お好
おこな	行	行な
おこた	怠
おこぜ	虎魚
おこし	お越し	小越
おこげ	御焦げ
おこえ	御声
おこう	汚行
おける	於ける
おけら	螻蛄
おけや	桶屋
おけと	置戸
おけつ	悪血
おぐろ	小黒
おぐり	小栗
おぐら	小椋	小倉
おぐま	小熊
おぐに	小国
おぐち	尾口	小口
おぐし	御髪	小串
おぐさ	小草
おくれ	遅れ
おくら	憶良	お蔵	御蔵
おくゆ	奥行
おくめ	奥目
おくみ	袵	衽
おくほ	奥穂
おくば	奥歯
おくの	奥乃	奥野
おくに	阿国
おくど	奥土
おくで	奥出
おくて	奥手
おくつ	奥津
おくち	奥地
おくだ	奥田
おくせ	奥瀬
おくこ	億個
おくぎ	奥義	奥儀
おくか	奥処
おくい	奥井	奥居
おぎろ	頤
おぎの	荻野	荻布
おぎな	補
おぎつ	荻津
おぎた	小木田	荻田
おぎそ	小木曽
おきや	置き屋	置屋
おきめ	沖目
おきみ	沖美
おきび	熾火	置き引	燠火
おきば	置場	置き場
おきぬ	起き抜
おきな	翁	奥菜
おきて	諚	沖手	掟
おきづ	お気付
おきつ	興津
おきだ	起き出
おきた	起き立	沖田	小木田
おきそ	小木曽
おきす	沖洲
おきじ	置字	置き字
おきざ	置き去
おきご	置き碁
おきが	置き掛
おきか	置き代	置き変	置換	置き換
おきあ	起き上
おがわ	尾河	尾川	緒川	小河	小川
おがら	麻幹
おがゆ	小粥
おがや	小萱
おがみ	男神	尾上
おがの	小鹿野
おがつ	雄勝
おがた	尾形	緒方	緒形	小方	小形
おがさ	小笠
おがい	小粥
おかん	お燗	惡寒	悪寒
おかゆ	小粥
おかや	岡谷
おかめ	傍目
おかみ	女将	御上	傍見	岡見
おかま	お釜
おかぼ	陸稲	傍惚	岡惚
おかべ	岡部
おかぶ	御株	雄株
おかの	岡野
おかね	お金
おかど	尾角
おかと	岡登
おかつ	雄勝
おかだ	岡田
おかた	お方	御方	岡田
おかし	お菓子
おかげ	お蔭	お陰	御陰	御蔭
おかお	お顔
おかえ	お帰	御返	岡江
おかい	小粥	汚怪
おおん	御
おおよ	凡
おおゆ	大湯
おおや	大家	大屋	大谷	大宅	大矢
おおも	大盛
おおめ	大目	多目
おおむ	御	概
おおみ	大見	大身
おおま	大負	大間
おおほ	大穂
おおぶ	大府	大降
おおば	大葉	大庭	大羽	祖母	大場
おおの	大野
おおね	大根
おおな	大名
おおど	大戸
おおで	大手
おおて	大手
おおづ	大詰	大津
おおつ	大津
おおち	邑智
おおだ	大田
おおた	大田	太田
おおせ	大瀬	仰せ
おおず	大洲
おおす	大須	多過
おおじ	王寺	祖父	大路
おおし	お教	御教	凡
おおさ	大佐
おおご	大胡	大湖
おおぐ	大食
おおく	お送	御送	多く
おおぎ	青木	扇	仰木
おおき	大城	大木
おおが	大賀	大掛
おおえ	大江	大兄
おおう	奥羽	大受
おおい	大飯	大炊	大井
おおあ	大荒	大当
おえつ	嗚咽
おうろ	往路	欧露
おうら	邑楽
おうめ	青梅
おうむ	雄武	王蟲	鸚鵡
おうみ	近江	青海
おうま	逢魔
おうぼ	応募
おうひ	王妃	奥秘
おうに	黄丹
おうな	翁	嫗	媼
おうど	黄土	王土
おうと	嘔吐	王都
おうて	追手	王手
おうち	尾内	お家	楝	相知	欒	樗	邑智
おうだ	殴打
おうた	桜多
おうそ	応訴
おうせ	逢瀬
おうす	御薄
おうじ	王地	王寺	往事	王子	欧字	往時	皇子
おうし	牡牛	黄紙	雄牛	横死
おうざ	王座
おうご	朷
おうこ	往古
おうげ	応化
おうけ	王家
おうぎ	扇	奥義	横議	奥儀
おうが	横臥
おうか	桜花	応化	押下	欧化	謳歌	王化	櫻花
おうう	奥羽
おうい	横位	王位
おうあ	欧亜	歐亞
おいわ	お祝	お岩
おいや	追い遣
おいめ	負い目
おいべ	及部
おいぬ	追い抜
おいて	於	於て	追風
おいつ	老津	追い詰	追い付
おいち	尾市	お市	追い散
おいだ	追出	追い出
おいた	追い立	置いた	生い立
おいこ	追い込	追い越	老い込	追込
おいけ	御池
おいか	追い掛
おいお	追い落
おいえ	尾家
おいう	追い討
おいあ	追い上
おーれ	ＯＲＥ
おーむ	Ω	王蟲
えんろ	遠路
えんる	遠流
えんり	厭離
えんゆ	縁由
えんや	塩冶	艶冶
えんむ	煙霧
えんま	閻魔
えんぶ	演武	円舞	演舞
えんぴ	猿臂	円匙
えんび	燕尾	塩ビ
えんど	塩度
えんち	園池	園地	遠地
えんだ	苑田	円建	遠田
えんた	苑田	遠田
えんそ	塩酢	遠祖	Cl	塩素	Chlorine
えんじ	園児	槐	臙脂	衍字
えんし	艶姿	遠視
えんざ	円座	縁坐	縁座	宴座	円坐
えんさ	怨嗟
えんご	縁語	援護	掩護
えんこ	縁故	塩湖	円弧
えんげ	嚥下
えんぎ	延喜	縁起	演義	演技
えんき	延期	塩基	縁切
えんか	艶歌	嚥下	怨歌	円価	演歌	縁家	円貨	塩化
えんお	厭悪
えんう	煙雨
えんい	遠位
えりみ	恵里美
えりな	江理奈
えりさ	恵利沙
えりこ	恵理子	江利子	悦吏子	絵梨子	英里子	えり子	英理子	恵里子	江里子	江梨子	絵理子
えりぐ	襟刳
えりか	恵理香	絵里花	江利香	惠理香
えらさ	偉さ
えもん	衣紋	衛門
えもの	得物	獲物
えもと	絵本	柄本	江本
えもじ	絵文字
えむら	江村
えみり	恵美里
えみや	江美弥	円宮
えみし	蝦夷
えみこ	英美子	絵己子	江美子	絵美子	恵美子	栄美子
えみか	恵美香
えまき	絵巻
えぼし	烏帽子
えほん	絵本
えほう	吉方	恵方
えべつ	江別
えふで	絵筆
えふだ	絵札
えびら	箙
えびね	恵比根
えびな	海老名	蝦名	蛯名
えびぞ	海老反
えびす	胡	恵比寿	戎	夷	狄	恵比須	貊	蛭子
えひめ	愛媛
えばら	荏原	江原
えばた	江端
えはら	荏原	江原
えはだ	絵肌
えはた	江畑	江幡
えのと	榎戸
えのこ	狗
えのぐ	絵の具	絵具
えのき	榎木	榎
えぬま	江沼
えぬこ	Ｎ個
えにわ	恵庭
えにし	縁
えなり	江成
えなみ	榎並
えなつ	江夏
えなが	柄長
えどや	江戸屋
えどま	江戸間
えどき	江戸期
えどえ	江戸絵
えとく	会得
えとき	絵解き
えとう	江藤	恵藤	衛藤	江頭
えてき	絵的
えづけ	餌付け
えつり	桟
えつよ	悦代
えつや	悦哉	悦也
えつじ	悦次	悦司
えつこ	絵津子	悦子	英津子	恵津子	えつ子
えつお	悦夫
えっか	越夏
えちご	越後
えだん	エ段
えだわ	枝分
えだぶ	枝振
えだは	枝葉
えだの	枝野
えだち	役
えだげ	枝毛
えだが	枝刈
えだか	枝刈
えたい	得体
えぞら	江面
えぞち	蝦夷地
えぞえ	江副
えぞう	絵像
えずみ	江角
えすは	Ｓ波
えじま	江島	江嶋
えじき	餌食
えしき	会式
えざわ	江沢	江澤
えざら	絵皿
えざき	江崎
えさん	恵山
えさや	餌屋
えさば	餌場
えさし	江差	江刺	枝幸	江指
えさぎ	餌木
えさき	江崎
えさか	江坂
えごま	荏胡麻
えこん	慧根
えこだ	江古田
えこじ	依怙地
えこう	回向
えけい	恵瓊
えぐみ	刳味
えぐち	江口
えくぼ	靨
えくさ	exa
えぎぬ	絵絹
えきり	疫痢
えきや	駅家
えきむ	役務
えきひ	液肥
えきね	駅寝
えきす	越幾斯
えきが	腋芽
えきか	腋窩	腋下	液果	液化
えきう	駅売
えがわ	江川
えがら	絵柄
えがみ	江上
えがた	得難
えがお	笑顔
えかき	絵描き	絵書き
ええた	η	Η
えいん	会陰
えいわ	英和	永和
えいろ	嬰ロ
えいり	栄利	絵入り	営利	鋭利
えいよ	栄誉
えいみ	詠美
えいほ	嬰ホ
えいへ	嬰ヘ
えいは	嬰ハ
えいに	嬰ニ
えいと	嬰ト
えいち	英知	叡知	叡智	睿智
えいだ	栄田	英田
えいた	英太
えいじ	英二	英字	英司	栄二	英次	永治	英志	鋭二	英史	栄次	英嗣	永二	英児	英治	嬰児	栄治
えいし	英紙	英姿	衛士	英詩	詠史	英資	衛視
えいご	英五	英語
えいこ	映子	英子	栄枯	瑛子	江威子	永子	暎子	栄子
えいき	盈虧	永記	鋭気	英気
えいが	栄華	映画	栄画
えいか	詠歌	穎果
えいい	鋭意	嬰イ	栄位	営為
えーた	η
うんよ	運良
うんゆ	運輸
うんも	雲母
うんむ	雲霧
うんぼ	雲母
うんの	海野
うんし	運指
うんき	温気	運気
うんが	運河
うんか	浮塵子	雲霞
うんう	雲雨
うわん	右腕
うわや	上屋
うわめ	上目
うわむ	上向
うわみ	上身	宇和海
うわべ	上辺
うわひ	上翳
うわば	上履
うわの	上乗	宇和野
うわね	上値
うわぬ	上塗
うわに	上荷
うわて	上手
うわづ	上積
うわず	上澄	上擦
うわさ	噂
うわぎ	上着	上衣
うわき	浮気
うわが	上書
うわか	上書
うわえ	上絵
うろん	胡乱
うろた	狼狽
うろこ	鱗
うろう	傴僂
うれゆ	売行
うれし	嬉し
うれえ	憂え	愁え	慯
うれう	悄
うれい	愁い	騷	恙	憂い
うるわ	麗
うるめ	潤目
うるち	粳
うるた	粳田
うるし	漆
うるさ	煩	五月蝿	騒
うるき	売木
うるか	潤香
うるお	潤
うるう	閏
うるい	潤
うりん	雨林
うりゅ	雨龍
うりや	売り家
うりば	売場	売り場
うりの	売野
うりね	売値	売り値
うりぬ	売り抜
うりと	売り飛
うりて	売り手	売手
うりつ	売り付
うりだ	売り出	売出
うりこ	売り込	売り越	売子
うりき	売り切
うりか	売り買	ウリ科
うりお	売惜	売り惜
うりう	瓜生
うりあ	売り上	売上
うらん	U	Uranium
うらわ	浦和
うらる	烏拉
うらら	麗ら	麗
うらや	羨
うらめ	裏目
うらむ	怏
うらみ	浦見
うらほ	裏帆
うらべ	浦辺	占部	浦部	卜部	裏部
うらば	裏葉
うらの	浦野
うらな	占	裏投	卜
うらど	裏取
うらて	裏手
うらづ	裏付
うらち	浦地
うらた	浦田
うらせ	浦瀬
うらじ	裏地
うらさ	浦佐
うらぎ	裏切
うらが	浦賀
うらえ	浦江
うらう	裏打
うらあ	裏編
うよく	右翼
うよう	右葉
うゆう	烏有
うやま	宇山	敬
うもん	宇門
うもう	羽毛
うめみ	梅見
うめの	梅野
うめづ	梅津
うめつ	埋め尽
うめだ	楳田	梅田
うめた	埋め立	梅田
うめず	楳図	梅津	梅酢	梅図
うめこ	埋め込	梅子	埋込
うめき	呻き	埋木
うめあ	埋め合
うむき	蛤
うみべ	海辺
うみの	海野
うみづ	海釣
うみつ	産み付
うみだ	生み出	産み出
うみお	産み落
うまれ	生まれ	生	生れ
うまら	茨
うまや	廏	馬屋	廐	厩
うまみ	旨味	旨み
うまば	馬場
うまの	馬野	馬乗
うまに	馬荷	甘煮
うまじ	馬路
うまご	孫
うまこ	馬子
うほう	右方
うべな	諾
うへん	羽片	右辺
うぶゆ	産湯
うぶや	産屋
うぶめ	産女
うぶげ	産毛
うぶぎ	産着
うばい	優婆夷
うのみ	鵜呑み	鵜呑
うのけ	宇ノ気
うのき	卯木	宇野木	卯野木	鵜木
うのう	右脳
うねめ	采女
うねま	畝間
うねび	畝傍
うぬぼ	自惚	己惚
うなり	唸り
うなだ	項垂
うなず	頷
うなじ	項
うなぎ	鰻
うなが	促
うない	宇内
うどん	饂飩
うどり	羽鳥
うどの	鵜殿
うとろ	宇登呂
うとく	宇徳	有徳
うとう	宇藤	宇籐
うでわ	腕輪
うでぐ	腕組
うでぎ	腕木
うでき	腕利
うでお	腕押
うてん	雨天
うてな	萼	台
うてき	雨滴
うづき	宇津木	卯月
うつわ	噐	器
うつろ	虚	虚ろ	宇津呂
うつも	鬱茂
うつむ	俯
うつみ	慈	宇都美	内海
うつぼ	笂	靱	靭
うつほ	空
うつぶ	俯	うつ伏
うつて	打つ手
うつつ	現
うつせ	虚
うつし	写	写し
うつく	美
うつぎ	宇津木
うつき	宇津木	宇津喜
うつお	靫	空
うつう	鬱紆
うつい	鬱伊
うって	討手
うった	訴
うっす	薄
うっこ	鬱乎
うっき	鬱気
うちわ	団扇	内輪
うちら	内良
うちよ	打ち寄
うちゆ	内湯
うちも	討ち漏
うちみ	打ち身	打見
うちま	打ち負
うちふ	打ち振
うちの	内野
うちぬ	打ち抜	撃ち抜
うちな	打ち鳴
うちど	打ち止
うちと	打ち取	打ち解	討ち取
うちで	打ち出	打出
うちて	討手
うちつ	打ち付
うちだ	内田	打ち出
うちた	打田	打ち立
うちす	打ち捨
うちじ	討ち死
うちこ	撃ち込	打込	打ち込	内子
うちけ	打ち消
うちぎ	袿
うちき	内木	内気	打ち切
うちが	内掛
うちか	打ち勝	打掛	打ち欠	打ち掛
うちお	打ち下	打ち落
うちい	討ち入	内井
うちあ	打ち明	打ち合	撃ち合	打ち上	打合
うだん	ウ段
うだい	宇内	宇大
うたん	右端
うたよ	歌代	詩代
うたの	歌野	宇多野	菟田野
うたて	転
うたづ	宇多津
うたつ	歌津	宇多津
うただ	宇多田
うたた	転
うたこ	詩子	歌子
うたげ	宴
うたぐ	疑
うたが	疑
うたい	謡	謠
うそぶ	嘯
うそじ	嘘字
うそく	右側
うぜん	羽前
うせつ	右折	雨雪
うせい	迂生
うずら	鶉
うずま	渦巻
うずば	渦場
うずの	鶉野
うずど	渦度
うずく	蹲
うずき	宇津木	疼き
うずい	渦位
うすら	薄ら
うすめ	薄目	薄め
うすび	薄日
うすば	薄葉	薄刃
うすで	薄手
うすだ	臼田
うすた	薄田
うすじ	薄地
うすげ	薄毛
うすぎ	薄切	薄着
うすき	臼杵	薄
うすい	碓井	薄井	碓氷	雨水	臼井
うじな	宇品
うじし	宇治市
うじこ	氏子
うじい	雲林院
うしろ	後ろ	後
うしや	牛屋
うしみ	丑三
うしの	牛野
うしね	牛根
うしな	喪	失
うしづ	牛津
うした	牛田
うしく	牛久
うしき	牛木
うしお	牛尾	牛追	潮
うざわ	宇澤	鵜澤	宇沢	鵜沢
うざき	宇崎
うさん	胡散
うさわ	宇沢
うさみ	宇佐見	宇沙美	宇佐美
うさぎ	兎	兔	卯	菟	莵
うごめ	蠢	蠕
うごき	動き
うごう	烏合
うこん	鬱金	右近
うこう	宇高
うげん	迂言	右舷
うげつ	雨月
うけん	宇検
うける	受ける
うけら	朮
うけも	受け持	受持
うけみ	受け身	受身
うけと	受け止	受取	受け取
うけて	受け手
うけつ	受付	受け継	受け付
うけが	肯
うけお	請け負	請負
うけう	請け売	受け売
うけい	受け入	誓約	受け容	右傾	受入
うけあ	請合	受け合	請け合
うぐら	葎
うぐい	鯏
うきわ	浮輪
うきよ	憂き世	浮世
うきめ	憂き目
うきみ	憂き身	浮き身	浮身
うきぼ	浮き彫
うきな	浮名
うきで	浮き出
うきつ	浮津
うきだ	浮き出
うきた	浮田	浮き立
うきす	浮巣
うきぐ	浮具
うきが	浮貸
うきえ	浮江
うきう	浮き浮
うきあ	浮き上
うがん	右岸	右眼
うがく	有学
うがき	宇垣
うがが	伺
うがい	鵜飼	嗽
うかん	有漢
うかわ	鵜川
うかれ	浮かれ
うから	親族
うかみ	窺見
うかつ	迂闊	迂濶
うかじ	宇梶
うかが	伺	覘	窺
うかい	鵜飼	鵜飼い	迂回
うおや	魚屋
うおみ	魚見
うおづ	魚津
うおせ	魚瀬
うおざ	魚座
うおい	魚井
うえん	迂遠
うえよ	上寄
うえや	↑	上矢
うえの	上野	植野
うえつ	植え付	羽越	上付
うえだ	上田	植田
うえた	植田
うえす	上須	上江洲
うえじ	植字
うえこ	植え込
うえき	植え木	植木
ういち	宇一
ういご	初子
うぃり	干莉
いんゆ	引喩	隠喩
いんむ	淫夢
いんぷ	殷富	印譜	陰阜	淫婦
いんぶ	陰部
いんぴ	隠避
いんび	隠微	淫靡
いんば	印旛
いんに	陰に	因位
いんど	印度
いんち	吋	韻致	引致
いんじ	韻字	印字	印璽
いんし	因子	院試	印紙	淫祀	淫祠
いんご	隠語	淫語
いんこ	鸚哥
いんぎ	院議
いんき	陰気	印記
いんが	陰画	因果	印画
いんか	引火	印可	印加	允可	陰窩
いんう	淫雨
いんい	因依	陰萎
いわれ	謂れ
いわや	窟	岩屋	岩谷
いわみ	石見	岩美	岩見
いわま	岩間
いわば	謂わば	岩場	言わば
いわの	岩野
いわね	岩根
いわな	岩魚
いわど	岩戸
いわと	岩戸	磐戸
いわで	岩出
いわて	岩手
いわた	岩田	磐田
いわせ	岩瀬	石瀬
いわし	鰮	鰛	鰯
いわさ	岩佐
いわく	曰く	曰
いわぎ	岩城
いわき	岩木	磐城	岩鬼	岩城
いわお	巌	岩雄	巖	岩夫	岩男	岩尾	岩生	磐
いわい	祝い	祝	磐井	岩韋	岩井
いろん	異論
いろわ	色分
いろり	鈩	囲炉裏	鑪
いろめ	色目
いろは	伊呂波
いろど	彩
いろづ	色付
いろだ	色出
いろこ	色子	色濃
いろけ	色気
いろか	色香
いろお	色落
いろう	慰労	遺漏
いろあ	色褪	色合
いれま	入れ混
いれば	入れ歯	入歯
いれて	入れて
いれた	入れ立
いれこ	入れ子	入籠	入れ込
いれぐ	入れ食
いれき	入木
いれか	入れ替	入れ換
いれい	異例	慰霊	違例	威令
いれあ	入れ揚
いるま	入間
いるす	居留守
いるか	鯆	海豚
いるい	彙類	衣類	異類
いりや	入谷
いりま	入り交
いりべ	入部
いりひ	入り日
いりの	入野
いりた	入田
いりさ	入佐
いりこ	入り込
いりく	入り組
いりき	入来
いりえ	入江	入り江
いらん	伊蘭
いらべ	伊良部
いらぶ	伊良部
いらつ	苛つ
いらだ	苛立
いらこ	伊良湖
いらか	甍
いらえ	応え	答え
いらい	以来	依頼
いよだ	伊與田
いよじ	五代嗣
いよし	伊予市
いよこ	伊代子
いよく	意欲
いよう	異様	威容	医用	偉容
いゆう	畏友
いやみ	厭み	嫌み	厭味	嫌味
いやま	井山	弥増
いやし	鄙	卑し
いやけ	嫌気
いやく	意訳	依約	医薬	違約
いやき	嫌気
いもん	慰問
いもり	井守	井森
いもの	鋳物
いもに	芋煮
いもと	井本	妹	井元
いもじ	鋳物師
いもお	妹尾
いめい	異名	依命	威名	違名	遺命
いむら	井村
いむた	伊牟田
いみん	移民
いみや	井宮
いみな	諱
いみづ	意味付
いみそ	意味素
いみず	射水
いみき	忌寸
いみあ	意味合
いまわ	今際	忌
いまる	井丸
いまり	伊万里
いまや	今や
いまに	今仁
いまど	今戸
いまで	今出
いまづ	今津
いまち	井街
いまだ	未	未だ	今田
いまず	今津
いまし	誡	汝	戒
いまい	今井
いぼく	遺墨
いぼう	依傍	威望
いほん	異本
いほく	以北
いほう	移封	異法	異邦	異方	遺芳	彙報	違法
いへん	韋編	異変
いへや	伊平屋
いへき	胃壁
いぶん	異文	遺文	遺聞	異聞
いぶり	胆振
いぶつ	異物	遺物
いぶせ	井伏
いぶき	息吹	伊吹
いぶか	訝	井深
いふく	威服	衣服	異腹
いふう	異風	威風	遺風
いびつ	歪
いびき	鼾
いひん	遺品
いばん	異版
いばり	尿
いばら	棘	荊	井原	茨
いばく	帷幕
いはん	違犯	違反
いはら	庵原	井原	伊原
いはつ	遺髪	衣鉢
いはく	曰く	威迫	医博
いはい	違背	位牌
いのる	祷
いのり	祷
いのめ	猪の目
いのま	猪摩
いのべ	井ノ部
いのふ	胃の腑
いのち	生命	命
いのだ	伊野田
いのせ	猪瀬
いのこ	居残
いのき	猪木
いのう	異能	衣嚢	伊能	稲生
いねん	為念
いねむ	居眠
いねの	稲野
いねだ	稲田
いねか	イネ科	稲刈
いぬめ	犬目
いぬは	犬派
いぬじ	犬死
いぬき	居抜き
いぬい	乾	犬井
いにん	委任
いなん	以南
いなり	稲荷
いなら	居並
いなや	否や
いなみ	稲美	印南	井波	伊波
いなほ	稲穂
いなべ	員弁
いなぶ	稲武
いなば	因幡	稲葉	稲場
いなの	稲野
いなな	嘶
いなづ	稲津
いなち	稲地
いなだ	鰍	稲田
いなせ	粹
いなず	稲津
いなさ	引佐
いなご	蝗
いなこ	稲子
いなげ	稲毛
いなぎ	稲置	稲木	稲城
いなき	稲木	稲城
いなか	田舎
いなお	居直	稲尾	稲生
いなえ	稲枝
いない	以内	稲井
いどう	移動	異同	医道	異動
いとよ	糸魚
いとめ	厭目	糸目
いとま	暇
いとな	營	営
いとだ	糸田
いとこ	従兄弟	従姉	従弟	従兄	従妹	従姉妹
いとく	威徳	懿徳	遺徳
いとが	糸賀
いとう	依投	伊東	厭う	伊藤	以東
いとい	糸井
いでん	遺伝	異伝	位田
いでゆ	出で湯
いでた	出で立
いてん	移転
いてつ	凍てつ	凍て付
いてざ	射手座
いてき	夷狄
いづれ	孰れ	何れ
いづな	飯綱
いづつ	井筒
いつわ	逸話	五和	五輪	僞	偽
いつも	何時も
いつみ	逸見	逸美
いつづ	居続
いつつ	5つ	５つ	五つ
いつこ	伊都子
いつく	慈
いつき	五木	五紀	五月	樹	斎
いつか	5日	何時か	５日	五日	不知
いつお	逸生	厳夫
いつう	胃痛
いっぽ	一歩
いっぷ	一夫
いっぴ	１日
いっぱ	一波	一派
いっと	一斗	一途	一兎
いって	一手
いっち	一致
いっそ	不如	一噌
いっせ	一瀬	一世
いっし	一死	一志	一糸	一子	一紙	一矢	逸史	一指
いっさ	一茶
いっこ	一己	一戸	1個	一顧	一箇	一ヶ	一個
いっく	一区	一句
いっき	一騎	一気	一期	一機	逸機	一揆	一輝
いっか	一下	一家	一価	一過	一課
いちわ	一羽	一話
いちろ	一路
いちる	一縷
いちり	一利	一理	一里
いちよ	市代
いちょ	遺著
いちや	一夜
いちめ	市女
いちみ	一味
いちぶ	一分	1部	一部
いちば	一馬	市場	一場
いちの	市野
いちに	一二
いちな	一名
いちど	1度	１度	一度
いちと	位置取
いちづ	位置付
いちぢ	伊知地
いちだ	一打	一朶	市田	伊地田
いちせ	一瀬
いちず	一頭	一途	位置付
いちじ	一児	1時	伊知地	１時	一字	１次	一時	1次	一事	一次
いちし	一志
いちざ	一座
いちご	苺	一期	莓	一語
いちこ	一子	市子	伊智子
いちげ	市毛
いちく	移築
いちぎ	一義	位置決
いちき	市來	一木	市来
いちお	一押
いちえ	一会
いちう	一宇
いちい	市井	一意	一井	一位	櫟
いだん	イ段
いだつ	遺脱
いだし	出
いだい	偉大	医大
いたん	異端	医療技術短期大学部	医短
いたわ	労
いたる	格	至	到
いたや	板屋	板矢	板谷
いため	板目
いたみ	伊丹
いたま	板間
いたぶ	甚振
いたば	板場
いたの	板野
いたに	猪谷
いたど	板戸
いたで	傷手	痛手
いたち	鼬
いただ	頂	戴
いたご	板子
いたこ	潮来	板子
いたく	依託	委託
いたい	板井	遺体	異体
いぞん	依存	異存
いぞり	居反り
いぞく	遺族
いぞう	遺贈	以蔵
いそん	依存
いそや	磯谷
いそま	磯間
いそべ	磯部	磯辺
いその	磯野
いそだ	礒田	磯田
いそじ	磯路	五十路
いそし	勤し
いそご	磯子
いそが	忙
いそう	位相	移相	異相	遺草	移送	意想
いぜん	以前	已然	依然
いぜな	伊是名
いぜき	井関
いせん	伊仙	緯線	以浅
いせり	井芹
いせや	伊勢屋
いせつ	異説	移設
いせだ	伊勢田
いせじ	伊勢路
いせき	移籍	遺跡	井関
いせい	為政	異性	異星	以西	遺制	威勢
いずれ	孰れ	何れ
いずも	出雲
いずみ	偉津美	和泉	五住	湶	出水	泉
いずつ	井筒
いずた	泉田
いずし	出石
いずこ	何処
いすわ	居座
いすみ	夷隅	伊角
いすず	いすゞ
いすけ	伊介
いすく	射竦
いすう	位数	異数
いすい	渭水
いじん	異人	偉人
いじり	井尻
いじら	伊自良
いじめ	苛め
いじひ	維持費
いじち	伊地知
いしん	威信	維新	異心	以深	遺臣
いしょ	異書	移書	遺書	医書
いしゅ	異種	意趣	射手	異株
いしや	石屋	石焼
いしゃ	慰謝	医者
いしみ	石見
いしま	石間
いしべ	石部	石辺
いしば	石場
いしの	石野
いしな	石投
いしと	石取
いしづ	石津
いしつ	異質	遺失
いしだ	石田
いしず	石津
いしじ	石地
いしこ	石子
いしげ	石下	石毛
いしぐ	石組
いしく	石工
いしき	伊敷	意識
いしい	石井
いざわ	伊沢	井沢	伊澤
いざり	躄
いざな	誘
いざき	伊崎	井崎
いざい	異材	偉材
いさん	違算	遺産	胃酸	胃散
いさわ	伊沢	井沢	伊澤	石和	井澤
いさり	漁
いさむ	勳	勇	勲
いさみ	勇
いさつ	縊殺
いささ	些	聊
いさご	砂金
いさこ	いさ子
いさく	遺作
いさき	伊佐木
いさか	井坂	伊坂	諍
いさお	烈	功	勲男	勳	勇夫	勲	勇雄
いさい	偉才	異彩	委細	異才
いごん	遺言
いごう	伊号
いこん	遺恨
いこま	居駒	生駒
いこつ	遺骨
いこじ	依怙地	意固地
いこく	異国
いこう	威光	以降	衣桁	移行	維綱	胃腔	遺構	遺稿	偉功	意向	移項	偉効
いこい	憩	憩い
いげん	異言	威厳	威嚴
いげた	井桁
いけん	遺賢	違憲	異見	意見
いけや	池谷
いけべ	池辺
いけの	池野	池乃
いけど	池戸	生け捕
いけだ	池田
いけた	井桁
いけす	生簀	生け簀
いけお	池尾
いけえ	池江
いけい	畏敬	異型	医系	異形
いぐん	威軍
いぐち	井口
いぐさ	藺草	井草	伊草
いくん	遺訓
いくら	居倉	伊倉	幾ら
いくよ	幾夜	郁代	育代
いくや	郁哉	育也
いくみ	育巳
いくま	伊玖磨
いくび	猪首
いくは	的
いくの	生野
いくど	幾度
いくつ	幾つ
いくた	生田	幾多
いくじ	育児	意気地
いくさ	戰	戦	軍
いくこ	以玖子	幾久子	郁久子	育子	郁子
いくお	幾夫	育男	郁生	郁夫	郁雄	幾雄
いくえ	郁恵	育江	幾重
いくい	生井
いぎそ	意義素
いぎす	伊岐須
いぎご	異義語
いきょ	依拠
いきみ	生き身
いきま	息巻
いきば	行き場	行場
いきの	生き延
いきぬ	生き抜	息抜
いきな	生名
いきど	行き止
いきづ	行き詰	息詰
いきつ	息継	行き着	行き付
いきち	閾値	域値	生血	生き血
いきた	息絶
いきせ	息急
いきす	行き過	伊岐須
いきご	意気込
いきぎ	息切
いきき	往き来	一箕	行き来
いきが	行き掛
いきか	閾下	行き交
いきお	勢
いきえ	生き餌
いきう	生き埋
いきい	生き生
いきあ	行き当	行き合
いがん	胃癌	依願
いがわ	井川	居川
いがり	猪狩
いがや	井ヶ谷
いがみ	井上
いがた	范	井形	鋳型	鎔
いがく	医学
いがき	斎垣
いがい	以外	遺骸	意外	貽貝
いかん	医官	異観	遺憾	尉官	偉観	如何	衣冠	移管
いかわ	井川	井河	居川
いかる	鵤	斑鳩
いかり	錨	怒	碇	怒り
いかほ	伊香保
いかひ	異花被
いかの	以下の
いかに	如何に
いかつ	威喝
いかだ	筏
いかた	伊方
いかけ	鋳掛
いかく	威嚇	位格	居角	威赫
いかが	如何
いかい	伊貝	位階	猪飼	異界
いおん	異音
いおり	庵	伊織	菴
いおの	魚野
いおち	庵地
いおか	井岡
いおえ	五百枝
いおう	S	硫黄	Sulfur
いえん	以遠	胃炎
いえる	癒える
いえど	雖
いえで	家出
いえだ	家田
いえじ	家路
いえき	胃液
いえい	家居	遺詠	遺影
いぇん	￥	円
いうら	井浦
いうち	井内
いいん	医員	医院	委員
いいわ	言い分
いいよ	言い寄
いいも	言い漏
いいま	言い曲	飯間	言い負
いいふ	言い触
いいは	言い張
いいの	飯野	言い退
いいね	言い値
いいぬ	言い抜
いいで	飯豊
いいつ	言い付	言い継
いいち	言い散
いいだ	飯田	言い出
いいた	言い立	言い足
いいそ	言い添
いいす	言い捨	言い過
いいし	言い知	飯石
いいこ	言い籠
いいけ	言い消
いいき	言い切	言い聞	異域
いいか	言い交	言い換	言い兼	言い掛	言い替
いいお	言い終	言い置	飯尾
いいあ	言い当	言い合
いあん	慰安
いあわ	居合
いあつ	威壓	威圧
いあく	帷幄
いあい	遺愛	居合
あんり	杏里
あんゆ	暗喩
あんや	暗夜
あんま	按摩
あんぽ	安保
あんぷ	暗譜
あんぶ	鞍部	暗部
あんぴ	安否
あんば	鞍馬
あんの	庵野	安野
あんに	暗に
あんな	杏奈
あんど	安堵
あんち	庵地	安地	安置
あんだ	安打
あんず	杏子	杏
あんじ	暗示	案じ
あんし	晏子	暗視
あんご	安吾
あんこ	暗刻	餡こ	安固
あんぐ	暗愚
あんき	安気	暗鬼	安危	安徽	晏起	暗記	諳記
あんが	安臥
あんか	行火	安価	案下
あんい	安易
あわれ	憐	哀れ
あわら	芦原
あわや	粟屋	淡谷	粟谷
あわび	鰒	蚫	鮑
あわの	阿波野	粟野
あわづ	粟津
あわつ	粟津
あわだ	泡立	粟立
あわた	粟田
あわせ	合わせ	袷
あわず	粟津
あわじ	淡路
あわざ	阿波座
あわさ	粟佐
あわい	間
あろじ	主
あれら	彼等
あれは	荒れ果
あれの	荒れ野
あれち	荒地	荒れ地
あれい	亜鈴	唖鈴
あるじ	主
あるが	有賀
ありや	有家
ありみ	有里巳
ありま	有馬
ありふ	有り触
ありだ	有田
ありた	有田
ありす	有栖
ありざ	有座
ありさ	亜利沙	亜理佐	亜里沙
ありき	有木
ありが	有我	有賀
ありか	亜里香	在処
ありえ	有り得	有家
ありう	有り得
ありあ	有り合
あらん	亜蘭	亜欄
あらわ	顕	露	表	現	著
あられ	霰
あらり	粗利
あらゆ	新湯
あらや	新屋	新谷
あらめ	荒布	荒目
あらの	荒野
あらと	荒砥
あらて	新手
あらだ	荒立
あらた	新太	新	革	検	更	改	荒田	新田	新た
あらそ	争	爭	競
あらず	非ず
あらす	粗過
あらし	嵐
あらこ	荒子
あらけ	有明
あらき	荒木
あらが	抗	争	諍	荒書	爭
あらか	殿
あらお	荒生	荒尾
あらい	新居	荒井	新井
あゆむ	渉
あゆみ	天弓	歩	歩み	亜由美	歩美	亜弓	彩友美
あゆこ	亜佑子
あやめ	菖蒲	文目
あやま	謬	謝	誤	過	阿山
あやべ	綾部
あやの	綾乃	綾野
あやね	綾音
あやつ	操
あやせ	綾瀬	綾世
あやし	愛子	怪し
あやこ	綾子	絢子	彩子	亜也子	亜矢子	文子	操子	亜弥子	章子
あやか	彩香	綾香
あやう	危
あもん	亜門
あもく	亜目
あもい	廈門	厦門
あめふ	雨降
あめに	飴煮
あむろ	安室
あみや	網屋
あみめ	網目	編目
あみの	網野
あみど	網戸
あみだ	編み出	阿弥陀
あみこ	安見子
あみき	編み機
あみか	網掛
あみえ	網江
あみう	網打
あみあ	編み上
あまり	甘利	余り
あまも	雨漏	甘藻
あまみ	甘味	奄美
あまべ	海部
あまの	天野	雨野
あまね	周	普	遍
あまに	甘煮
あまど	雨戸
あまと	天飛
あまて	天照
あまづ	天津
あまつ	天津
あまち	天池	天地
あまだ	雨垂	天田
あまた	数多	天田
あまず	甘酢	甘酸
あます	余す
あまじ	天路
あまし	蔗
あまさ	甘さ
あまご	雨乞
あまこ	尼子
あまぐ	雨具
あまぎ	甘木	亜麻木	天城	雨着
あまき	天木
あまお	雨尾
あまえ	甘え
あぼし	網干
あぼう	安房
あほう	阿呆	阿房
あべの	阿倍野	阿部野
あべた	安部田
あへん	阿片	鴉片
あぶら	膏	脂	油
あぶみ	鐙
あぶな	危な	危
あぶた	虻田
あぶく	泡
あふち	楝	樗
あびる	阿比留
あびこ	安彦	我孫子
あびき	網引
あひる	鶩	家鴨	阿比留
あばれ	暴れ
あばら	肋
あばた	痘痕
あはな	畔放
あのよ	彼の世
あのこ	あの娘
あのう	穴太	安濃
あねご	姐御	姉御
あねき	姉貴
あにや	安仁屋
あにき	兄貴
あにい	兄い
あなん	阿南
あなほ	穴掘
あなば	穴馬	穴場
あなど	侮
あなだ	穴田
あなた	貴女	貴方
あなし	阿梨
あなご	穴子
あなが	強
あなう	穴埋
あない	案内	穴井
あとり	花鶏
あとめ	跡目
あとみ	跡見
あとべ	跡部
あとづ	後付
あとち	跡地
あとお	後押
あとう	阿東
あてみ	当て身
あては	当て嵌
あてね	雅典
あてな	宛名	宛て名
あてど	当て所
あてつ	阿哲	当て付
あてじ	宛て字	当て字	宛字	あて字
あてこ	当て込
あづま	我妻	吾妻	東
あづち	安土
あつら	誂
あつゆ	熱湯
あつや	篤哉
あつめ	厚目	厚め
あつみ	厚見	厚み	温海	渥美	淳美	厚味
あつま	集	集ま	厚真
あつび	熱火
あつで	厚手
あつた	熱田	厚田
あつじ	厚地
あつし	敦司	厚志	敦志	陸	篤	淳	敦史	篤志	篤司	敦士	淳史	敦	充史	篤史	厚
あつさ	暑さ	厚さ
あつこ	篤子	惇子	亜都子	淳子	敦子	温子	あつ子	厚子
あつぎ	厚切	厚着	厚木
あつき	敦紀
あつか	扱
あつお	淳夫	厚雄	敦男	敦夫
あっぴ	安比
あっと	＠
あった	暖	温
あっし	圧死
あっけ	呆気
あっき	悪鬼
あっか	悪貨	悪化
あちわ	阿知波
あだん	ア段
あだな	渾名	綽名	仇名	徒名
あだて	当
あだち	足立	足達	安達
あだう	仇打
あだい	亜大
あたん	亜炭
あたる	中	鼎
あたり	邊	辺り	辺	当り	当たり	邉
あたら	新
あたみ	熱海
あたま	頭
あたた	暖	温
あたし	私
あたご	愛宕
あたけ	安宅
あたく	安宅
あたか	宛	安宅	恰
あたい	値	価	價	値い
あそん	朝臣	遊ん
あそみ	朝臣
あそび	遊び
あそこ	彼処
あそう	阿僧	麻生
あぜん	唖然
あせり	焦り
あせも	汗疹
あせび	馬酔木
あせい	阿世
あずみ	安曇	杏美	安住
あずま	吾嬬	吾妻	東
あずち	安土	堋
あずさ	梓
あずけ	預け
あずき	小豆
あずか	与	預
あすわ	足羽
あすら	阿修羅
あすけ	足助
あすか	飛鳥	明日香
あじろ	網代	足代	安代
あじむ	安心院
あじみ	味見
あじま	安島
あじな	阿品	芦品
あじつ	味付
あじだ	味出
あじす	阿知須
あじけ	味消	味気
あじき	味気
あじか	簣
あじあ	亞細亞	亜細亜
あしろ	安代
あしゆ	足湯	脚湯
あしゅ	亜種
あしや	芦谷	芦屋
あしゃ	唖者
あしめ	走目
あしべ	芦部	芦辺
あしぶ	足踏
あしふ	足踏
あしび	馬酔木
あしば	足場
あしな	足名	足並	足慣	芦品	芦名
あしど	足取
あしと	足取
あしだ	芦田
あした	明日	朝
あしげ	葦毛	芦毛	足蹴
あしか	足掛
あしお	足尾
あざや	鮮
あざむ	欺
あざみ	薊
あざぶ	麻布
あざな	糾	字
あざけ	嘲
あざい	浅井
あさり	朝里	浅利	浅蜊	蜊	鯏
あさゆ	朝湯
あさや	朝焼
あさみ	麻見	浅見	亜沙美	亜左美	朝美	麻美	あさ美
あさま	朝間	浅間
あさぶ	麻布	麻生
あさひ	朝陽	朝日	旭
あさば	浅場	浅羽
あさの	浅野
あさね	朝寝
あさと	朝戸	麻人
あさで	浅手
あさづ	浅漬
あさぢ	浅茅
あさだ	朝田	阿佐田	浅田	麻田
あさせ	浅瀬
あさす	浅過
あさじ	朝地	浅茅
あさご	朝来
あさこ	浅子	あさ子	亜抄子	朝子	麻子
あさげ	朝餉
あさけ	朝明
あさぎ	浅葱	浅黄	麻木	浅木
あさき	麻木
あさが	浅賀	朝賀
あさか	朝霞	朝加	安積	浅香
あさお	朝雄	朝起	浅尾	麻生
あさい	浅煎	朝井	淺井	浅井
あこや	阿古屋
あこめ	衵	袙
あこそ	阿古曾
あこぎ	阿漕
あこが	憬	憧
あこう	赤穂	亜綱
あげや	揚屋
あげば	揚場	揚げ場
あげは	揚羽
あげの	揚野
あげち	上地
あげく	挙句	揚句	挙げ句	上げ句
あげお	上尾
あけみ	暁美	明海	明美	朱実	明珠	朱美
あけび	木通
あけの	明野
あけち	明智
あけた	開け閉
あけこ	朱子
あけく	明け暮
あけお	暁生
あぐん	亜群
あぐり	亜久里
あぐら	趺坐	胡座	胡坐	胡床
あぐに	粟国
あぐさ	阿草
あぐい	安食	安居院	阿久比
あくろ	悪路
あくる	明くる
あくむ	悪夢
あくみ	飽海
あくま	悪魔
あくび	悪日	欠伸
あくば	悪罵
あくね	阿久根
あくと	踵
あくつ	阿久津	圷
あくち	悪血
あくた	芥
あくじ	悪事
あくぎ	悪戯
あくが	憧
あくい	阿久井	悪意
あぎと	顎
あきれ	呆れ
あきら	顕	曉	彰	陽	晃	章	彬	亨	昭	光	朗	晶	明	聡	旭	昜	鑑	滉	晄	亮	輝	顯	諦	啓	日明	暁	璋	晧	朖	洸
あきよ	晃代	明代
あきや	空き家	空家
あきみ	秋生
あきま	空き間	秋間
あきほ	明穂	秋保	秋穂
あきば	秋庭	秋葉	秋晴	秋場
あきは	秋葉
あきの	秋野	昭乃
あきな	賈	明菜	商
あきと	彰人
あきつ	蜻蛉	安芸津	秋津
あきち	空き地	空地
あきた	飽田	飽き足	秋田
あきす	空き巣	空巣
あきこ	亜樹子	朱子	亜季子	亜希子	朗子	亜以子	明子	晃子	顕子	晶子	亜紀子	彰子	暁子	昭子	章子
あきく	安芸区
あきお	晶夫	秋雄	昭男	明男	暁生	晃夫	章夫	彬生	明央	秋男	明夫	秋夫	亜希夫	昭夫	明雄	昭雄	彰夫
あきえ	章江	秋江	秋絵	亜紀恵	明恵	昭江	晃枝
あきう	秋保
あがわ	吾川	阿川
あがる	上がる
あがり	上り
あがほ	英賀保
あがの	阿賀野
あがな	贖	購
あがた	県
あかん	阿寒
あかる	明	明る
あかり	灯り	灯	明り	燈	明かり
あから	赧	赤ら
あかゆ	赤湯
あかめ	赤目
あかみ	赤み	赤身
あかま	赤間
あかほ	赤穂
あかね	朱子	茜
あかぬ	垢抜
あかに	赤丹
あかな	赤名
あかず	赤酢
あかじ	赤地	赤字	垢染
あかし	明石	證	証	灯	絳し	赤司
あかざ	藜
あかご	赤児	赤子
あかげ	赤毛
あかぎ	赤木	赤城
あかお	赤尾
あかい	赤井
あおり	煽り
あおや	青屋	青谷
あおむ	仰向
あおみ	青み
あおば	青葉
あおの	青野
あおに	青二	青丹
あおな	青菜
あおと	青砥	青戸
あおち	青地
あおた	青田
あおそ	青麻	青苧
あおじ	青地
あおげ	青毛
あおき	青木
あおえ	青江
あおい	碧	青井	葵
あえん	Zinc	Zn	亜鉛
あえり	愛絵理
あえば	饗庭
あえて	敢えて
あえぎ	喘ぎ
あうん	阿吽
あいわ	相和	哀話
あいろ	隘路
あいり	愛里
あいら	姶良	吾平
あいみ	亜衣実	愛美
あいま	合い間	相俟	合間
あいぼ	愛慕
あいべ	相部
あいぶ	愛撫
あいば	饗場	相場	相羽	愛馬	相庭
あいは	愛葉
あいの	愛野	相乗
あいな	相成
あいて	相手
あいづ	会津
あいつ	彼奴	相継	相次
あいち	相知	愛知
あいだ	会田	愛田	合田	藍田	英田	間	相田
あいそ	愛想	相磯	相曽	哀訴	愛相
あいず	合図	会津
あいじ	愛児
あいし	哀詩	間紙	愛子	哀史
あいご	愛語	愛護
あいこ	藍子	愛顧	アイ子	愛子
あいぎ	合着	間着
あいき	愛機
あいが	相賀
あいか	哀歌	相変
あいえ	藍絵
あいう	相討	相打
あいい	相容
おんれつ	音列
おんれい	御礼	恩礼
おんりつ	音律
おんよみ	音読み	音読
おんよく	温浴
おんよう	温容	恩養	陰陽
おんやく	音訳
おんめい	恩名	音名	恩命
おんみつ	隠密
おんべつ	音別
おんぷう	温風
おんびん	音便	穏便
おんびき	音引き
おんばん	音盤
おんのじ	御の字
おんねん	怨念
おんねつ	温熱
おんにん	穏忍
おんなゆ	女湯
おんなめ	妾
おんなで	女手
おんなず	女好
おんなじ	同じ
おんない	恩愛
おんどる	温突
おんどり	雄鳥
おんどさ	温度差
おんどく	音読
おんとう	温湯	穏当
おんてん	温点	恩典
おんてき	怨敵
おんてい	音程	温低
おんつう	音通
おんちく	音蓄
おんだん	温暖
おんだい	音大
おんたけ	御岳
おんたく	恩沢
おんたい	温帯	御大	恩貸
おんぞん	温存
おんぞう	音像
おんそく	音速	音束
おんせん	音線	温泉	音栓
おんせつ	音節
おんせき	恩錫
おんせい	音声
おんすう	音数
おんすい	温水
おんじん	恩人
おんしん	音信
おんしゃ	御社	音写	恩赦
おんしつ	温室	音質
おんさん	音産
おんさく	音作
おんごく	遠国
おんこう	音高	温厚	恩光	恩幸	音効
おんげん	音源
おんけん	穏健
おんけつ	温血
おんけい	音型	恩恵
おんぐん	音群
おんぐう	恩遇
おんくん	音訓
おんがん	温顔
おんがく	音楽
おんがえ	恩返
おんかん	音感
おんかた	御方
おんかく	温覚
おんかい	音階
おんえん	恩怨
おんえい	恩栄
おんいん	音韻
おんいき	音域
おんあつ	音圧
おんあい	恩愛
おわりね	終値
おわらい	お笑い
おわいや	汚穢屋
おろそか	疎か
おろしね	卸値
おろおぼ	疎覚
おれまが	折れ曲
おれたち	俺達
おれせん	折線	折れ線
おれさま	オレ様	俺様
おれくち	折れ口
おりよく	折よく
おりやま	折山
おりもの	下り物	織物
おりもと	織元
おりほん	折本
おりふし	折節
おりひめ	織姫
おりばこ	折箱	折り箱
おりはら	織原	折原
おりはし	折橋
おりづる	折鶴	折り鶴
おりづめ	折詰	折り詰め
おりたて	折立
おりたた	折り畳	折畳
おりしも	折しも
おりしげ	折茂
おりこみ	折込
おりけい	折罫
おりくち	降り口	下り口
おりきど	折木戸
おりがみ	折り紙	折紙
おりがさ	織笠
おりから	折柄
おりかも	氈
おりかさ	折り重	織笠	折笠
おりかえ	折返	折り返
おりおり	折々
おりいと	織糸	織り糸
おりあい	折合い	折り合い
おらんだ	和蘭
およろこ	お慶
およずれ	妖
およぎこ	泳ぎ込
おゆわり	御湯割り	お湯割り
おゆるし	お許し
おゆずり	御譲り
おやゆび	親指	拇
おやゆず	親譲
おやもと	親元
おやまだ	小山田
おやまし	小山市
おやぶん	親分
おやぶね	親船
おやばか	親馬鹿	親バカ
おやねこ	親猫
おやなぎ	小柳
おやだま	親玉
おやたち	親達
おやすみ	お休み
おやしお	親潮
おやざと	親里
おやきじ	親記事
おやがめ	親亀
おやかぶ	親株
おやかた	親方	お館
おやかく	親核
おやかぎ	親鍵
おやいも	親芋
おやいぬ	親犬
おやいで	小柳出
おやいづ	小柳津
おやいず	小柳津
おもわず	思わず
おもわく	思惑	思わく
おももち	面持	面持ち
おもむろ	徐
おもむけ	趣
おもむき	趣き	趣
おもみづ	重み付
おもぶき	趣
おもばば	重馬場
おもはゆ	面映
おもなが	面長
おもてむ	表向
おもてだ	表立
おもてじ	表地
おもてが	表書
おもてあ	表編
おもづら	羈
おもちゃ	玩具
おもだち	面立ち
おもだか	面高	沢瀉
おもたに	面谷
おもすぎ	重過ぎ
おもしろ	面白
おもざし	面差し
おもぐる	重苦
おもくる	重苦
おもがい	面繋	面懸	羈
おもかじ	面舵
おもかげ	俤	面影
おもおも	重々
おもいや	思い遣
おもいで	思い出	想い出
おもいつ	思い付	思い詰
おもいだ	思い出
おもいた	思い立
おもいし	思い知
おもいこ	思い込
おもいき	思い切
おもいか	思い兼
おもいお	思い起
おもいう	思い浮
おもいい	思い入
おもいあ	思い当	思い上
おめみえ	お目見え	御目見得
おめがね	御眼鏡
おめいし	お名刺
おめあて	お目あて
おむすび	御結び
おみやげ	御土産	お土産
おみむら	麻績村
おみまい	お見舞い	御見舞い	御見舞	お見舞
おみとお	御見通
おみそれ	御見逸	御見逸れ
おみごと	御見事
おみこし	御神輿
おみくじ	御神籤
おみがわ	小見川
おみあし	御御足
おみあい	お見合い
おまわり	お巡り
おまもり	御守り	お守り
おまつり	お祭り	御祭
おまいり	御参り	お参り
おぼろげ	朧げ
おぼしめ	思召
おぼえず	覚えず
おぼえこ	覚え込
おへんじ	お返事	御返事
おぶくろ	尾袋
おふたり	お二人	御二人
おふくろ	御袋	お袋
おふかい	オフ会
おびふう	帯封
おびひろ	帯広
おびはば	帯幅
おびのこ	帯鋸
おびなど	帯等
おびなた	大日方
おびとけ	帯解
おびただ	夥
おびじめ	帯締め
おびした	帯下
おびきよ	誘き寄
おびがみ	帯紙
おびがね	帯金
おびがき	帯書
おびかわ	帯革	帯川
おびいた	帯板
おひろめ	お披露目	御披露目
おひるね	お昼寝
おひらき	御開き	お開き
おひとよ	御人好
おひつじ	牡羊
おひたし	お浸し	御浸し
おひさま	御日様	お日様
おばすて	姨捨
おばしま	欄
おばさん	小母さん
おはらい	お赦い
おはよう	お早う
おはやめ	お早め
おはやし	お囃子
おはなみ	お花見
おはなし	お話
おはぐろ	御歯黒	鉄漿
おのやま	小野山
おのむら	小野村
おのみち	尾道
おのでら	小野寺
おのづか	小野塚
おのだか	小野高
おのぞみ	お望み
おのずと	自ずと	自と
おのずか	小野塚	自
おのざわ	小野沢
おのざき	小野崎
おのさと	小野里
おのけん	小野研
おのがわ	小野川
おのがみ	小野上
おのかわ	小野川
おのおの	各	各々
おのおか	小野岡
おのうえ	尾上
おねみち	尾根道
おねてん	尾根点
おねだん	お値段
おねせん	尾根線
おねがい	お願い
おによめ	鬼嫁
おにゆり	鬼百合
おにもつ	お荷物
おにみそ	鬼味噌
おにまろ	鬼磨呂
おにへい	鬼平
おにばば	鬼婆
おにはは	鬼母
おにづか	鬼塚
おにつか	鬼束	鬼塚
おにっこ	鬼っ子
おにざわ	鬼沢
おにぎり	御握り
おにがわ	鬼皮
おにうだ	鬼生田
おにあい	お似合い
おなもみ	葹
おなまえ	お名前	御名前
おなはま	小名浜
おなじみ	お馴染
おなじく	同じく	々
おながわ	女川
おどろき	驚き
おどりば	踊り場
おどりで	躍り出
おどりて	踊り手
おどりだ	踊り出
おどりじ	踊り字
おどりこ	踊り子	踊り込
おどりあ	踊り明
おどしゃ	御土砂
おどしと	脅し取
おとろえ	衰え
おともれ	音洩れ
おとめざ	乙女座
おとめご	少女子
おとべつ	音別
おとふじ	乙藤
おとふけ	音更
おとひめ	乙姫
おとひと	弟
おとなり	お隣	お隣り
おとなし	音無
おとなげ	大人気
おとどけ	お届け
おととり	音取り	音取
おととし	一昨年
おととい	一昨日
おとてき	音的
おとつい	一昨日
おとだし	音出し
おとずれ	訪れ
おとしご	落し子	落とし子
おとしい	陷	陥
おとさた	音沙汰
おとこゆ	男湯
おとこで	男手
おとくに	乙訓
おとくい	お得意
おとがい	頤
おとかわ	乙川
おとかず	音数
おとおし	御通し
おとうと	弟
おとうす	音薄
おといち	音一
おでんわ	お電話
おでかけ	お出かけ
おてんば	お転婆	御転婆
おてんき	お天気
おてもり	お手盛り
おてもと	お手元
おてまえ	お点前
おてほん	お手本
おてつき	御手付き
おてだま	お手玉
おてすう	お手数	御手数
おてがる	お手軽
おてがみ	御手紙	お手紙
おてかず	お手数
おていれ	お手入れ
おてあげ	御手上げ	お手あげ
おつぼね	お局
おつとめ	お勤め	御勤め
おつたえ	お伝え
おつしゅ	乙種
おつくり	御作り	御造り
おつがわ	乙川
おつかい	お使い
おつあん	乙案
おっぱら	追っ払
おっぱま	追浜
おっぱじ	おっ始
おっしゃ	仰
おっくう	億劫
おっきな	大っきな
おっかぶ	押っ被
おっかけ	追っかけ
おちゃめ	お茶目
おちみず	落水	落ち水
おちびと	落人
おちばた	落葉焚
おちこみ	落ち込み	落ちこみ
おちこち	遠近
おちけん	落研
おちぐち	落ち口
おちくぼ	落ち窪
おちから	御力
おちかた	遠方	墜ち方
おちうど	落人
おちいし	落石
おちあゆ	落ち鮎
おちあい	落合
おだわら	小田原
おだやか	穏やか
おだまり	お黙り
おだまき	苧環
おだぶつ	御陀仏	お陀仏
おだなか	小田中
おだじま	小田嶋	尾田島	小田島
おだしま	小田嶋
おだくら	小田倉
おだぎり	小田桐	小田切
おだがわ	小田川
おだいら	小平
おたるし	小樽市
おたより	お便り
おたまや	霊屋
おたふく	お多福
おたっし	お達し
おたずね	お尋ね
おたじま	小田嶋	小田島
おたけび	雄叫び
おたがい	お互い
おたから	お宝	御宝
おぞけだ	怖気立
おそれる	惶
おそれい	恐れ入
おそらく	恐らく
おそまつ	御粗末
おそまき	遅蒔き
おそばん	遅番	遅版
おそなえ	御供え	お供え
おそぢえ	遅知恵
おそざき	遅咲き
おそうじ	お掃除
おそいく	襲い来
おぜんだ	御膳立
おぜぬま	尾瀬沼
おせざき	大瀬崎
おせいぼ	お歳暮	御歳暮
おすめす	牡牝	雄雌
おすまし	御澄まし
おすまい	お住い
おすねこ	雄猫
おすすめ	お勧め	お薦め
おすごし	お過ごし
おすがた	御姿
おすかぶ	雄株
おすうま	牡馬
おすうし	雄牛
おじょく	汚辱
おじょう	御嬢
おじゃま	お邪魔	御邪魔
おじさん	小父さん
おじさま	叔父様
おじけづ	怖気付
おじかん	お時間
おじおば	叔父叔母
おしんこ	御新香
おしわり	押割り
おしろい	白粉
おしらせ	お知らせ
おしょく	汚職
おしょう	和尚
おしゅう	汚臭
おしゃれ	おシャレ	お洒落	御洒落
おしゃく	御酌
おしゃか	御釈迦	お釈迦
おしもど	押し戻
おしみず	押水
おしまい	御仕舞い	御仕舞
おしぼり	御絞り
おしほり	押堀
おしひろ	押し広
おしひし	押し拉
おしばな	押花	押し花
おしはか	推し量
おしのび	御忍び
おしなが	押し流	お品書
おしどり	鴦	鴛鴦
おしとど	押し止
おしとお	押し通
おしつま	押し詰
おしつぶ	押し潰	圧し潰
おしつつ	押し包
おしつけ	押し付け
おしだま	押し黙
おしだし	押し出し
おしたお	押し倒
おしずし	押鮨
おしすす	推し進	押し進
おしごと	お仕事
おしころ	押し殺
おしくも	惜しくも
おしくま	押熊
おしきり	押切
おしきせ	御仕着せ
おしがみ	押紙
おしがし	押し貸し
おしかわ	押川
おしかり	お叱り
おしかた	押方
おしかけ	押し掛け
おしかく	押角
おしおき	御仕置
おしえご	教え子
おしえこ	教え込
おしうり	押売
おしいれ	押し入れ	押入
おしあげ	押上
おざなり	御座なり
おざしき	お座敷
おさらぎ	大仏	大佛
おさふね	長船
おさなさ	幼さ
おさなご	幼子
おさない	小山内	長内	幼い
おさそい	お誘い
おさけび	雄叫び
おさきに	お先に
おさがり	御下がり	御下り
おさかな	お魚
おさえつ	押え付	押さえ付
おさえこ	押さえ込	抑え込
おごそか	厳か
おごおり	小郡
おこりう	起こり得
おこのみ	お好み
おこのぎ	小此木
おこない	行い	行ない
おことば	御言葉
おこっぺ	興部
おこたち	御子達
おこたえ	お答え	御答え
おこさん	お子さん
おこさま	お子様
おこころ	御心
おげんき	お元気	御元気
おげれつ	お下劣
おげひん	お下品
おけどう	桶胴
おけがわ	桶川
おけいこ	お稽古
おぐるま	小車
おくわざ	奥技
おくれげ	後れ毛
おくりび	送り火
おくりな	諡
おくりて	送り手
おくりつ	送り付
おくりだ	送り出
おくりこ	送り込
おくゆき	奥行き	奥行
おくやみ	お悔やみ
おくやま	奥山
おくもと	奥本	納本
おくめん	臆面	憶面
おくむら	奥村
おくみの	奥美濃
おくまん	億万
おくぶか	奥深
おくふか	奥深
おくひだ	奥飛騨
おくはら	奥原
おくのと	奥能登
おくのて	奥の手
おくねん	億年
おくぬき	奥貫
おくにん	億人
おくにし	奥西
おくなが	奥永
おくない	屋内	奥内
おくとみ	奥富
おくとね	奥利根
おくでん	奥伝
おくでら	奥寺
おくづけ	奥付
おくつき	奥つ城
おくだん	臆断
おくだて	奥立
おくたま	奥多摩
おくたに	奥谷
おくそこ	奥底
おくそく	憶測	臆測
おくせつ	臆説	憶説
おくしり	奥尻
おくしゃ	屋舎
おくしが	奥志賀
おくさん	奥さん
おくさわ	奥沢	奥澤
おくさま	奥様
おくさき	奥崎
おくがた	奥方
おくがき	奥書
おくがい	屋外
おくかわ	奥川
おくかい	億回
おくえん	億円
おくいり	奥入
おぎわら	荻原
おぎゅう	荻生
おぎはら	荻原
おぎのめ	荻目	荻野目
おぎしま	荻島
おぎくぼ	荻窪
おぎうえ	荻上
おきわた	沖渡
おきわす	置き忘
おきょう	お経
おきゃん	お侠	御侠
おきゃく	お客
おきもの	置物
おきもと	沖本
おきもち	お気持ち	お気持
おきまり	お決まり
おきぶみ	置文
おきふじ	沖藤
おきぬけ	起き抜け
おきにい	お気に入
おきなわ	沖縄	沖繩
おきなか	沖中
おきなお	起き直
おきづけ	沖漬け	沖漬
おきづき	お気付き
おきつち	置き土
おきたま	置賜
おきざり	置き去り
おきくら	沖倉
おきがる	御気軽
おきがさ	置き傘
おきかた	置き方
おきかえ	置き換え	置換え
おきいし	置石	置き石
おきあゆ	置鮎
おきあみ	沖醤蝦
おきあじ	沖鰺
おきあい	沖合い	沖合
おがわな	小川名
おがさか	小賀坂
おがくず	大鋸屑
おかわり	お代わり	お代り	お変り
おからだ	お身体
おかやま	岡山
おかやす	岡安
おかもと	岡本	岡元
おかもち	岡持	岡持ち
おかむろ	岡室
おかむら	岡村
おかまい	御構い
おかぼれ	傍惚れ	岡惚れ
おかふじ	岡藤
おかひら	岡平
おかひさ	岡久
おかはる	岡原
おかはら	岡原
おかはち	岡八
おかはし	岡橋
おかどめ	岡留
おかづり	陸釣
おかっぴ	岡っ引
おかって	お勝手
おかだや	岡田屋
おかだま	丘珠
おかだい	岡大
おかたに	岡谷
おかぞえ	岡添
おかじま	岡嶋	岡島
おかしら	尾頭
おかしや	お菓子屋
おかしま	岡島
おかしい	可笑しい
おかざわ	岡澤
おかざき	丘咲	岡崎
おかさん	岡三
おかさか	岡坂
おかげん	御加減	お加減
おかぐら	御神楽
おかくら	岡倉
おかがみ	岡上
おかがき	岡垣
おかかえ	お抱え	御抱え
おかえり	お帰り
おかえし	お返し	御返し
おかうち	岡内
おおわら	大笑
おおわに	大鰐
おおわだ	大輪田	大和田
おおわし	大鷲
おおわざ	大技
おおわく	大和久	大枠
おおわき	大脇
おおよど	大淀
おおよそ	大凡	凡そ
おおよせ	大寄
おおゆみ	大弓
おおゆき	大雪
おおやん	欧陽
おおやま	大山
おおやの	大矢野
おおやね	大屋根
おおやち	大矢知
おおやす	大保
おおやけ	公	大宅
おおやぎ	大八木	大谷木
おおもん	大門
おおもり	大森	大盛	大盛り
おおもも	大桃
おおもの	大物
おおもと	大本	大元
おおもじ	大文字
おおもう	大儲
おおむろ	大室
おおむら	大村
おおむね	概ね	大旨	概
おおむた	大牟田
おおむぎ	大麦
おおみら	薤
おおみよ	大御代
おおみや	大宮
おおみね	大峰
おおみつ	大光
おおみち	大道
おおみだ	大見出
おおみぞ	大溝
おおみず	大水
おおみか	大甕
おおみえ	大見得
おおまわ	大回
おおまま	大間々
おおまど	大窓
おおまつ	大松
おおまち	大町
おおまた	大股
おおまけ	大負け
おおまき	大蒔
おおまか	大まか
おおまえ	大前
おおぼし	大星
おおぼけ	大歩危	大ボケ	大ぼけ
おおほん	大本
おおほり	大堀	大濠
おおべや	大部屋
おおぶり	大降り
おおぶね	大船
おおぶち	大淵	大渕
おおふね	大舟
おおふな	大船
おおふく	大福
おおふか	大深
おおびん	大瓶	大壜
おおびけ	大引け
おおびき	大引
おおひろ	大広
おおひら	大衡	大平
おおひと	大仁
おおひさ	大久
おおばん	大版	大番	大判	大盤
おおばこ	大箱
おおばけ	大化け
おおばか	大馬鹿
おおはる	大治
おおはら	大原
おおはま	大濱	大浜
おおはば	大幅
おおはた	大畠	大畑
おおはじ	大恥
おおはし	大橋
おおはさ	大迫
おおのみ	大野見
おおねだ	大根田
おおぬま	大沼
おおぬき	大貫
おおにわ	大庭
おおにた	大仁田
おおにし	大西
おおなめ	大滑
おおなみ	大浪	大波
おおなべ	大鍋
おおなた	大鉈
おおなき	大泣き
おおなえ	大苗
おおどお	大通
おおとろ	大トロ
おおとり	鵬	鳳	大鳥	鴻
おおとよ	大豊
おおとも	大友	大伴
おおとの	大殿
おおとね	大利根
おおとう	大任	大塔
おおでき	大出来
おおてる	大照
おおてら	大寺
おおてい	大体
おおづめ	大詰	大詰め
おおづな	大綱
おおづつ	大筒
おおつる	大鶴
おおつま	大妻
おおつぼ	大坪
おおつぶ	大粒
おおつの	大角
おおつち	大槌
おおつし	大津市
おおつき	大附	大津寄	大規	大月	大槻
おおつが	大津賀
おおつか	大塚	大束
おおつえ	大津絵
おおちが	大違
おおだま	大玉
おおだな	大店
おおだて	大館
おおだち	大館	大立
おおだこ	大ダコ
おおだけ	大岳
おおだか	大高
おおだい	大台
おおたま	大玉
おおたに	大谷
おおたち	大立
おおたし	太田市
おおたけ	大武	大丈	大嶽	大竹
おおたく	大田区
おおたき	大瀧	大多喜	王滝	大滝
おおたか	大高
おおぞん	大損
おおぞら	大空
おおぞね	大曽根
おおぞこ	大底
おおその	大園
おおそね	大曽根
おおそと	大外
おおそこ	大底
おおそが	大曽我
おおぜき	大関
おおぜい	大勢
おおせと	大瀬戸
おおせつ	仰せ付
おおずわ	大諏訪
おおすみ	大隅	大住	大角
おおすじ	大筋
おおすぎ	大杉	大過ぎ
おおすが	大須賀
おおすか	大須賀
おおじま	大島
おおじか	麋
おおしろ	大城
おおしま	大嶋	大島
おおしば	大柴	大芝
おおした	大下
おおしげ	大重
おおしけ	大時化
おおしか	大鹿
おおしお	大塩	大潮
おおざら	大皿
おおざと	大里
おおざけ	大酒
おおさわ	大沢	大澤	大騒
おおさま	王様
おおさと	大里	大郷
おおさじ	大匙
おおさこ	大迫
おおさき	大崎
おおさか	大阪	大坂	逢坂
おおごま	大駒
おおごと	大事
おおごし	大腰
おおごえ	大声	大越
おおこめ	大米
おおこし	大越
おおげさ	大袈裟	大げさ
おおけが	大怪我	大ケガ	大けが
おおぐろ	大黒
おおぐれ	大暮
おおぐち	大口
おおぐす	大楠
おおぐし	大串
おおぐい	大食い	大喰い
おおくわ	大桑
おおくり	お送り
おおくら	大倉	大蔵
おおくま	大隈	大熊	逢隈
おおくぼ	大窪	大久保
おおくび	衽
おおくに	大国
おおくち	大口
おおぎり	大喜利	大切り
おおぎみ	大宜味
おおぎし	大岸
おおきめ	大き目
おおきみ	大君
おおきに	大きに
おおきな	大きな
おおきど	大木戸
おおきた	大北
おおきす	大き過
おおきさ	大きさ
おおきい	大きい
おおがら	大柄
おおがめ	鰲
おおがみ	大神
おおがね	大鐘	大金
おおがち	大勝ち
おおがた	大型	大潟	大形	大方
おおがけ	大駆
おおがき	大柿	大書	大垣
おおがい	大貝	頁
おおかわ	大川	大河
おおかれ	多かれ
おおかめ	狼
おおかみ	大神	狼
おおかべ	大壁
おおかた	大片	大方
おおかぜ	大風
おおかじ	大鍛冶	大火事
おおおみ	大臣
おおおく	大奥
おおおか	大岡
おおえど	大江戸
おおうら	大浦
おおうつ	大写
おおうち	大内
おおうだ	大宇陀
おおうそ	大嘘	大ウソ
おおうえ	大上
おおいわ	大岩
おおいり	大入	大入り
おおいに	大いに
おおいと	大糸
おおいち	大市
おおいた	大板	大分
おおいそ	大急	大磯
おおいし	大石
おおいけ	大池
おおいえ	大家
おおあわ	粱
おおあれ	大荒れ
おおあり	大有り
おおあめ	大雨
おおあみ	大網
おおあま	大甘
おおあば	大暴
おおあな	大穴
おおあせ	大汗
おおあじ	大味
おおあし	大足
おおあざ	大字
おおあさ	大朝
おおあえ	大饗
おえかき	お絵描き	お絵かき	お絵書き
おうれん	黄蓮
おうりん	黄燐
おうりつ	王立
おうらい	往来
おうよう	應用	鷹揚	応用
おうゆう	鴎友
おうめん	凹面
おうめし	青梅市
おうみじ	近江路
おうぼう	横暴
おうほう	應報	往訪	王法	応報
おうべい	欧米
おうへん	応変	黄変
おうへい	横柄
おうぶん	欧文	応分
おうぶつ	応用物理	応物
おうふく	往復
おうふう	欧風
おうばく	黄檗	黄蘗
おうはん	黄斑	凹版
おうのう	懊悩	応能
おうねん	往年
おうにん	応仁
おうなつ	押捺
おうどう	王道	黄銅	横動	横道	黄道
おうとつ	凹凸
おうとう	王党	桜桃	櫻桃	大塔	応答	鴨東
おうでん	応電
おうてん	横転
おうてき	横笛
おうてい	奥底
おうだん	応談	黄疸	横断	黄胆
おうだく	応諾
おうたい	応対	黄体	横隊
おうぞく	王族
おうそう	押送
おうせん	応戦	鏖戦
おうせつ	応接
おうせき	往昔
おうせい	王制	旺盛	王政
おうすう	応数
おうすい	王水
おうじん	応身
おうじょ	皇女	王女
おうじゅ	応需
おうじゃ	王者
おうじつ	往日
おうしん	往信	往診
おうしゅ	応手
おうしゃ	王者
おうしつ	王室
おうしざ	牡牛座
おうさま	王様
おうさつ	殴殺	応札	鏖殺
おうさか	逢坂
おうごん	黄金
おうこく	王国
おうこう	王后	王侯	横行	往航	王公
おうけん	王権
おうぎや	扇谷
おうがい	鴎外
おうかん	王冠	往還
おうかじ	押下時
おうかく	旺角
おうおう	往々	汪々
おうえん	応援
おうえい	応永
おういん	桜蔭	押韻	押印
おういつ	汪溢	横溢
おうあん	応安
おいわけ	追分
おいわい	御祝	御祝い	お祝い
おいらん	花魁
おいらせ	奥入瀬
おいらく	老いらく
おいもと	追い求
おいめい	甥姪
おいまわ	追い回
おいまつ	老松
おいばね	追羽根
おいはら	追い払
おいはま	生浜	追浜
おいはぎ	追剥
おいのり	お祈り
おいつづ	追い続
おいっこ	甥っ子
おいだし	追出
おいたて	追立て
おいたち	生い立ち
おいそぎ	お急ぎ
おいせん	追銭
おいすが	追い縋
おいしゃ	お医者
おいしげ	生い茂
おいさき	老い先	生い先
おいこん	追いコン
おいこみ	追い込み	追込み
おいこし	追越	追越し	追い越し
おいかわ	生川	追川	及川
おいかぜ	追い風	追風
おいおと	追い落
おいおい	追々
おあそび	お遊び
おあずけ	お預け
おあがり	お上がり
おあいて	お相手	御相手
おあいそ	お愛想
えんれい	延齢
えんるい	縁類
えんりょ	遠慮
えんらく	宴楽	円楽	猿楽
えんらい	遠来	遠雷
えんよう	艶容	遠洋	援用
えんゆう	円融
えんやす	円安
えんもく	演目
えんめい	延命	艶名
えんむす	縁結
えんまん	円満
えんまく	煙幕
えんぽん	艶本	円本
えんぽう	演報	延宝	遠方
えんぼう	怨望	遠謀	遠望
えんぺん	縁辺
えんぺい	援兵	掩蔽
えんべつ	遠別
えんぷん	円墳
えんぶん	艶聞	延文	塩分	艶文
えんぴつ	鉛筆
えんぱつ	延発
えんぱく	延泊
えんばん	鉛版	円盤	円板
えんばら	円払
えんばく	燕麦
えんのう	延納
えんねん	延年
えんねつ	炎熱
えんにち	縁日
えんない	円内	園内
えんどく	鉛毒	煙毒
えんどお	縁遠
えんどう	遠藤	筵道	豌豆	沿道	羨道
えんとつ	煙突
えんとく	延徳
えんとう	遠投	煙筒	円筒	円頭	遠島
えんでん	塩田
えんてん	炎天	遠点
えんてつ	遠鉄
えんてい	園丁	堰堤
えんちん	遠沈
えんだん	縁談	演壇
えんだま	円玉
えんだて	円建て
えんだか	円高
えんだい	円台	縁台	演題	遠大	演台
えんたん	鉛丹
えんたく	円卓
えんたい	掩体	延滞	淹滞
えんぞう	円蔵	塩蔵
えんそく	遠足
えんそう	演奏
えんぜん	婉然	艶然	嫣然
えんぜつ	演説	演舌
えんせん	厭戦	沿線
えんせき	遠戚	宴席	塩析	縁石
えんせい	延性	遠征	縁生	厭世
えんずい	延髄
えんすい	円錐	塩水
えんじん	猿人	閹人	円陣	厭人
えんじょ	援助
えんじゅ	槐
えんじゃ	縁者	演者
えんしん	延伸	遠心	円心
えんしょ	炎暑	艶書
えんしゃ	演者
えんしつ	煙室
えんざん	塩山	演算	鉛槧	圓山	遠山
えんざい	冤罪	寃罪
えんさん	塩酸	演算
えんさき	縁先
えんごく	遠国
えんごか	援護下
えんこん	怨恨
えんこく	遠国
えんこう	円光
えんげん	怨言	淵源
えんげつ	偃月
えんげき	演劇
えんげい	園芸	園藝	演芸
えんけん	偃蹇
えんけい	冤刑	燕京	円形	遠景
えんぐん	援軍
えんぐみ	縁組
えんくう	円空
えんぎは	演技派
えんきん	遠近
えんきり	縁切り
えんがん	遠眼	沿岸
えんがわ	縁側
えんがる	遠軽
えんがく	縁覚
えんがい	掩蓋	塩害	煙害	円外	円蓋	鉛害	円買い
えんかん	煙管	円環	鉛管
えんかわ	圓川
えんかる	遠軽
えんかつ	円滑
えんかく	遠隔	沿革
えんかい	沿海	遠海	延会	宴会
えんおう	閻王
えんえん	蜿々	延々	蜿蜒	奄奄
えんえき	演繹
えんえい	遠泳
えんうん	煙雲
えんうり	円売り
えんいん	延引	援引	遠因
えんあん	塩安
えろほん	エロ本
えりもと	襟元
えりまき	襟巻
えりぬき	選り抜き
えりごの	選り好
えりぐり	襟刳り
えりくび	襟首
えりがみ	襟髪
えりうら	襟裏
えりあし	襟足
えりあか	襟垢
えらぼう	選ぼう
えらぶる	偉ぶる
えらぶつ	豪物	偉物
えらびだ	選び出
えむかえ	江迎
えぼだい	えぼ鯛
えびはら	海老原	蛯原
えびなし	海老名市
えびづる	蝦蔓
えびづか	海老塚
えびちゃ	葡萄茶
えびぞり	海老反り
えびすや	蛭子屋
えびさわ	海老沢	海老澤
えびがた	海老固
えびいろ	葡萄色
えばらこ	桧原湖
えはがき	絵葉書	絵はがき
えのもと	榎本
えのでん	江の電
えのぞの	榎園
えのしま	江の島	江ノ島
えのきど	榎戸
えのきだ	榎田
えにっき	絵日記
えなんじ	淮南子
えどまえ	江戸前
えどてん	江戸展
えどっこ	江戸っ子
えどざき	江戸崎
えどさき	江戸崎
えどくら	江戸蔵
えどがわ	江戸川
えとろふ	択捉
えでほん	絵手本
えてして	得てして
えてこう	猿公	猿猴
えづくり	絵作り
えつろう	悦朗
えつれき	閲歴
えつらん	閲覧
えつらく	悦楽
えつねん	越年
えつどく	閲読
えっぺい	閲兵
えっぷく	悦服
えっとう	越冬
えっけん	越権	謁見
えちぜん	越前
えちごや	越後屋
えちがわ	愛知川
えだわか	枝分
えだみち	枝道
えだまめ	枝豆
えだまつ	枝松
えだぶり	枝振り
えだばん	枝番
えだばり	枝針
えだなみ	枝並
えだせん	枝線
えだずみ	枝炭
えだがわ	枝川
えだがり	枝刈り
えだうち	枝打ち
えたじま	江田島
えぞまつ	蝦夷松
えぞしか	蝦夷鹿
えずりこ	江釣子
えずめん	絵図面
えすせき	Ｓ席
えすしき	S式
えすがた	絵姿
えじぷと	埃及
えしゃく	会釈
えさばこ	餌箱
えさづり	餌釣り
えさだい	餌代
えごよみ	絵暦
えごころ	絵心
えことば	絵詞
えぐりだ	抉り出
えきれい	液冷
えきゆう	益友
えきもれ	液漏れ
えきめい	駅名
えきまえ	駅前
えきべん	駅弁	液便
えきびる	駅ビル
えきない	駅内
えきどめ	駅止め	駅止
えきとう	駅頭
えきでん	驛傳	駅伝
えきてき	液滴
えきちく	役畜
えきだん	易断
えきたい	液体
えきそう	液相
えきせん	易占
えきせい	液性
えきすう	駅数
えきしゃ	易者	駅舎
えきざい	液剤
えきごと	駅毎
えきけん	益軒
えききん	益金
えきがわ	駅側
えきがく	易学	疫学
えきかん	駅間
えきおん	液温
えきうり	駅売り
えきうら	駅裏
えきいん	駅員
えがたい	得難い
えがしら	江頭
えがきだ	描き出
えいれい	英霊
えいりん	英鈴	営林	映倫
えいりょ	叡慮
えいりか	営利化
えいらく	永楽
えいよう	栄養	栄耀	営養
えいゆう	英雄
えいやく	英訳
えいもん	営門
えいもり	栄森
えいもじ	英文字
えいめい	英名	英明
えいみん	永眠
えいほう	泳法	英法	鋭鋒
えいべつ	永別
えいべい	英米
えいへい	衛兵
えいぶん	英文
えいふつ	英仏
えいふく	永福
えいびん	鋭敏
えいばん	英盤
えいはつ	映発
えいのう	営農
えいねん	永年
えいにち	英日
えいどう	栄道	泳動
えいとく	永徳
えいとう	衛陶
えいでん	叡電
えいてん	栄典	栄転
えいてい	営庭
えいだん	英断	営団	帝都高速度交通営団
えいだつ	穎脱
えいだい	英題	永代
えいたん	詠嘆	詠歎
えいたつ	英達	栄達
えいたい	永代
えいぞく	永続
えいぞう	影像	映像	栄蔵	英三	営造	栄三
えいそう	営巣	営倉
えいぜん	営繕
えいせん	鋭尖	曳船
えいせい	永逝	衛星	衞生	衞星	永生	永世	衛生
えいすけ	英介	英輔	栄介
えいすう	英数
えいじん	英人
えいじゅ	衛戍
えいじつ	永日
えいしん	詠進	栄進
えいしょ	営所	英書
えいしゅ	英主
えいしゃ	泳者	営舎	映写
えいざん	叡山
えいさつ	縊殺
えいさく	栄策	栄作	英作
えいさい	栄西	穎才	英才
えいごか	英語化	英語科
えいごう	永劫
えいこん	英魂
えいこく	英国
えいこう	栄孝	栄幸	栄光	曳行	曳光	曳航	営口
えいげん	永源
えいけん	英検
えいけつ	英傑	永訣
えいけい	鋭形
えいぐん	英軍
えいぎん	詠吟
えいきょ	盈虚
えいきち	永吉	栄吉
えいがや	映画屋
えいがし	映画史
えいがく	栄学
えいがか	映画化
えいかん	栄冠
えいかく	鋭角
えいおん	嬰音
えいえん	永遠
えいえい	英英	永々	営営	営々
えいいん	影印
えいいち	栄一	詠一	英一	榮一
えあわせ	絵合	絵合わせ
うんわる	運悪
うんよう	運用
うんめい	運命
うんぷう	雲風
うんぴつ	運筆
うんぱん	運搬
うんのう	蘊奥	暈ノウ	雲衲
うんぬん	云々
うんなん	雲南
うんどう	運動
うんでい	雲泥
うんてん	運転
うんてい	雲梯
うんちん	運賃
うんちく	薀蓄	蘊蓄
うんだめ	運試
うんだい	雲台
うんそう	運送
うんぜん	雲仙
うんせい	運勢
うんすい	雲水
うんじゅ	琅珠
うんしん	雲身	運針
うんざん	運算
うんさん	雲散
うんこく	雲谷
うんこう	暈光	運行	運航
うんげん	繧繝
うんけい	運慶	雲形
うんかい	雲海
うんえん	雲煙
うんえい	運営
うわやく	上役
うわもの	上物
うわむき	上向き
うわみの	上蓑
うわみぞ	上溝
うわまわ	上回
うわまえ	上前
うわばり	上張り
うわばみ	蠎蛇
うわばき	上履き
うわのり	上乗り
うわのせ	上乗せ
うわぬり	上塗り
うわなり	嫐
うわてな	上手投
うわづみ	上積み
うわつら	上面
うわぞこ	上底
うわずみ	上住	上澄み
うわすべ	上滑
うわじま	宇和島
うわざら	上皿
うわごと	譫言
うわぐつ	上靴
うわがわ	上側
うわがみ	上紙
うわがき	上書	上書き
うわえだ	上枝
うわあご	上顎
うろくず	鱗
うろおぼ	空覚	疎覚	うろ覚
うれゆき	売行	売れ行き	売行き
うれのこ	売れ残
うれっこ	売れっ子
うれだか	売れ高
うれせん	売れ線
うれすじ	売れ筋
うれしの	嬉野
うれくち	売れ口
うれあし	売れ足
うるむち	烏魯木斉
うるしま	漆島
うるしえ	漆絵
うるおい	潤い
うりんけ	羽林家
うりわた	売渡	売り渡
うりょう	雨量
うりゅう	雨竜	雨龍	瓜生
うりもの	売り物	売物
うりもく	ウリ目	Cucurbitales
うりはら	売り払
うりぬし	売主	売り主
うりぬけ	売り抜け
うりどき	売り時
うりづら	瓜連
うりつづ	売り続
うりつく	売り尽
うりだし	売り出し	売出し	売出
うりしぶ	売り渋
うりざね	瓜核	瓜実
うりさば	売り捌
うりごえ	売り声	売声
うりこみ	売り込み
うりぐい	売り食い
うりくち	売り口
うりきれ	売切れ	売切	売り切れ
うりかた	売り方	売方
うりかけ	売掛	売り掛け
うりかい	売り買い
うりいそ	売り急
うりいえ	売り家
うりある	売り歩
うりあげ	売上げ	売上	売り上げ
うらわし	浦和市
うらわざ	裏技
うららか	麗らか
うらやま	裏山	羨	浦山
うらやす	浦安
うらやき	裏焼き
うらもん	裏門
うらもの	裏物
うらもと	浦本
うらめん	裏面
うらめし	浦飯
うらめい	裏銘
うらみち	裏道
うらまど	裏窓
うらまち	裏町
うらぼん	盂蘭盆
うらほろ	浦幌
うらべや	裏部屋
うらぶた	裏蓋
うらばん	裏番
うらはら	裏腹
うらはま	浦浜
うらにわ	裏庭
うらにし	浦西
うらなり	末生り	末成り
うらなみ	浦波
うらなげ	裏投げ
うらない	占い	卦	卜い
うらどら	裏ドラ
うらどお	裏通
うらづけ	裏付け	裏付
うらぞこ	浦底
うらそえ	浦添
うらぜん	浦禅
うらずみ	裏住み
うらじろ	裏白
うらしま	浦島
うらしの	嬉野
うらさわ	浦沢
うらさび	心淋
うらさく	裏作
うらごし	裏漉し
うらごえ	裏声
うらこう	浦港
うらけん	裏拳
うらけい	裏罫
うらぐち	裏口
うらぎり	裏切り
うらきど	裏木戸
うらがわ	裏側	浦川
うらがみ	浦上	裏紙
うらがね	裏金
うらがな	心悲
うらがき	裏書き	裏書
うらがお	裏顔
うらがえ	裏返
うらかわ	浦河	浦川
うらかみ	浦上
うらかた	裏方
うらかぜ	裏風	浦風
うらかえ	裏返
うらえり	裏襟
うらうち	裏打ち	裏打
うらうす	浦臼
うらあみ	裏編み
うやむや	有耶無耶
うやうや	恭
うもうだ	羽毛田
うめやま	梅山
うめもり	梅森
うめもと	梅本
うめむろ	梅室
うめむら	梅村
うめみや	梅宮
うめぼし	梅干	梅干し
うめばち	梅鉢
うめはら	梅原
うめづけ	梅漬け	梅漬
うめつく	埋め尽
うめたに	梅谷
うめたて	埋立て	埋立
うめぞめ	梅染
うめぞの	梅園
うめしゅ	梅酒
うめざわ	梅澤	梅沢
うめざき	梅崎
うめさわ	梅沢
うめさお	梅棹
うめこみ	埋め込み
うめくさ	埋草	埋め草
うめきち	梅吉
うめがわ	梅川
うめがき	梅垣
うめがえ	梅枝
うめあわ	埋め合
うみやま	海山
うみはら	海腹
うみのひ	海の日
うみねこ	海猫
うみなり	海鳴り
うみどり	海鳥
うみづり	海釣	海釣り
うみづき	産み月
うみだし	海田市
うみぞい	海沿い
うみさち	海幸
うみがわ	海側
うみがめ	海亀
うみがみ	海神
うみかぜ	海風
うみおと	生み落	産み落
うみうし	海牛
うみうお	海魚
うまれん	馬連
うまれつ	生まれ付
うまれか	生まれ変
うまれお	生まれ落
うまみち	馬道
うまぶね	馬槽
うまばん	馬番
うまばえ	馬蠅
うまはし	馬橋
うまのり	馬乗り
うまぬし	馬主
うまどし	午年
うまとび	馬飛び	馬跳び
うまづら	馬面
うまたて	馬立
うまたち	馬達
うまずら	馬面
うまずめ	石女
うまさけ	旨酒	味酒
うまごや	馬小屋
うまごめ	馬込
うまこし	馬越
うまくさ	秣
うまいり	馬入
うまいち	馬市
うまあぶ	馬虻
うべせん	宇部線
うべこう	宇部興
うへんち	右辺値
うぶやま	産山
うぶすな	産土
うぶごえ	産声
うふさま	右府様
うびょう	宇廟
うひょう	雨氷
うばそく	優婆塞
うばすて	姥捨て	姥捨
うばがい	姥貝
うばいと	奪い取
うばいし	姥石
うばいさ	奪い去
うばいあ	奪い合
うのはな	卯の花
うのせん	宇野線
うねもと	畝本
うねかわ	畝川
うねおか	宇根岡
うぬぼれ	自惚れ
うなばら	海原
うなどん	鰻丼
うなづき	宇奈月
うなぎや	鰻屋
うながし	令
うなかみ	海上
うどんや	うどん屋	饂飩屋
うどんこ	饂飩粉
うどねり	内舎人
うでまえ	腕前
うでぶし	腕節
うでづく	腕尽く
うでだめ	腕試
うでたて	腕立
うでずく	腕ずく	腕尽く
うでぐみ	腕組み
うできき	腕利き
うでがた	腕固
うてんじ	雨天時
うつろう	映ろう	移ろう
うつろい	移ろい
うつりゆ	移り行
うつりつ	鬱律
うつりぎ	移り気
うつりが	移り香
うつりか	移り変
うつよく	鬱抑
うつゆう	鬱邑	鬱悒
うつもん	鬱悶
うつみや	宇津宮
うつぼつ	鬱勃
うつばり	梁
うつそみ	現身
うつぜん	鬱然
うつせみ	空蝉	現身
うつしよ	現世
うつしみ	現身
うつしと	写し取
うつしだ	映し出	写し出
うつぎみ	鬱気味
うつおう	鬱懊	鬱怏	鬱泱
うつうつ	鬱鬱	鬱々
うついく	鬱郁
うっぷん	欝憤	鬱憤
うっとう	鬱陶	欝陶
うってで	打って出
うったえ	訴え
うったい	鬱滞
うっそく	鬱塞
うっそう	鬱蒼	欝蒼	鬱葱
うっせき	うっ積	鬱積	欝積
うっせい	鬱生
うっすら	薄ら
うっこん	鬱金
うっけつ	うっ血	鬱結	鬱血	欝血
うっくつ	鬱屈
うちわも	内輪揉
うちわた	内渡
うちわけ	内訳
うちわく	内枠
うちょく	右直
うちゅう	雨中	宇宙
うちやま	内山
うちやぶ	討ち破	打ち破
うちもの	打ち物	打物
うちもと	内一
うちむら	内村
うちむき	内向き
うちみや	内宮
うちみず	打ち水
うちまわ	内回
うちまた	内股
うちまご	内孫
うちまく	内幕
うちまき	内巻	内巻き
うちぼり	内堀
うちぼう	内房
うちほろ	討ち滅
うちぶろ	内風呂
うちひら	内平
うちひし	打ち拉
うちばり	梁
うちばば	内馬場
うちはら	打ち払	内原
うちはな	打ち放
うちはた	討ち果
うちはし	内橋
うちのり	内法	内のり
うちのみ	内海
うちぬき	打抜き
うちにわ	内庭
うちなだ	内灘
うちなが	打ち眺
うちなお	打ち直
うちどめ	打止	打ち止め
うちとお	打ち通
うちでし	内弟子
うちづら	内面
うちづま	内妻
うちたお	打ち倒
うちそで	内袖
うちぜい	内税
うちじに	討死
うちざた	内沙汰
うちこわ	打ち壊
うちころ	打ち殺
うちこみ	打ち込み
うちこば	内木場
うちこし	打越
うちげば	内ゲバ
うちくび	打首	打ち首
うちくだ	打ち砕
うちくず	打ち崩
うちぎぬ	打衣
うちきん	内金
うちきり	打ち切り	打切
うちきば	内木場
うちきず	打傷
うちがわ	内側
うちがし	打菓子	打ち菓子
うちがけ	内掛け
うちかわ	内川
うちかた	内方	打ち方	内潟
うちかけ	裲襠	打掛け
うちおと	打ち落	撃ち落
うちうら	内浦
うちうみ	内海
うちうち	内々
うちいり	内入り
うちいで	打出
うちいけ	内池
うちあわ	打合
うちあみ	打ち網	打網
うちあげ	打ち上げ
うだがわ	宇田川
うたよみ	歌詠み
うたもの	唄物	歌物
うたまろ	歌麿
うたまる	歌丸
うたほん	歌本
うたびと	歌人
うたひめ	歌姫
うたばん	歌伴
うたたね	転寝	うたた寝	転た寝
うたせゆ	打たせ湯
うたしろ	歌代
うたごえ	歌声
うたぐち	歌口
うたぎれ	歌切
うたがわ	宇田川	歌川
うたがき	歌垣
うたがい	疑い
うたかた	泡沫
うたかい	歌会
うたいり	歌入り
うたいめ	歌い女
うたいて	歌い手
うたいだ	歌い出
うたいあ	謳い上	歌い明	歌い上
うそふき	嘯
うそなき	嘘泣き
うそつき	嘘吐き	嘘つき
うそさむ	うそ寒
うそくさ	嘘臭
うそうそ	嘘々
うせもの	失せ物
うせつま	右折待
うずらの	鶉野
うずまさ	太秦
うずまき	渦巻	渦巻き
うずたか	堆
うずしお	渦潮
うずくま	蹲	踞
うすわら	薄笑
うすらひ	薄ら氷
うすよご	薄汚
うすよう	薄葉	薄様
うすゆき	薄雪
うすやみ	薄闇
うすやき	薄焼き	薄焼
うすもの	薄物
うすまく	薄膜
うすべり	薄縁
うすべに	薄紅
うすべお	護田鳥尾
うすのろ	薄鈍
うすねず	薄鼠
うすぬり	薄塗り	薄塗
うすにく	薄肉
うすづき	薄月
うすちゃ	薄茶
うすずみ	薄墨
うすじお	薄塩
うすざん	有珠山
うすぐら	薄暗
うすぐも	薄雲
うすくち	薄口
うすぎり	薄切り
うすぎぬ	薄衣
うすきみ	薄気味
うすきし	臼杵市
うすがみ	薄紙
うすがた	薄型
うすかわ	薄皮
うすうす	薄々
うすいろ	薄色
うすいた	薄板
うすあじ	薄味
うすあげ	薄揚げ
うじょう	鵜匠	羽状	有情	雨上
うじむし	ウジ虫	蛆虫
うじふさ	氏房
うじはら	氏原
うじちゃ	宇治茶
うじせん	宇治線
うじさと	氏郷
うじがわ	宇治川
うじがみ	氏神
うじいえ	氏家
うしわた	牛渡
うしろめ	後目
うしろむ	後向	後ろ向
うしろみ	後ろ身	後見
うしろで	後ろ手
うしろづ	後ろ付
うしらん	烏糸欄
うしょう	鵜匠
うしみつ	丑三つ
うしまる	牛丸
うしまど	牛窓
うしぼり	牛堀
うしぶか	牛深
うしのひ	丑の日
うしどし	丑年
うしとら	艮
うしじま	牛嶋	牛島
うしごや	牛小屋
うしごめ	牛込
うしかい	牛飼	牛飼い
うしおだ	潮田
うさせつ	右左折
うさぎざ	兎座
うさがわ	宇佐川
うごきだ	動き出
うけわた	受け渡	受渡
うけやど	請宿
うけもど	受け戻
うけぶみ	請文
うけばこ	凵
うけにん	請人
うけなが	受け流
うけとり	受け取り	受取
うけつけ	受付	受付け	受け付け
うけたま	受け賜
うけしょ	請書	受書
うけざら	受け皿
うけごし	受け腰
うけこた	受け答
うけぐち	受け口	受口
うけくち	受け口
うけがわ	受け側
うけかた	受け方
うけおい	請負
うけうり	受け売り
うけいれ	受入れ	受け入れ	受入
うぐいす	鴬	鶯
うきよえ	浮世絵
うきょう	右京
うきぼり	浮き彫り	浮彫
うきふね	浮舟	浮船
うきばし	浮橋
うきはし	浮き橋	浮橋
うきしま	浮島
うきしず	浮き沈
うきごし	浮き腰	浮腰
うきぐも	浮雲
うきくさ	浮草
うきがや	浮ヶ谷
うきうき	浮き浮き
うきいし	浮石
うきあし	浮足
うかれめ	浮かれ女
うかびで	浮かび出
うかびあ	浮かび上
うかがい	伺	窺
うかいろ	迂回路
うおみつ	魚光
うおみそ	魚味噌
うおのめ	魚の目
うおぬま	魚沼
うおづし	魚津市
うおつか	魚塚
うおずみ	魚住
うおしま	魚島
うおざき	魚崎
うおがし	魚河岸
うえろく	上本町六丁目
うえやま	上山
うえもん	右衛門
うえもり	上森
うえもと	植本
うえむら	上村	植村
うえむき	上向き
うえまつ	植松	上松
うえまち	上町
うえひら	植平
うえはら	上原	植原
うえはま	上浜
うえのし	上野市
うえにし	上西
うえなか	植中
うえづけ	上付
うえつけ	植付け
うえだし	上田市
うえたに	上谷
うえたけ	植竹
うえぞの	上園
うえすぎ	上杉
うえじま	上島
うえじに	餓死
うえしま	上島
うえしば	植芝
うえした	上下
うえしき	上式
うえさま	上様
うえさか	上坂
うえこみ	植え込み
うえくぼ	上窪
うえくさ	植草
うえきや	植木屋
うえがわ	上側
うえおか	植岡
うええだ	上枝
ういろう	外郎
ういまご	初孫
ういじん	初陣
ういざん	初産
ういうい	初々
うぃーん	維納
うーろん	烏龍
うーはん	武漢
いんわい	淫猥
いんろう	印籠	印篭
いんれつ	陰裂
いんれき	陰暦
いんれい	引例
いんりつ	韻律
いんらん	淫乱
いんよく	淫欲
いんよう	飲用	引用	陰陽
いんもん	陰門
いんもう	陰毛
いんめん	印面	隠面
いんめつ	湮滅	隠滅
いんめい	因明
いんぽん	淫奔	淫本	院本	印本
いんぼう	陰謀
いんぺい	隠蔽
いんべん	員弁
いんぶん	韻文
いんびさ	淫靡さ
いんばん	印判
いんばい	淫売
いんのう	陰嚢
いんねん	因縁
いんにん	隠忍
いんにく	印肉
いんなみ	印南
いんない	院内	印内
いんどう	犬童	引導
いんとん	隠遁
いんとく	隠匿
いんとう	咽頭	淫蕩
いんてん	院展
いんてい	陰梃
いんたい	隠退	引退
いんぞく	姻族
いんそつ	院卒	引率
いんぜん	隠然
いんぜみ	院ゼミ
いんぜい	印税
いんせん	隠線	陰線
いんせつ	引接
いんせき	姻戚	隕石	引責	殞石
いんせい	陰性	院政	院生	隠栖	隠棲
いんずう	員数
いんすう	因数	引数	員数
いんすい	引水
いんじょ	淫女
いんじゅ	印綬	院主
いんじゃ	隠者
いんじき	印字機
いんしん	陰唇	殷賑
いんしゅ	飲酒
いんしつ	陰湿
いんしか	因子化
いんざい	印西	印材
いんさん	陰惨
いんさつ	印刷
いんごう	院号	因業
いんこく	陰刻	印刻
いんこう	印行	咽喉	淫荒	淫行
いんげん	隠元
いんけん	隠顕	引見	陰険	隠見
いんけい	陰茎
いんぎん	慇懃
いんきん	陰金	引磬	印金
いんきょ	允許	隠居	殷墟
いんがし	印画紙
いんがい	院外	員外
いんかん	印鑑
いんかく	陰核
いんかか	隠花果
いんえい	印影	陰影	陰翳
いんうつ	陰鬱
いんいつ	隠逸
いわんや	況んや
いわゆる	所謂
いわやま	岩山
いわもと	岩本
いわむろ	岩室
いわむら	岩村
いわみね	岩峰
いわみだ	岩見田
いわみず	岩水
いわまつ	岩松
いわほり	岩堀
いわぶろ	岩風呂
いわぶち	岩淵	岩渕
いわふね	岩船	岩舟
いわふじ	岩藤
いわひろ	岩廣
いわばし	石走
いわはら	岩原
いわはだ	岩肌
いわはし	岩橋
いわのり	岩海苔
いわぬま	岩沼
いわなみ	岩波	岩浪
いわない	岩内
いわつぼ	岩壺
いわつき	岩槻	岩月
いわつか	岩塚
いわつう	岩通
いわだけ	岩岳
いわたや	岩田屋
いわたに	岩谷
いわたし	磐田市
いわたけ	岩岳
いわたき	岩滝
いわしろ	岩代	岩城
いわした	岩下
いわさわ	岩沢
いわさき	岩崎
いわくら	岩倉	岩鞍
いわくま	岩熊
いわくに	岩国
いわきり	岩切
いわきじ	磐城路
いわがに	岩蟹
いわかん	違和感
いわかわ	岩川
いわかめ	岩亀
いわかみ	岩上
いわかど	岩角
いわかげ	岩陰
いわおか	岩岡
いわうち	岩内
いわあな	岩穴
いろんな	色んな
いろわけ	色分	色分け
いろもの	色物
いろめい	色名
いろぶみ	色文
いろどり	彩
いろどめ	色止め
いろづけ	色付
いろづか	色使
いろつや	色艶
いろちが	色違
いろずり	色刷	色刷り
いろすう	色数
いろじろ	色白
いろごと	色事
いろこい	色恋
いろぐろ	色黒
いろくず	鱗
いろがみ	色紙
いろかわ	色川
いろかず	色数
いろおび	色帯
いろおち	色落ち
いろいろ	色色	色々	色いろ
いろあく	色悪
いろあい	色合い	色相	色合
いれわす	入れ忘
いれもの	容れ物	入れ物
いれふだ	入れ札
いれなお	入れ直
いれぢえ	入れ知恵
いれちが	入れ違
いれたて	入れ立て
いれずみ	入れ墨	文身	刺青
いれこみ	入込
いれぐい	入れ食い
いれかた	入れ方
いれかえ	入れ替え	入替	入換	入れ換え
いれいひ	慰霊碑
いるまし	入間市
いるかせ	忽
いるかざ	海豚座
いりよう	入用	入り用
いりょく	威力	偉力	意力
いりょう	衣糧	衣料	医療
いりゅう	慰留	遺留	移流
いりやま	入山
いりもや	入母屋
いりむこ	入り婿
いりみだ	入り乱
いりまめ	煎豆
いりまち	入り待ち
いりふね	入船	入り船
いりびた	入り浸
いりなか	杁中
いりしお	入潮
いりさわ	入澤
いりぐち	入口	入り口
いりくち	入り口
いりがい	入貝
いりうみ	入海
いりうち	入内
いりあい	入会
いらくさ	刺草	蕁麻
いらいら	苛苛	苛々
いよてつ	伊予鉄
いよたに	伊豫谷
いような	異様な
いよいよ	愈々	愈
いやなが	彌永
いやちこ	灼然
いやしく	苟
いやけい	祖谷渓
いやおう	否応
いやいや	嫌々
いももと	芋本
いもめじ	芋目地
いもめし	芋飯
いもむし	芋虫
いもばん	芋版
いものし	鋳物師
いもづる	芋蔓
いもたれ	胃もたれ
いもがゆ	芋粥
いもかわ	芋川
いもうと	妹
いもあん	芋餡
いむらや	井村屋
いむしつ	医務室
いみろん	意味論
いみょう	異名
いみもの	忌物	斎物	忌み物
いみぶか	意味深
いみなし	意味無
いみてき	意味的
いみしん	意味深
いみきら	忌み嫌
いみあい	意味合い	意味合
いまわの	忌野
いまよし	今吉
いまよう	今様
いまやま	今山
いまむら	今村
いまみや	今宮
いまみち	今道
いままで	今まで	今迄
いまべつ	今別
いまふじ	今藤
いまふく	今福
いまふう	今風
いまひと	今仁	今一
いまばり	今治
いまはん	今半
いまはし	今橋
いまにし	今西
いまなが	今永
いまなか	今中	今仲
いまどき	今時
いまだに	未だに
いまだて	今立
いまぜき	今関
いましめ	戒め
いましま	今嶋
いまさら	今更	今さら
いまさと	今里
いまさき	今崎
いまごろ	今頃	今ごろ
いまころ	今頃
いまがわ	今川
いまがね	今金
いまおか	今岡
いまいま	忌々
いまいで	今出
いまいち	今市	今一
いまいけ	今池
いぼだい	疣鯛
いぼがわ	揖保川
いほうは	違法派
いほうし	違法視
いぶんし	異分子
いぶんか	異文化
いぶりだ	燻り出
いぶすき	指宿
いぶくろ	胃袋
いふしん	畏怖心
いふごう	異符号
いふくべ	伊福部
いびしゃ	居飛車
いびがわ	揖斐川
いひょう	意表	違表	依憑
いばらぎ	茨城
いばらき	茨木	茨城
いばしょ	居場所
いはらだ	居原田
いのまた	猪股	猪俣
いのぶた	猪豚
いのはら	猪原
いのなか	井の中
いのちも	命燃
いのちと	命取
いのちご	命乞
いのちが	命懸
いのした	井下
いのしし	猪	亥	豕	猯
いのさか	猪坂
いのこり	居残り
いのぐち	井口	井ノ口
いのくま	猪熊
いのくち	井口
いのおか	猪岡
いのうえ	井上	井之上
いねもく	Graminales	Glumiflorae	イネ目	Poales
いねむり	居眠り
いねみつ	稲光
いねなが	稲永
いねかり	稲刈り	稲刈
いぬやま	犬山
いぬまる	犬丸
いぬぶし	犬伏
いぬぶえ	犬笛
いぬねこ	犬猫
いぬなき	犬鳴
いぬどし	戌年
いぬつか	犬塚
いぬたで	犬蓼
いぬぞり	犬橇	犬ぞり
いぬじに	犬死に
いぬごや	犬小屋
いぬころ	犬ころ
いぬぐい	犬喰い	犬食い
いぬくい	犬食い
いぬがみ	犬神
いぬかみ	犬上
いぬかき	犬掻き
いぬかい	犬飼	犬養
いにょう	囲繞
いにゅう	移入
いにしえ	古	古え
いなりだ	稲荷田
いなよし	稲吉
いなもり	稲森	稲盛
いなもと	稲元
いなむら	稲村
いなむし	蝗
いなみね	稲嶺
いなひさ	稲久
いなにわ	稲庭
いななき	嘶き
いななが	稲永
いなづま	稲妻
いなつぎ	稲継
いなつき	稲築
いなだき	頂
いなたま	稲魂
いなずま	稲妻	霆
いなしろ	稲城
いなしき	稲敷
いなざわ	稲沢
いなさく	稲作
いなぎし	稲城市
いながわ	猪名川	稲川
いながけ	稲掛
いながき	稲垣
いなかわ	稲川
いなかず	稲数
いなかじ	田舎染
いなおか	稲岡
いどみず	井戸水
いどべい	井戸塀
いどばた	井戸端
いどたい	緯度帯
いどころ	居所	拠所
いどがわ	井戸川
いどうび	移動日
いどうひ	移動費
いどうは	移動派
いどうど	移動度
いどうち	移動地
いどうじ	移動時
いどうご	移動後
いとより	糸撚り	糸縒り
いとやま	糸山
いとまん	糸満
いとまき	糸巻
いとへん	糸偏
いとのこ	糸鋸
いとぬき	糸貫
いとてき	意図的
いとたに	糸谷
いとぞこ	糸底
いとすぎ	糸杉
いとしま	糸島
いとしご	いとし子
いとざき	糸崎
いとさき	糸崎
いとけな	稚	幼
いとぐち	緒	糸口
いとくず	糸屑
いとおり	糸織
いとうや	伊東屋
いとうし	伊東市
いでんや	遺伝屋
いでんし	遺伝子
いでむら	出村
いでみつ	出光
いでさわ	出澤	出沢
いでぐち	井手口
いづぶち	出渕
いづはら	出原	厳原
いづつや	井筒屋
いつわり	偽り
いつらく	逸楽
いつぶん	逸聞
いつぶつ	逸物
いつはし	五橋
いつづけ	居続け
いつだつ	逸脱
いつしか	何時しか
いつざい	逸材
いつごろ	いつ頃
いつくし	慈
いつきだ	五木田
いっぽん	一本
いっぽう	一報	一法	一方
いっぺん	一変	一偏	一辺	一編	一遍	一片	一篇
いっぺき	一碧
いっぺい	一兵	一平
いっぷん	一分	１分	1分
いっぷく	一服
いっぷう	一風	一封
いっぴん	逸品	一品
いっぴつ	一筆
いっぴき	一匹
いっぱん	一般	一斑	一版	一半	一班
いっぱつ	一髪	一発
いっぱし	一端
いっぱく	一白	一泊	一拍
いっぱい	一敗	一杯
いっとく	一得
いっとき	一時
いっとう	一統	一投	一頭	一等	一党	一刀
いってん	一転	1点	一点
いってつ	一徹
いってこ	行って来
いってく	行って来
いってき	一滴	一擲	行って来
いってい	一定
いっつう	一通	1通
いっつい	一対
いっちど	一致度
いったん	一短	一反	一たん	一端	一旦
いったく	一卓
いったい	一体	一帯	一隊
いっそく	一足
いっそう	一掃	一層	逸走
いっせん	一銭	一線	一閃	一戦	一千
いっせつ	一説	一節
いっせき	一席	一石	一隻	一夕
いっせい	一声	一生	一世	一成	一誠	一斉
いっすん	一寸
いっすい	一睡	溢水
いっしん	一身	一心	一審	一新
いっしょ	一所	一緒	一書
いっしゅ	一種	一首
いっしゃ	一者	一社
いっしつ	一室	一失
いっしき	一色	一式
いっさつ	一冊	一札
いっさく	一昨	一策	一作
いっさい	一再	一済	一際	一切	一歳
いっこん	一献
いっこだ	一戸建
いっこく	一刻	一国
いっこう	一項	一稿	一幸	一行	一考	一向	一鉤	1項	溢口
いっけん	一見	一件	1件	一間	一軒
いっけつ	一決	一穴	溢血
いっけい	一計	一系	一景
いっきん	一斤	一金
いっきよ	一気読
いっきょ	一挙
いっきに	一気に
いっきく	一掬
いっかん	一貫	一環	一巻
いっかつ	一喝	一括
いっかく	一廓	一攫	一画	一獲	一劃	一角
いっかい	１Ｆ	１回	一介	1回	一階	一塊	一回
いちわり	一割
いちろん	一論
いちろう	伊知郎	市郎	一浪	一郎	一朗
いちれん	一蓮	一連
いちれつ	一列	1列
いちれい	一例	一礼
いちるい	一塁	一類
いちりん	1輪	一輪
いちりの	一里野
いちりつ	市立	一率	一律
いちりき	一力
いちらん	一覧	一蘭	壹覽
いちよし	市吉
いちよく	一翼
いちよう	一様	一葉
いちょう	胃腸	異聴	異朝	医長	移牒	威張	移調	銀杏	公孫樹
いちゆう	一揖
いちゅう	意中	移駐
いちやづ	一夜漬
いちやく	一躍	一役
いちもん	一問	一門	一文
いちもつ	一物	逸物
いちもじ	1文字	１文字	一文字
いちもく	一目
いちもう	一毛
いちめん	一面
いちめい	一名	一命	1名
いちむら	市村	一村
いちまん	一萬	一万
いちまつ	一抹	市松	一松
いちまい	一枚
いちぼう	一望
いちべつ	一瞥	一別
いちぶん	一分	一聞	一文
いちびん	一便
いちひめ	市姫
いちばん	壱番	一番
いちばた	一畑
いちばい	一倍
いちはら	市原
いちはや	逸早	逸速	一早
いちはつ	鳶尾
いちはた	一畑
いちはし	市橋
いちのへ	一戸
いちのせ	一ノ瀬	市之瀬	一野瀬	一瀬	一の瀬
いちのき	一の樹
いちのう	一能
いちねん	一年	1年	一念
いちにん	一人	一任
いちにょ	一如
いちにほ	一二歩
いちにち	1日	一日
いちなん	一難
いちどめ	一度目
いちどく	一読
いちどき	一時
いちどう	一同	一堂	一道
いちとし	一都市
いちてき	位置的
いちづけ	位置付け
いちだん	一団	一段
いちださ	一打差
いちだい	一大	一代	一台
いちたに	市谷
いちぞん	一存
いちぞく	一族
いちぜん	一膳
いちすぎ	一杉
いちじん	一陣
いちじる	著
いちじょ	一助	一女
いちじま	市嶋	市島
いちじつ	一日
いちじし	一次子
いちじく	無花果	一軸
いちじき	一時期
いちごん	一言
いちごう	一号	一合	壱号
いちこつ	壱越
いちこし	市越
いちこう	一高
いちげん	一見	一弦	一元	一言	一限	壱源
いちげき	一撃
いちげい	一芸
いちけん	一研
いちけい	位置系
いちぐん	一群	一軍
いちぐう	一隅	一遇
いちくら	肆
いちがん	一眼	一丸
いちがや	市ヶ谷	市谷	市ケ谷
いちがつ	睦月	１月	一月	1月
いちがお	市ヶ尾
いちがい	一概
いちかわ	市川
いちから	一から
いちかい	市貝
いちおん	一音
いちおし	一推し	一押し
いちおく	一億
いちおう	一応
いちえん	一円
いちいん	一院	一員	一因
いちいち	一々
いちあん	一案
いちあく	一握
いだてん	韋駄天
いだいさ	偉大さ
いたんじ	異端児
いたんし	異端視
いたわり	功
いたりあ	伊太利亜	伊太利屋
いたりー	伊太利
いたよせ	板寄
いたもち	板持
いためん	板面
いためつ	痛め付
いためし	イタ飯
いたみど	痛み止
いたみし	伊丹市
いたみい	痛み入
いたまえ	板前
いたべい	板塀
いたばり	板張り	板張
いたばし	板橋
いたばさ	板挟
いたはし	板橋
いたのま	板の間
いたどり	板取
いたでん	イタ電
いたづら	惡戲	悪戯
いたづけ	板付
いたって	至って
いただに	板谷
いただき	頂
いたずり	板摺り
いたずら	徒ら	悪戯	徒
いたじき	板敷
いたざき	板崎
いたざい	板材
いたさと	板里
いたくら	板倉
いたきれ	板切れ
いたがみ	板紙
いたがね	板金	鈑
いたがき	板垣
いたかべ	板壁
いたかぶ	板株
いたいた	痛々
いたいじ	異体字
いたあつ	板厚
いぞんわ	依存和
いぞんぶ	依存部
いぞんど	依存度
いそやま	磯山	礒山
いそむら	磯村
いそみち	磯道
いそまつ	磯松
いそのけ	磯野家
いそなみ	磯波
いそとし	五十年
いそじん	磯陣
いそしぎ	磯鷸
いそざき	磯崎
いそざお	磯竿
いそごく	磯子区
いそくど	異速度
いそがわ	五十川
いそがみ	磯上
いそがい	磯貝
いそうさ	位相差
いそうき	移相器
いせわん	伊勢湾
いせもと	伊勢本
いせはら	伊勢原
いせつご	移設後
いせたん	伊勢丹
いせせん	伊勢線
いせしま	伊勢志摩
いせざき	伊勢崎
いせさき	伊勢崎	伊勢左木
いせきご	移籍後
いせかい	異世界
いせえび	伊勢海老	伊勢エビ
いせいか	異性化
いずもし	出雲市
いずみや	泉谷
いずみだ	泉田
いずみく	泉区
いずまい	居ずまい
いずはら	厳原
いずぬま	伊豆沼
いずしま	出島
いすのき	柞
いすせき	椅子席
いすがた	椅子型
いじわる	意地悪
いじるし	井印
いじょく	居職
いじょう	委譲	異常	≧	異状	以上	移譲	移乗	囲繞
いじゅつ	医術
いじゅう	移住
いじゃく	胃弱
いじっぱ	意地っ張
いじたい	異字体
いじげん	異次元
いしんは	維新派
いしんご	維新後
いしわり	石割
いしわら	石原
いしわた	石渡	石綿
いしょく	異色	委嘱	移植	依嘱	衣食
いしょう	異称	衣装	衣裳	意匠	囲障
いしゆみ	弩	石弓
いしゅつ	移出
いしゅく	委縮	萎縮	畏縮	蝟縮
いしゅう	蝟集	異臭	遺習
いしやま	石山
いしやき	石焼き	石焼
いしもり	石森
いしもと	石本	石元
いしもち	石持
いしもだ	石母田
いしもた	石母田
いしむろ	石室
いしむれ	石牟礼
いしむら	石村
いしみね	石嶺
いしみつ	石光
いしみち	石道
いしまる	石丸
いしまつ	石松
いしまき	石巻
いしほう	医師法
いしべい	石塀
いしぶみ	碑
いしぶし	石伏
いしばち	石鉢
いしばし	石橋
いしばい	石灰
いしはり	石播
いしはら	石原
いしはま	石浜
いしはた	石畑
いしぬき	石貫
いしなべ	石鍋
いしなぎ	石投
いしどこ	石床
いしどう	石堂
いしとび	石飛
いしでら	石寺
いしてき	意志的
いしづけ	石附
いしづく	石造
いしづき	石突き	鐓	石突
いしづか	石塚
いしづえ	礎
いしつみ	石積み
いしつか	石塚
いしだん	石段
いしだか	石高
いしだい	石鯛
いしぞね	石曽根
いしそね	石曽根
いしずけ	石附
いしずか	石塚
いしずえ	礎
いしじま	石嶋	石島
いしした	石下
いしざわ	石沢	石澤
いしざら	石皿
いしざき	石崎
いしざか	石坂
いしごう	石郷
いしころ	石塊
いしこし	石越
いしけり	石蹴り
いしぐろ	石黒
いしぐみ	石組み
いしくら	石倉
いしくに	石國
いしきか	意識化	意識下
いしがめ	石亀
いしがみ	石神	石上
いしがま	石釜
いしがね	石金
いしがき	石垣
いしかわ	石河	石川
いしかり	石狩
いしかめ	石亀
いしかべ	石壁
いしかい	医師会
いしおか	石岡
いしうち	石打
いしうす	石臼
いざよい	十六夜
いざなみ	伊邪那美	伊弉冉
いざなぎ	伊邪那岐	伊弉諾
いざかや	居酒屋
いさりび	漁火
いさやま	諌山	伊佐山
いさみた	勇み立
いさはら	井佐原
いさはや	諌早
いささか	聊か
いさぎよ	潔
いさかい	諍い	諍
いさおし	功	勲
いごころ	居心
いごこち	居心地
いごきし	囲碁棋士
いこまし	生駒市
いこうじ	移行時
いこうご	移行後
いこうき	移行期
いこーる	＝
いげんご	異言語
いけわき	池脇
いけやま	池山
いけもり	池森
いけもと	池本
いけみや	池宮
いけみず	池水
いけばな	活花	挿花	生け花
いけはら	池原
いけはぎ	生剥
いけにえ	犧	犠	生け贄	生贄	犠牲	牲
いけなみ	池波
いけなが	池永
いけつき	池月
いけだし	池田市
いけたに	池谷
いけじり	池尻
いけした	池下
いけざわ	池沢	生澤	池澤
いけさか	池坂
いけがわ	池川
いけがや	池谷	池ケ谷
いけがめ	池亀
いけがみ	池上
いけがき	生垣	生け垣
いけうら	池浦
いけうち	池内
いけうお	活魚
いぐるみ	弑	弋
いぐすり	胃薬
いくりん	育林
いくらか	幾らか
いくゆう	育友
いくもう	育毛
いくまん	幾万
いくほど	幾程
いくぶん	いく分	幾分
いくひろ	郁博
いくひと	生人
いくばく	幾何	幾許
いくはら	幾原
いくねん	幾年
いくにん	幾人
いくにち	幾日
いくとせ	幾年
いくとお	幾通
いくつき	幾月
いくつか	幾つか
いくたり	幾人
いくたま	生玉
いくたび	幾度
いくぞう	幾三	郁三
いくそう	幾層
いくせん	幾千
いくせい	育成
いくすじ	幾筋
いくすう	育雛
いくじひ	育児費
いくしゅ	育種
いくしま	生島
いくさば	軍場
いくさち	生幸
いくさき	行く先
いくさか	生坂
いくえい	育英
いくいな	生稲
いぎりす	英吉利
いぎょう	医業	遺業	偉業	異形
いぎもう	異義申
いぎぶか	意義深
いぎあり	異議有り
いきわた	行き渡
いきわか	生き別
いきりた	熱り立
いきょく	異曲	委曲	医局
いきょう	異教	井京	異境	異郷
いきもの	生物	生き物
いきはじ	生き恥
いきのね	息の根
いきのこ	生き残
いきぬき	息抜き	息抜
いきなや	行き悩
いきなが	生き長
いきない	域内
いきどお	憤
いきとど	行き届
いきづか	息使	息遣
いきつづ	生き続
いきつけ	行き付け
いきつぎ	息継ぎ
いきつき	生月
いきちが	行き違
いきだお	行き倒
いきすじ	粋筋
いきすぎ	行過ぎ
いきしゅ	異機種
いきしに	生き死に
いきしな	行きしな
いきざま	生き様
いきざい	遺棄罪
いきさわ	生澤
いきさつ	経緯
いきさき	行き先	行先
いきごみ	意気ごみ	意気込み
いきぐる	息苦
いきくち	生き口
いきぎれ	息切れ
いきぎも	生き肝
いきがみ	生き神
いきがい	域外	生き甲斐	生きがい
いきかん	異機間
いきかよ	行き通
いきかた	生き方	行き方
いきかえ	行き帰	生き返
いきおい	勢い
いきうめ	生き埋め	生埋め
いきうま	生き馬
いきうつ	生き写
いきいき	生き生き
いきあた	行き当
いがらし	五十嵐
いがみあ	啀み合
いがっか	医学科
いがせん	伊賀線
いがしら	井頭
いがぐり	毬栗
いがくぶ	医学部
いがくか	医学科
いがうえ	伊賀上
いかるが	斑鳩
いかりど	錨戸
いからし	五十嵐
いかよう	如何様
いかめら	胃カメラ
いかむけ	医家向け
いかほど	如何程
いかひか	異花被花
いかなる	如何なる
いかなご	玉筋魚
いかてん	イカ天
いかづち	雷
いかだい	筏井
いかずち	霹	雷	霆
いかすみ	烏賊墨
いかすい	胃下垂
いかしか	医科歯科
いかざき	五十崎
いかさま	如何様
いかけん	医科研
いかがく	医化学	医科学
いかおな	以下同
いおんか	イオン化
いおはら	庵原
いおうじ	医王寺
いえよう	家様
いえやま	家山
いえやす	家康
いえもと	家元
いえもち	家茂	家持ち
いえみつ	家光
いえなみ	家並	家並み
いえなが	家永
いえども	雖	雖も
いえつき	家付	家付き
いえすじ	家筋
いえしま	家島
いえがら	家柄
いえがた	家型
いえいえ	家々
いいわた	言い渡	言渡
いいわす	言い忘
いいわけ	言い訳	言訳
いいよど	言い淀
いいやま	飯山
いいもり	飯盛	飯森
いいむら	飯村
いいまわ	言い回
いいまぎ	言い紛
いいぼし	飯干
いいぶん	言い分
いいふる	言い古
いいふく	言い含
いいひろ	言い広
いいひら	言い開
いいはん	一翻
いいはま	飯浜
いいはな	言い放
いいはじ	言い始
いいのこ	言い残
いいのが	言い逃
いいぬま	飯沼
いいなん	飯南
いいなら	言い習
いいなが	稲永
いいなお	言い直
いいとお	言い通
いいづな	飯綱
いいづか	飯塚
いいつの	言い募
いいつづ	言い続
いいつた	言い伝
いいつく	言い尽
いいちが	言い違
いいだし	飯田市
いいだこ	飯蛸
いいだか	飯高
いいたて	飯館
いいたが	言い違
いいたか	飯高
いいそん	言い損
いいそこ	言い損
いいずか	飯塚
いいすて	言い捨て
いいすぎ	言い過ぎ
いいじま	飯嶋	飯島
いいしぶ	言い渋
いいざわ	飯沢
いいざか	飯坂
いいさか	飯坂
いいぐさ	言い草
いいくる	言い包
いいくら	飯倉
いいぎり	椅
いいがた	言い難
いいかわ	言い交
いいかた	言い方
いいかえ	言い替え	言い返	言い換え
いいおよ	言い及
いいおと	言い落
いいおく	言い送
いいおか	飯岡
いいうり	言売
いいある	言い歩
いいあい	言い合い
いあんふ	慰安婦
いーすと	ＥＡＳＴ
あんらく	安楽
あんやく	暗躍
あんもち	餡餅
あんもく	暗黙
あんめん	暗面
あんみん	安眠
あんみつ	餡蜜
あんまん	餡饅
あんまく	暗幕
あんぽり	安保理
あんぽう	罨法
あんぶん	案分	案文	按分
あんひつ	安謐
あんぱん	あんパン	餡パン
あんぱち	安八
あんばこ	暗箱
あんばい	按排	按配	塩梅	案配
あんのん	安穏
あんのう	鞍嚢
あんねん	安念
あんねい	安寧
あんにん	杏仁
あんなん	安南
あんなか	安中
あんない	案内
あんどん	行灯	闇鈍	行燈
あんどく	暗読
あんどう	安東	安藤
あんとく	安徳
あんとう	安東	暗闘
あんてん	暗転	鞍点
あんてい	安定
あんちん	安珍
あんたん	暗澹
あんたく	安宅
あんたい	安泰
あんそく	安息
あんぜん	暗然	安全
あんせい	安政	安静
あんじん	安心
あんじょ	晏如
あんじゅ	杏樹	庵主
あんしん	安心
あんしょ	暗所
あんしつ	暗室	庵室
あんざん	鞍山	暗算	安産
あんざい	安斎	安齊	安西	安在	安齋	安斉
あんさつ	暗殺
あんごう	暗合	暗号
あんこく	暗黒	闇黒	安国
あんこう	鮟	安康	鱇	鮟鱇
あんこー	暗刻
あんけん	案件
あんけい	安慶
あんぐう	行宮
あんくん	暗君
あんぎゃ	行脚
あんきょ	暗渠	安居
あんきも	鮟肝
あんがい	案外
あんかん	暗槓	安閑
あんかけ	餡掛
あんえい	暗影	安永
あんうん	暗雲
あんうつ	暗鬱
あんいつ	安逸	安佚
あわれむ	恤れむ
あわゆき	沫雪	淡雪	泡雪
あわもり	泡盛
あわぶろ	泡風呂
あわひめ	泡姫
あわばこ	泡箱
あわつぶ	粟粒
あわだち	泡立	泡立ち
あわただ	遽	慌
あわせよ	併せ読
あわせも	合わせ持
あわせの	併せ呑
あわせて	併せて
あわせず	合わせ酢	合せ酢
あわしま	淡島
あわさか	泡坂
あわおど	阿波踊
あれくる	荒れ狂
あるふぁ	α
あるしゅ	或る種
あるごん	Argon	Ar
あるござ	アルゴ座
あるきだ	歩き出
あるきさ	歩き去
あるいは	或は	或いは
ありわら	在原
ありよし	有吉
ありよう	有り様
ありゅう	亜流
ありやま	有山
ありもり	有森
ありもと	有本
ありむら	有村
ありみつ	有光
ありまさ	有正
ありはら	有原	在原
ありはた	有畠
ありなが	有永
ありとも	有朋
ありとう	有藤
ありてい	有体	有り体	有態
ありづか	蟻塚
ありつね	有恒
ありつぎ	有次
ありだか	有り高
ありたま	有玉
ありしよ	在りし世
ありしま	有島
ありさん	阿里山
ありさわ	有沢	有澤
ありさま	有様	有り様
ありさか	有坂
ありくら	有倉
ありくい	食蟻獣
ありがね	有り金
ありがと	有り難	有難
ありがち	有り勝ち
ありがた	有難
ありかわ	有川
ありかべ	有壁
ありかた	あり方	在り方	有り方
ありうる	有り得る
ありあわ	有り合
ありあま	有り余
ありあけ	有明
あらわざ	荒技	荒業
あららぎ	蘭
あらゆる	凡
あらやま	荒山
あらもの	荒物
あらもと	荒本
あらまつ	荒松
あらまち	荒町
あらまた	荒俣
あらまさ	新政
あらまき	荒巻	荒牧	新巻
あらふね	荒船
あらふか	荒深
あらびき	粗引き	粗碾き	粗挽き
あらびあ	亞剌比亞
あらばち	新鉢
あらはま	荒浜
あらはた	荒畑
あらぬの	粗布
あらなわ	荒縄
あらなみ	荒波
あらどこ	新床
あらため	改め
あらたま	新田間
あらたに	新たに	荒谷
あらたけ	荒武
あらそい	争い
あらぜき	荒関
あらすじ	粗筋
あらしね	荒稲
あらさわ	荒澤	荒沢
あらさき	荒崎
あらさが	粗探
あらごと	荒事
あらごし	粗漉し
あらけず	荒削
あらくれ	荒くれ
あらきの	新木野
あらきだ	荒木田
あらがね	荒金	鉱	粗金
あらがき	荒書き	新垣
あらかん	阿羅漢
あらかわ	粗皮	荒川
あらかね	鉱	粗金
あらかた	粗方
あらかせ	荒稼
あらかじ	予	豫
あらおり	粗織
あらうみ	荒海
あらうま	荒馬
あらいわ	荒岩
あらいば	洗い場
あらいど	荒井戸
あらいだ	洗い出
あらいそ	荒磯
あらいし	荒石
あらいあ	洗い上
あらあら	荒々
あゆみよ	歩み寄
あゆづり	鮎釣り
あゆつり	鮎釣り
あゆざわ	鮎澤
あゆさわ	鮎澤
あゆかわ	鮎川
あやめか	アヤメ科
あやむら	文村
あやまり	誤り
あやまち	誤ち	過ち
あやふみ	礼史
あやはな	彩花
あやとり	綾取り
あやとも	文友
あやつり	操
あやつじ	綾辻
あやつか	綾塚
あやせま	綾瀬間
あやせし	綾瀬市
あやしろ	綾城
あやぎぬ	綺	綾絹
あやぎく	綾菊
あやがみ	綾上
あやかみ	綾上
あやおり	綾織
あやうた	綾歌
あやいと	綾糸
あめんぼ	水馬	水黽
あめりか	亜米利加	亞米利加	米
あめよこ	アメ横
あめみや	雨宮
あめふり	雨ふり	雨降り
あめつゆ	雨露
あめつち	天地
あめだま	飴玉
あめかぜ	雨風
あめいろ	飴色
あみやき	網焼き	網焼
あみもの	編み物	編物
あみもと	網元
あみぼし	網干
あみぼう	編棒
あみばり	編針
あみはり	網張
あみはま	網浜
あみのめ	網の目
あみなか	網中
あみてん	網点
あみだな	網棚
あみしろ	網代
あみしま	網島
あみがさ	編笠
あみかけ	網掛	網かけ	網掛け
あみうち	網打ち
あまんざ	甘座
あまるめ	余目
あまるべ	余部	餘部
あまやど	雨宿
あまやか	甘やか
あまもり	雨漏り	雨漏	雨森
あまもよ	雨催
あまもと	天本
あまみや	天宮	雨宮
あまみそ	甘味噌
あまみず	雨水
あまのり	甘海苔
あまぬま	天沼
あまなつ	甘夏
あまどり	天鳥
あまどい	雨樋
あまとう	甘党
あまでら	尼寺
あまつぶ	雨粒
あまつじ	天辻
あまつさ	剰
あまっさ	剰
あまちゃ	甘茶
あまだれ	雨垂れ	雨だれ
あまだい	甘鯛
あまぞら	雨空
あまじお	甘塩
あまざけ	甘酒
あまごい	雨乞い
あまぐり	甘栗
あまぐも	雨雲
あまくぼ	天久保
あまくち	甘口
あまくだ	天下	天降
あまくさ	天草
あまぎご	天城越
あまがみ	甘噛み
あまがせ	天ケ瀬	天瀬
あまがさ	雨傘	雨がさ	雨ガサ
あまがけ	天翔
あまがき	甘柿
あまがい	雨海	天海
あまかわ	甘皮	天川
あまから	甘辛
あまかみ	甘噛み
あまかぜ	雨風
あまかす	甘粕
あまかけ	天翔
あまおと	雨音
あまえび	甘海老	甘エビ	甘えび
あまいろ	亜麻色
あまいた	天板
あまいけ	天池	雨池
あまあし	雨足
あべのく	阿倍野区
あべかわ	安倍川
あぶりだ	炙り出
あぶらや	油屋
あぶらみ	油身	脂身
あぶらひ	油日
あぶらな	油菜	薹
あぶらだ	油田
あぶらじ	油染
あぶらげ	油揚
あぶらえ	油絵
あぶらあ	油揚
あぶはち	虻蜂
あぶなえ	危絵
あぶくま	阿武隈
あふれで	溢れ出
あふれだ	溢れ出
あふりか	阿弗利加
あびせか	浴びせ掛
あびこし	我孫子市
あひかけ	足腰
あばずれ	阿婆擦れ
あばしり	網走
あばきた	暴き立
あはなち	畔放ち	畔放
あのころ	あの頃
あねたい	姉帯
あねじゃ	姉者
あねざき	姉崎
あねさま	姉様
あねさき	姉崎
あねぎみ	姉君
あねがわ	姉川
あねうえ	姉上
あによめ	嫂	兄嫁
あにめか	アニメ化
あにでし	兄弟子
あにじゃ	兄者
あにぎみ	兄君
あにうえ	兄上
あなやま	穴山
あなみず	穴水
あなほり	穴掘り
あなぶき	穴吹
あなねら	穴狙
あなとう	穴党
あなぐら	穴蔵	窖
あなぐま	穴熊
あながわ	穴川
あながち	強ち
あなうめ	穴埋め
あなうま	穴馬
あどがわ	安曇川
あとやく	後厄
あともど	後戻
あとみや	後宮
あとまわ	後回
あとばら	後払
あとはん	後版
あとのり	後ノリ	後乗り
あととり	跡取り
あとづけ	後付け	後付
あとつぎ	跡継ぎ
あとぢえ	後知恵
あとぞめ	後染め
あとずさ	後退
あとすこ	後少
あとざん	後産
あとさく	後作
あとさき	後先
あとくち	後口
あとくさ	後腐
あときん	後金
あとがま	後釜
あとがき	後書	後書き
あとかわ	後川
あとかた	跡かた	跡形
あとおし	後押し
あとおい	後追い	後追
あとうだ	阿刀田
あとあと	後々
あとあじ	後味
あとあし	後足	後脚
あでやか	艶やか
あてもの	当て物
あてはま	当て嵌
あてはつ	宛発
あてにげ	当て逃げ
あてなが	宛て名書
あてつけ	当て付け
あてさき	宛先	宛て先
あてこと	当て事
あてこす	当て擦
あてうま	当て馬
あづまや	東谷
あつろう	篤郎	淳良
あつれき	軋轢
あつらえ	誂え
あつよう	厚様
あつゆき	篤幸	敦之	淳之
あつやき	厚焼き	厚焼
あつもり	敦盛
あつもの	羹
あつまり	集り	集まり
あつべつ	厚別
あつひろ	敦弘	淳裕	厚宏
あつひと	厚人
あつひこ	淳彦	篤彦	敦彦
あつのぶ	篤信
あつぬり	厚塗り	厚塗
あつでん	圧電
あつつぐ	淳嗣
あつたか	篤孝
あつしば	厚芝
あつけし	厚岸
あつぐる	暑苦
あつくる	暑苦
あつぎり	厚切り
あつぎし	厚木市
あつがみ	厚紙
あつがま	厚釜
あつかん	熱燗
あつかい	扱い
あつえん	圧延
あついた	圧板
あつあつ	熱々
あつあげ	厚揚げ
あっぷく	圧服
あっぱれ	天晴れ	天晴	遖
あっぱく	圧迫
あっぱい	圧排
あっとこ	厚床
あっとう	圧到	圧倒
あってん	圧点
あっつう	圧痛
あっそう	圧送
あっせん	斡旋
あっせつ	圧雪	圧接
あっせい	圧政	圧制
あっさぶ	厚沢部
あっさつ	圧殺
あっさく	圧搾
あっさい	圧砕
あっこう	悪口
あっけな	呆気な
あっけし	厚岸
あっけい	悪計
あっかん	悪漢	圧巻
あっかく	圧覚
あっかい	圧潰
あだゆめ	徒夢
あだばな	徒花
あだちく	足立区
あだたら	安達太良
あだしの	化野
あだごと	徒事
あだうち	仇討ち	仇討
あたりち	当り散	当たり散
あたらし	新子	新し
あたまわ	頭割
あたまだ	頭出
あたまが	頭書
あたまう	頭打
あたたか	暖
あたくし	私
あたがわ	熱川
あたかも	恰も	宛も	宛
あそびめ	遊び女	遊女
あそびべ	遊部
あそびば	遊び場
あそびて	遊び手
あそびす	遊び過
あそびげ	遊び毛
あそびあ	遊び明
あそさん	阿蘇山
あそうぎ	阿僧祇
あぜみち	畦道
あぜぬり	畦塗り
あぜくら	校倉
あせみず	汗水
あせふき	汗拭き
あせにぎ	汗握
あせとり	汗取り
あせくさ	汗臭
あせかき	汗掻き
あずみの	安曇野
あずまや	東屋	阿亭	四阿
あずけい	預け入
あすなろ	翌檜
あすかじ	飛鳥路
あすかい	飛鳥井
あじゃり	阿闍梨
あじゃら	戯
あじとみ	安次富
あじつけ	味付	味付け
あじちが	味違
あじさか	鯵坂
あじさい	紫陽花
あじけな	味気無
あじきな	味気無
あじがわ	安治川
あじから	味方
あじおか	味岡
あじおう	味皇
あしわら	葦原
あしわだ	足和田
あしわざ	足技
あしよわ	足弱
あしょろ	足寄
あしゆび	足指	趾
あしゅら	阿修羅
あしやす	芦安
あしやし	芦屋市
あしもり	足守
あしもの	脚物
あしもと	脚元	足許	足元	足下
あしまわ	足回
あしまえ	足前
あしべつ	芦別
あしぶみ	足踏み	足踏
あしぶえ	葦笛
あしふき	足拭き
あしばら	足払
あしばや	足早
あしはら	蘆原	芦原
あしなみ	足並	足並み
あしなが	足長
あしなえ	跛	蹇
あしどり	足取り	足鳥
あしどめ	足止	足留め	足止め
あしとり	足取り
あしづけ	足付
あしつぎ	足継ぎ
あしつき	足付
あしだい	足代
あしたば	明日葉	鹹草
あしたか	愛鷹
あしそこ	足底
あしずり	足摺
あししげ	足繁
あしざわ	芦澤	芦沢
あしさき	足先
あしこし	足腰	脚腰
あしくび	足首
あしくせ	足癖
あしきり	足切り
あしきた	芦北	葦北
あしがわ	芦川
あしがる	足軽
あしがら	足搦	足柄
あしがた	足固	足形	足型
あしがか	足掛
あしかわ	芦川
あしかり	芦刈
あしかせ	足枷	鐐	桎
あしかけ	足掛	足掛け
あしかが	足利
あしおり	足折
あしおと	脚音	足音	跫
あしうら	足裏
あしいろ	足色
あしあと	足跡
あざわら	嘲笑
あざらし	海豹
あざやか	鮮やか	鮮か
あされん	朝練
あさゆう	朝夕
あさやま	浅山	朝山
あさやけ	朝焼け
あさもや	朝靄
あさめし	朝メシ	朝飯
あさむし	浅虫
あさみや	麻宮	朝宮
あさみぞ	麻溝
あさまつ	朝松
あさぶろ	朝風呂
あさぶき	麻吹
あさふく	浅福
あさびん	朝便
あさひる	朝昼
あさひや	旭屋
あさひな	朝比奈	朝日奈
あさひく	旭区
あさばん	朝晩
あさはら	浅原	麻原
あさはや	朝早
あさはか	浅はか
あさのみ	麻の実
あさのぶ	朝信
あさのは	麻の葉
あさぬま	浅沼
あさぬの	麻布
あさなわ	麻縄
あさなべ	浅鍋
あさなぎ	朝凪
あさどら	朝ドラ
あさてい	朝定
あさづま	朝妻
あさづけ	浅漬
あさつゆ	朝露
あさつき	浅葱
あさって	明後日
あさぢえ	浅知恵
あさだち	朝立ち
あさせん	阿佐線
あさじえ	浅知恵
あさしろ	麻城
あさしも	朝霜
あさしな	浅科
あさしお	朝潮
あさざけ	朝酒
あさぐろ	浅黒
あさくら	麻倉	朝倉	浅倉
あさくち	浅口
あさくさ	浅草
あさぎり	朝霧
あさぎぬ	麻衣
あさきた	安佐北
あさがや	阿佐谷	阿佐ヶ谷
あさがみ	麻上
あさがた	朝型	朝方
あさがけ	朝駆
あさがお	蕣	朝顔
あさがえ	朝帰
あさかわ	朝川	浅川
あさかぜ	朝風
あさかげ	朝影
あさおき	朝起き
あさおか	浅丘	朝丘	麻丘	朝岡
あさえだ	朝枝	浅枝
あさいと	麻糸	麻絲
あさいち	朝一	朝市
あごわん	英虞湾
あごひも	顎紐
あごひげ	鬚	顎鬚
あこがれ	憧れ	憬れ
あげもの	揚げ物
あげまつ	上松
あげまき	総角
あげぶた	上げ蓋
あげばり	幄
あげはま	揚浜
あげはば	上げ幅
あげなべ	揚げ鍋
あげだま	揚げ玉
あげだし	揚出し	揚げ出し
あげだい	揚代
あげぞこ	上げ底
あげぜん	上げ膳
あげしお	上げ潮	上潮
あげさげ	上げ下げ
あげかじ	上げ舵
あげおし	上尾市
あげあし	上足	挙げ足	挙足	上げ足	揚げ足	揚足
あけわた	明渡	明け渡
あけぼの	曙
あけびか	Lardizabalaceae	アケビ科
あけひろ	明け広	開け広
あけはま	明浜
あけはな	開け放
あけたて	開け閉て
あけしめ	開け閉め
あけくれ	明け暮れ
あけがた	明け方
あくれい	悪例
あくらつ	悪辣
あくよう	悪用
あくゆう	阿久悠	悪友
あくやく	悪役
あくもん	悪問
あくめい	悪名
あくまで	飽く迄
あくほう	悪法	悪報
あくへん	悪変
あくへき	悪癖
あくへい	悪弊
あくぶん	悪文
あくふう	悪風
あくひつ	悪筆
あくねん	悪念
あくぬき	灰汁抜き
あくにん	悪人
あくにち	悪日
あくなき	飽くなき
あくどう	悪童	悪道
あくとく	悪徳
あくとう	悪投	悪党
あくてん	悪天
あくだま	悪玉
あくたれ	悪たれ
あくたい	悪態
あくそう	悪僧	悪相
あくぜい	悪税
あくせん	悪戦	悪銭
あくせく	齷齪
あくせい	悪性	悪声	悪政
あくじょ	悪女
あくじき	悪食
あくしん	悪心
あくしょ	悪所	悪書
あくしゅ	悪趣	握手	悪手
あくしゃ	幄舎
あくしつ	悪疾	悪質
あくさく	齷齪
あくさい	悪妻	悪才
あくごう	悪業
あくえん	悪縁
あくえき	悪疫
あくうん	悪運
あくいん	悪因
あぎょう	ア行	あ行
あきんど	商人
あきれは	呆れ果
あきらめ	諦め
あきらか	曠	明らか	明か	昿
あきよし	明良	彰芳	明吉	昭義	秋吉	昭良
あきゆき	昭如
あきゅう	秋保
あきやま	秋山
あきやす	彰康	秋休
あきもの	秋物
あきもと	秋元	秋本
あきむら	秋村
あきみつ	彬光	章充
あきみち	明倫
あきみず	秋水
あきまる	秋丸
あきまで	秋迄
あきべや	空部屋	空き部屋
あきふゆ	秋冬
あきふみ	章文	明文	晶文
あきふく	秋服
あきびん	空瓶
あきひろ	暁宏	明広	明裕	明弘	晃広	章裕	明浩	章宏	彰広	昭宏	明大	章広	昭博	章博	晃宏	章弘	哲裕	昭弘	明宏	彰宏	晃弘	碩宏	章浩	昭浩
あきひと	昭仁	祥仁	明仁
あきひで	彰英
あきひさ	顕尚	彰久
あきひこ	秋彦	明彦	昭彦	祥彦	彰彦	晶彦	暁彦
あきばれ	秋晴れ	秋晴
あきばこ	空箱
あきのり	昭則	昭徳	昭憲	晧則	明徳	彰則	明紀	明憲	晃紀
あきなる	秋成
あきなり	章成	秋成
あきなす	秋茄子
あきなぎ	秋奈祇
あきなが	秋永
あきない	商い
あきとも	秋友
あきとし	明敏	秋利	晃年	彰俊
あきづき	秋月
あきつぐ	明二
あきだい	秋大
あきたに	秋谷
あきたし	秋田市
あきぞら	秋空
あきせき	空き席
あきすえ	秋末
あきしま	安芸島	昭島
あきしの	秋篠
あきさわ	秋澤
あきさめ	秋雨
あきさと	穐里
あきごろ	秋頃
あきごう	秋号
あきぐん	安芸郡
あきぐち	秋口
あきがわ	秋川
あきがせ	秋ケ瀬
あきかん	空缶	空き罐	空き缶
あきかわ	秋川
あきかぜ	秋風
あきかず	彰一
あきおみ	明臣
あきおか	秋岡
あきうみ	明生
あきあじ	秋味
あきあき	飽き飽き	厭き厭き
あがりゆ	上がり湯
あがりば	上がり場
あがりた	揚田
あがりこ	上がり込
あがない	贖	贖い
あがつま	我妻	吾妻
あがおか	阿賀岡
あかんこ	阿寒湖
あかるみ	明るみ
あかゆき	赤雪
あかもん	赤門
あかむし	赤虫
あかみそ	赤みそ	赤味噌
あかみず	赤水	閼伽水
あかまる	赤丸
あかまど	赤窓
あかまつ	赤松
あかぼり	赤堀
あかぼし	赤星
あかぼう	赤帽
あかほん	赤本
あかほり	赤堀
あかふだ	赤札
あかふじ	赤富士
あかふく	赤福
あかびら	赤平
あかひら	赤平
あかひと	赤人
あかひげ	赤髭
あかばん	赤盤
あかばね	赤羽根	赤羽
あかばな	赤花
あかばこ	赤箱
あかはら	赤腹
あかはね	赤羽
あかはに	赤埴
あかはな	赤鼻
あかはだ	赤膚	赤肌
あかはた	赤旗	旃
あかはじ	赤恥
あかねか	アカネ科	Rubiaceae
あかぬま	赤沼
あかぬけ	垢抜け
あかどう	赤胴
あかとき	暁
あかでん	赤電
あかてん	赤点
あかつち	赤土	赭
あかつき	垢付き	曉	閼伽坏	暁
あかつか	赤塚
あかちん	赤チン
あかちゃ	赤茶
あかだま	赤玉
あかだな	閼伽棚
あかだし	赤出し
あかたん	赤丹	赤短
あかせん	赤線
あかすり	垢擦り
あかじそ	赤紫蘇
あかじく	赤字区
あかしろ	赤白
あかしや	明石家
あかしま	暴
あかしば	赤芝
あかしな	明科
あかしし	明石市
あかしお	赤潮
あかざん	赤残
あかざわ	赤沢	赤澤
あかざき	赤崎
あかざか	アカザ科
あかさき	赤碕	赤崎
あかさか	赤坂
あかげら	赤啄木鳥
あかぐろ	赤黒
あかぐみ	紅組
あかぐま	赤熊
あかくろ	赤黒
あかくら	赤倉
あかぎれ	皹	皸
あかがわ	赤川
あかがり	赤狩
あかがみ	赤紙
あかがね	銅
あかがい	赤貝
あかかげ	赤影
あかおに	赤鬼
あかおか	赤岡
あかえだ	赤枝
あかいわ	赤磐	赤岩
あかいろ	赤色
あかいし	赤石
あかいけ	赤池
あかあか	明々	赤々
あかあお	赤青
あおりた	煽り立
あおやま	青山
あおやぎ	青柳
あおやき	青焼き	青焼
あおもん	青門
あおもり	青森
あおもの	青物
あおもと	青本
あおむし	青虫
あおむけ	仰向け
あおむぎ	青麦
あおまめ	青豆
あおほん	青本
あおひげ	青髯
あおばん	青盤	青版
あおばく	青葉区
あおはた	青旗
あおのり	青海苔
あおねこ	青猫
あおねぎ	青ネギ	青葱
あおぬま	青沼
あおにび	青鈍
あおなし	青梨
あおちゃ	青茶
あおだま	青玉
あおだち	青立ち
あおだけ	青竹
あおたん	青短	青丹	青痰
あおたけ	青竹
あおたが	青田買
あおぞら	蒼空	青空
あおせん	青線
あおすじ	青筋
あおじろ	青白	蒼白
あおじる	青汁
あおじそ	青紫蘇	青ジソ
あおしま	青嶋	青島
あおしか	青鹿
あおくび	青首
あおくさ	青草	青臭
あおぎり	青桐	榮
あおぎみ	仰ぎ見
あおきこ	青木湖
あおがり	青刈り
あおがく	青山学院大学	青学
あおがき	青垣
あおかん	青かん	青姦
あおかび	青黴
あおかち	青褐
あおおに	青鬼
あおいろ	青色
あおいめ	青い目
あおいし	青石
あおいけ	青池
あおあお	蒼々	蒼蒼	青青	青々
あえんか	亜鉛華
あえもの	和え物
あいれん	愛恋	愛憐	哀憐
あいりん	愛輪
あいらく	哀楽
あいよし	相吉
あいよく	愛欲
あいよう	愛用
あいやま	相山
あいやど	相宿
あいやく	相役
あいもと	相本
あいもち	相持ち
あいまい	曖昧
あいぼし	相星
あいぼう	相棒
あいべや	相部屋
あいべつ	愛別	哀別
あいふだ	合札
あいふく	間服	合服
あいびき	逢引	合挽き	合挽
あいひと	相等
あいばら	相原	合原
あいはん	相判	相反	合判
あいはら	粟飯原	相原	合原	藍原	愛原
あいのり	相乗り
あいのて	合の手
あいのす	愛の巣
あいのこ	間の子
あいぬご	アイヌ語
あいにく	生憎
あいなめ	鮎魚女
あいどく	愛読
あいとう	哀悼
あいてど	相手取
あいづま	逢妻
あいづち	相槌	相づち
あいづき	相築
あいつら	相連
あいつと	相勤
あいつぎ	相次
あいつう	相通
あいだい	愛大
あいたい	相対
あいぞう	愛憎	愛蔵
あいそん	愛孫
あいそづ	愛想尽
あいそく	愛息
あいそう	愛想
あいぜん	愛染
あいぜつ	哀絶
あいせつ	哀切
あいせき	哀惜	相席	愛惜
あいずみ	藍住
あいじん	愛人
あいしょ	愛書
あいしゃ	愛車
あいしあ	愛し合
あいざわ	相沢	相澤	会沢
あいさわ	相沢
あいさつ	挨拶
あいさい	愛妻
あいごま	合駒	合い駒
あいこと	相異
あいこく	哀哭	愛国
あいこう	愛校	愛甲	愛好
あいけん	愛犬
あいけい	愛敬
あいくち	合口	合い口	匕首
あいぎん	愛吟
あいがん	哀願	愛玩
あいがも	合鴨
あいがみ	藍紙	間紙
あいかん	哀歓	哀感
あいかわ	相川	相変	合川	愛川	鮎川
あいかた	合方	相方
あいかぎ	合鍵
あいおい	相生
あいえん	愛煙
あいえき	愛液
あいうら	相浦
あいうち	相討ち	相打ち
あいいん	合印	愛飲
あいいろ	藍色
あいいそ	相磯
あいいく	愛育
あーとし	アート紙
あーくろ	アーク炉
おんりょう	怨霊	音量	温良
おんりえど	厭離穢土
おんようじ	陰陽師
おんようけ	陰陽家
おんやさい	温野菜
おんみょう	陰陽
おんみつり	隠密裡	隠密裏
おんぴょう	音表
おんひょう	音標
おんなやく	女役
おんなもの	女物
おんなもじ	女文字
おんなへん	女偏
おんなばん	女版
おんなばら	女腹
おんなのこ	女の子	女のコ
おんなっけ	女っ気
おんなたら	女誑
おんなたち	女達
おんなずき	女好き
おんなざか	女盛	女坂
おんなくさ	女臭
おんなぎら	女嫌
おんなぎみ	女君
おんながわ	女側
おんながた	女形
おんどてん	温度点
おんどけい	温度計
おんでこざ	鬼太鼓座
おんちょう	恩寵	温調	音長	音調
おんちゅう	御中
おんちけん	音知研
おんだんき	温暖期
おんだんか	温暖化
おんぞうし	御曹子	御曹司
おんそろん	音素論
おんそれつ	音素列
おんそもじ	音素文字
おんそめい	音素名
おんそてき	音素的
おんそぐん	音素群
おんせんち	温泉地
おんせいぶ	音声部
おんせいは	音声波
おんせいか	音声化
おんすいき	温水機
おんじょう	恩情	音情	音声	温情	音場
おんじゅん	音順	温順
おんじゅつ	恩恤
おんじゅく	御宿
おんしらず	恩知らず
おんしょく	温色	音色
おんしょう	恩賞	温床	恩奨	恩詔
おんしゅう	温州	恩讎	恩讐
おんしゃく	恩借
おんしつど	温湿度
おんしつさ	音質差
おんしっぷ	温湿布
おんげんぶ	音源部
おんけんは	穏健派
おんぎょく	音曲
おんぎょう	隠形
おんきょう	音強	音響
おんきゅう	恩給
おんきごう	音記号
おんがっか	音学家
おんがぐん	遠賀郡
おんがくや	音楽屋
おんがくぶ	音楽部
おんがくは	音楽派
おんがくし	音楽史
おんがくか	音楽科	音楽家	音楽化
おんがえし	恩返し
おんあつひ	音圧比
おんあつち	音圧値
おんあつさ	音圧差
おわりごろ	終頃
おろしまち	卸町
おろしがね	下ろし金
おろしうり	卸売	卸売り
おろかもの	愚か者
おろおぼえ	疎覚え
おれいもう	御礼申
おれいきん	お礼金
おれいきじ	御礼記事
おりょうり	お料理
おりめただ	折り目正
おりべやき	織部焼
おりどしき	折戸式
おりちょう	折丁
おりごとう	オリゴ糖
おりかえし	折り返し
おりおんざ	オリオン座
おりおえき	折尾駅
おりあしく	折悪しく
おりーぶゆ	オリーブ油
おらんだご	オランダ語
およろこび	お喜び	お慶び
およめさん	お嫁さん
およびごし	及び腰
おやゆずり	親譲り
おやむすめ	親娘
おやまかん	小山間
おやまえき	小山駅
おやふこう	親不孝
おやじしん	親自身
おやしらず	親不知
おやごころ	親心
おやこなべ	親子鍋
おやこどん	親子丼
おやこづれ	親子連れ
おやこたか	親子鷹
おやこかん	親子間
おやくそく	お約束	御約束
おやきょく	親局
おやがわり	親代り
おやがかり	親掛り
おもんぱか	慮
おもんばか	慮
おもわせぶ	思わせ振
おもわすれ	面忘れ
おもむろに	徐に
おものがわ	雄物川
おもてやま	表山
おもてもん	表門
おもてめい	表銘
おもてむき	表向	表向き
おもてぶた	表蓋
おもてどお	表通
おもてざた	表ざた	表沙汰
おもてさく	表作
おもてごう	表郷
おもてけい	表罫
おもてぐみ	表組
おもてぐち	表口
おもてがわ	表側
おもてがき	表書き
おもてがえ	表替え
おもてかた	表方
おもてうら	表裏
おもてあみ	表編み
おもしろみ	面白味	面白み
おもしろさ	面白さ
おもしろい	面白い
おもがわり	面変り
おもうつぼ	思う壷
おもいやり	思いやり
おもいもの	思い者
おもいめぐ	思い巡
おもいみだ	思い乱
おもいのこ	思い残
おもいなや	思い悩
おもいなし	思い做し
おもいなお	思い直
おもいどお	思い通
おもいとど	思い止
おもいつづ	思い続
おもいつき	思い付き
おもいちが	思い違
おもいすご	思い過
おもいこみ	思い込み
おもいきり	思い切り
おもいきや	思いきや
おもいがわ	思川
おもいかえ	思い返
おもいおも	思い思
おもいえが	思い描
おもいいれ	思い入れ
おもいいた	思い至
おもいあま	思い余
おめがもう	オメガ網
おめいこう	御命講
おみわたり	御神渡り
おみまいひ	お見舞い費
おみぬぐい	御身拭い
おみなえし	女郎花
おみとおし	御見通し	お見通し
おみつもり	御見積
おみおつけ	御御御付け
おみおくり	お見送り
おまちがい	お間違い
おまごさん	お孫さん
おまえたち	御前達
おまえざき	御前崎
おぼろづき	朧月
おぼろぐも	朧雲
おぼつかな	覚束無
おぼえなお	覚え直
おぼえがき	覚え書き	覚書
おぼうさん	お坊さん
おほしさま	お星様
おべんとう	お弁当
おぶちざわ	小淵沢
おふでさき	御筆先
おふたかた	御二方
おびじょう	帯状
おびきおく	帯記憶
おひるまえ	お昼前
おひるどき	お昼時
おひるころ	お昼頃
おひゃくど	御百度
おひめさま	お姫様
おひなさま	御雛様
おひとよし	御人好し
おひつじざ	牡羊座
おひざもと	お膝元
おひきたて	お引き立て
おひきうけ	お引受け
おばません	小浜線
おばなざわ	尾花沢
おばたやま	小畑山
おばあさん	お婆さん
おのだせん	小野田線
おのそっき	小野測器
おのずから	自ずから	自ら
おのがわこ	小野川湖
おねえさん	お姉さん
おねえさま	お姉様	お姉さま
おにわばん	御庭番
おにひとで	鬼海星
おにたいじ	鬼退治
おにごっこ	鬼ごっこ
おにこうべ	鬼首
おにけいじ	鬼刑事
おにぐるま	鬼車
おにがわら	鬼瓦
おにがしま	鬼ヶ島
おにいさん	お兄さん
おなれそめ	御馴染
おなりもん	御成門
おながどり	尾長鶏
おながざる	尾長猿
おないどし	同い歳	同い年
おどろきい	驚き入
おどりくる	踊り狂
おとわやま	音羽山
おとりひき	お取り引き
おともだち	お友達
おとめたい	乙女隊
おとなよう	大人用
おとなたち	大人達
おとなしく	大人しく
おとどまち	大殿町
おとそしき	音組織
おとじろう	音二郎
おとじたい	音自体
おとしより	お年寄り
おとしもの	落し物	落とし物
おとしまえ	落し前	落とし前
おとしぶみ	落とし文	落書	落し文
おとしぶた	落し蓋	落とし蓋
おとしぬし	落とし主	落し主
おとしだま	お年玉	おとし玉
おとしだね	落し胤
おとしげき	音刺激
おとしかた	落し方
おとしあな	落し穴	落とし穴
おとこやま	男山
おとこやく	男役
おとこもの	男物
おとこもじ	男文字
おとこみち	男道
おとこまえ	男前
おとこのこ	男の子	男のコ
おとこなき	男泣き
おとこだて	男伊達
おとこたち	男達
おとこざか	男盛	男坂
おとこぐみ	男組
おとこくさ	男臭
おとこぎみ	男君
おとこがわ	男側
おとこがみ	男神
おとうさん	お父さん
おとうさま	御父様
おとあわせ	音合わせ	音合せ
おてのもの	お手の物	御手の物
おてつだい	お手伝い
おてあらい	御手洗	お手洗
おつきさま	お月様
おつきあい	お付き合い
おっとせい	膃肭臍
おってがき	追而書
おちゃのま	お茶の間	御茶乃間
おちゃづけ	お茶漬	お茶漬け
おちゃだい	お茶大	お茶代
おちゃしつ	お茶室
おちゃがし	お茶菓子
おちゃかい	お茶会
おちゃうけ	御茶請け
おちむしゃ	落武者	落ち武者
おちばたき	落葉焚き
おちばいろ	落葉色
おちこぼれ	落ちこぼれ	落ち零れ
おだきゅう	小田原急行電鉄	小田急
おだいもく	御題目
おだいとう	尾岱沼
おたるえき	小樽駅
おたのしみ	お楽しみ
おたちだい	お立ち台	御立ち台
おぞんそう	オゾン層
おそれざん	恐山
おそるべし	恐るべし
おそるべき	恐るべき
おそらくは	恐らくは
おそくとも	遅くとも
おそうまれ	遅生れ
おそうしき	お葬式	御葬式
おそあがり	遅上がり
おぜんだて	御膳立て	お膳立て
おせわさま	御世話様
おせっかい	御節介	お節介
おすみつき	お墨付き	御墨付
おすみうむ	Os	Osmian
おすとめす	雄と雌
おすそわけ	お裾分け	御裾分け
おすいもの	お吸い物
おじょうず	御上手
おじゅけん	お受験
おじぎそう	含羞草	御辞儀草
おじかせん	男鹿線
おじいさん	お爺さん
おしょくじ	御食事	お食事
おしゃらく	御洒落
おしゃべり	お喋り
おしまずき	几
おしぼたん	押しボタン
おしはらい	お支払い
おしのむら	忍野村
おしなべて	押し並べて
おしたおし	押し倒し
おしかせん	男鹿線
おしえかた	教え方
おしあわせ	お幸せ
おさわがせ	お騒がせ
おさめこみ	納込
おさなづま	幼妻
おさながお	幼顔
おさだみほ	長田美穂
おさくひん	御作品
おさえこみ	抑え込み
おさえかた	押え方
おごおりし	小郡市
おこりかた	怒り方
おこりいし	瘧石
おことわり	お断り
おことてん	乎古止点
おこがまし	烏滸がまし
おこうでん	御香典
おけはざま	桶狭間
おけしょう	お化粧
おけがわし	桶川市
おぐらやま	小倉山
おぐらけい	小椋佳
おぐらあん	小倉餡
おぐにまち	小国町
おくればせ	遅れ馳せ	遅馳
おくりもの	饋	賻	贈り物	贈物
おくりもと	送り元
おくりむか	送り迎
おくりぬし	贈り主	送り主	送主
おくりなお	送り直
おくりとど	送り届
おくりだし	送り出し
おくりたお	送り倒
おくりさき	送り先	贈り先
おくりがな	送り仮名
おくりかな	送り仮名
おくりかえ	送り返
おくらいり	お蔵入り
おくみかわ	奥三河
おくぼいん	奥母音
おくびょう	臆病
おくちょう	億兆
おくだいら	奥平
おくたんい	億単位
おくただみ	奥只見
おくじょう	屋上
おくしょん	億ション
おくざしき	奥座敷
おくさがみ	奥相模
おくいぶき	奥伊吹
おくいずも	奥出雲
おぎのしき	荻野式
おぎにしき	小城錦
おきわたし	沖渡し
おきみやげ	置土産	置き土産
おきまゆみ	沖まゆみ
おきばしょ	置き場所	置場所
おきのしま	沖ノ島	隠岐島
おきにいり	お気に入り
おきなわし	沖縄市
おきなわご	沖縄語
おきなかし	沖仲士
おきなあめ	翁飴
おきどころ	置き所
おきどけい	置き時計	置時計
おきでんき	沖電気
おきてやぶ	掟破
おきてがみ	置き手紙	置手紙
おきさわら	沖鰆
おきごたつ	置き炬燵
おきぐすり	置き薬
おがわまち	小川町
おがわえき	緒川駅
おがみたお	拝み倒
おがたけん	緒形拳
おがさわら	小笠原
おがさはら	小笠原
おかんがえ	お考え
おかやまし	岡山市
おかひじき	陸鹿尾菜
おかばやし	岡林
おかばしょ	岡場所
おかねもち	お金持ち
おかっぴき	岡っ引き
おかちまち	御徒町
おかだせん	岡多線
おかざきし	岡崎市
おかげさま	御蔭様	お蔭様
おかいもの	お買い物
おかいどく	お買い得
おかいあげ	お買上
おかあさん	お母さん
おかあさま	お母さま	御母様	お母様
おおわらわ	大童
おおわらい	大笑い
おおよわり	大弱り
おおよろこ	大喜
おおやまだ	大山田
おおやけど	大火傷
おおもりく	大森区
おおもじか	大文字化
おおめつけ	大目付
おおめだま	大目玉
おおむらじ	大連
おおむこう	大向う
おおむかし	大昔
おおみやし	大宮市
おおみなと	大湊
おおみだし	大見出し
おおみそか	大晦日
おおみしま	大三島
おおまわり	大回り
おおまぬけ	大間抜
おおまちが	大間違
おおまじめ	大真面目
おおまがり	大曲
おおぶくろ	大袋
おおぶえき	大府駅
おおふなと	大船渡
おおひろま	大広間
おおばやし	大林
おおばたけ	大畠
おおばくち	大博打
おおはらの	大原野
おおはやり	大流行
おおはずれ	大外れ	大ハズレ
おおはざま	大間
おおのけん	大野研
おおのくに	大乃国
おおねじめ	大根占
おおにもつ	大荷物
おおなんじ	大汝
おおどまり	大泊
おおどしま	大年増
おおどころ	大所
おおどけい	大時計
おおどおり	大通り	大通
おおどうぐ	大道具
おおとりい	大鳥居
おおとかげ	大蜥蜴
おおてもん	大手門
おおてまち	大手町
おおてすじ	大手筋
おおづかみ	大掴み
おおつやま	大津山
おおつなみ	大津波
おおつせん	大津線
おおちがい	大違い
おおだんな	大旦那
おおだいこ	大太鼓
おおたわら	大田原
おおたぐろ	太田黒
おおたがわ	太田川
おおそうじ	大掃除
おおせざき	大瀬崎
おおずもう	大相撲
おおじぬし	大地主
おおじだい	大時代
おおじしん	大地震
おおしみず	大清水
おおしごと	大仕事
おおざはた	大座畑
おおざっぱ	大雑把
おおさわの	大沢野
おおさわぎ	大騒ぎ
おおさかふ	大阪府
おおさかし	大阪市
おおごしょ	大御所
おおこうち	大河内
おおげんか	大喧嘩
おおぐまざ	大熊座
おおくまざ	大熊座
おおくびえ	大首絵
おおくずれ	大崩れ
おおぎょう	大仰
おおぎまち	扇町
おおぎばし	扇橋
おおぎたに	扇谷
おおぎがた	扇型
おおがわら	大河原
おおがらす	大鴉
おおがたば	大型馬
おおがたき	大型機
おおがたか	大型化
おおがえし	大返し
おおかんだ	大神田
おおかわら	大河原
おおかみざ	狼座
おおかがみ	大鏡
おおおとこ	大男
おおえやま	大江山
おおえのき	大榎
おおうりだ	大売出
おおうつし	大写し
おおいまち	大井町
おおいぬざ	大犬座
おおいなる	大いなる
おおいたし	大分市
おおいそぎ	大急ぎ
おおいそが	大忙
おおいずみ	大泉
おおいしだ	大石田
おおいがわ	大井川
おおいかく	覆い隠
おおあわて	大慌て
おおあらい	大洗
おおあばれ	大暴れ
おおあたり	大当たり	大当り
おおあかじ	大赤字
おえらがた	お偉方
おうれつか	横裂果
おうりょく	応力
おうりょう	横領
おうりゅう	横流
おうようか	応用可
おうめせん	青梅線
おうめえき	青梅駅
おうむがい	鸚鵡貝
おうぼよう	応募用
おうぼばこ	応募箱
おうぼすう	応募数
おうぼしゃ	応募者
おうぼけん	応募券
おうぼくだ	応募下
おうべいば	欧米馬
おうぶんし	欧文誌
おうびりん	桜美林
おうばんが	凹版画
おうどいろ	黄土色
おうとうや	応答野
おうとうき	桜桃忌
おうちょう	王朝
おうちゃく	横着
おうだんか	応談可
おうそうじ	大掃除
おうぜんじ	王禅寺
おうせつま	応接間
おうじょう	往生	王城	応情
おうじゅく	黄熟
おうじやま	皇子山
おうじせん	王子線
おうじさま	王子様
おうじえき	王子駅	王寺駅
おうしょく	黄色	応嘱
おうしょう	応召	王将
おうしゅう	歐州	欧洲	歐洲	奥州	欧州	押収	応酬
おうざせん	王座戦
おうごんひ	黄金比
おうごんき	黄金期
おうけとり	お受け取り
おうぎょく	黄玉
おうぎさわ	扇沢
おうぎがた	扇形
おうきゅう	王宮	応急
おうかがい	お伺い
おうえんぶ	応援部
おうえんか	応援歌
おううせん	奥羽線
おういんし	押韻詩
おういんご	欧印語
おういせん	王位戦
おいろなお	御色直
おいみどり	老緑
おいまわし	追廻
おいばらい	追い払い
おいしんぼ	美味しんぼ
おいしょう	追証
おいえげい	御家藝	お家芸	御家芸
おあらため	お改め
おあふとう	オアフ島
おーきゃく	O脚	Ｏ脚
えんりゃく	延暦
えんりえど	厭離穢土
えんむすび	縁結び
えんみらい	遠未来
えんまがお	閻魔顔
えんぽうば	遠方場
えんびふく	燕尾服
えんばんぶ	円盤部
えんのすけ	猿之助
えんのした	縁の下
えんにゅう	衍入
えんどおい	縁遠い
えんてんか	炎天下
えんつづき	縁続き
えんちょく	鉛直
えんちょう	延長	円頂	園長
えんちゅう	円柱
えんちゃく	延着
えんちてん	遠地点
えんたんい	円単位
えんそさん	塩素酸
えんそけい	塩素系
えんそくこ	堰塞湖
えんそうば	円相場
えんそうじ	演奏時
えんそうご	演奏後
えんそうか	演奏家
えんせんず	円線図
えんせいひ	遠征費
えんじょひ	援助費
えんじょう	炎上	円状	遠城
えんじゅつ	演述
えんじゅく	円熟
えんじゃく	燕雀
えんじたち	園児達
えんじいろ	臙脂色
えんしんか	延伸化
えんしょく	焔色	怨色
えんしょう	炎症	延焼	袁紹	艶笑	円生	煙硝	遠称
えんしゅつ	演出
えんしゅう	円周	遠州	演習
えんざんぶ	演算部
えんざんし	演算子
えんざんき	演算機	演算器
えんざんか	演算化
えんさんし	演算子
えんこけい	円弧形
えんげきぶ	演劇部
えんげいぶ	園芸部
えんげいか	園芸家
えんぐらふ	円グラフ
えんぎもの	縁起物
えんぎしょ	縁起書
えんぎしき	延喜式
えんぎかい	演技会
えんきょり	遠距離
えんきょく	婉曲
えんきょう	延慶	燕京	円鏡	延享
えんきゅう	円球
えんきどう	円軌道
えんきごう	円記号
えんがんぶ	沿岸部
えんかわせ	円為替
えんかぶつ	塩化物
えんかつか	円滑化
えんかけい	演歌系
えんかくち	遠隔地
えんかいや	宴会屋
えんえきぎ	演繹木
えるびうむ	Er	Erbium
えりまわり	襟回り
えりしょう	衿章	襟章
えりごのみ	選り好み	えり好み
えらびかた	選び方
えもんかけ	衣紋掛け
えまきもの	絵巻物
えべつえき	江別駅
えびふらい	海老フライ
えびすばし	戎橋
えびすがお	恵比寿顔
えびがため	海老固め
えひめだい	愛媛大
えひめけん	愛媛県
えぬじげん	Ｎ次元
えぬきょう	Ｎ響
えなざくら	恵那櫻
えどひがん	江戸彼岸
えどばくふ	江戸幕府
えどじょう	江戸城
えどじだい	江戸時代
えどがわく	江戸川区
えてんらく	越天楽
えてふえて	得手不得手
えてかって	得手勝手
えつたろう	悦太郎
えっとうち	越冬地
えっちゅう	越中
えっきょう	越境
えちごせん	越後線
えちごじし	越後獅子
えだわかれ	枝分かれ	枝わかれ
えだじょう	枝状
えそらごと	絵空事
えさかてん	江坂店
えこひいき	依怙贔屓
えきほんや	駅本屋
えきべんや	駅弁屋
えきふきん	駅付近
えきびょう	疫病
えきばしゃ	駅馬車
えきてきか	液滴化
えきちょう	益鳥	駅長
えきちゅう	益虫	液中
えきぜんぶ	駅全部
えきじょう	液状
えきじゅう	益獣	液汁
えきじたい	駅自体
えきしょう	液晶
えきしせつ	駅施設
えきげしゃ	駅下車
えきぎゅう	役牛
えききょう	易経
えきかがす	液化ガス
えいりょう	英領
えいりてき	営利的
えいりせい	営利性
えいようそ	栄養素
えいようし	栄養枝	栄養士
えいようき	栄養期
えいようか	栄養価
えいへいじ	永平寺
えいぶんし	英文誌
えいぶんか	英文科
えいたんご	英単語
えいたろう	英太郎	永太朗	栄太郎
えいぞうか	映像化
えいせいし	衛生士
えいすうじ	英数字
えいじろう	英辞郎	栄次郎
えいじよう	英字用
えいじょく	栄辱
えいじゅう	永住
えいじしじ	英字指示
えいしょく	栄職
えいしょう	永正	詠唱
えいしゅん	英俊
えいしゅつ	映出	詠出
えいしゅう	瀛州
えいしゃく	栄爵
えいしゃき	映写機
えいごよう	英語用
えいごやく	英語訳
えいごめん	英語面
えいごめい	英語名
えいごぶん	英語文
えいごふう	英語風
えいごばん	英語版
えいごてき	英語的
えいごだい	英語題
えいごじん	英語人
えいごげき	英語劇
えいごけん	英語圏
えいごきじ	英語記事
えいごがく	英語学
えいこもじ	英小文字
えいこくご	英国語
えいこくき	英国旗
えいこうき	曳航機
えいげんじ	永源寺
えいぎょう	営業
えいきょう	影響	永享
えいきゅう	永久
えいきごう	嬰記号
えいがらん	映画欄
えいがよう	映画用
えいがむら	映画村
えいがばん	映画版
えいがてき	映画的
えいがじん	映画人
えいがさい	映画祭
えいがかん	映画館
えいがかい	映画界
えいかいわ	英会話
うんりょう	雲量
うんりゅう	雲竜
うんようひ	運用費
うんようじ	運用時
うんまかせ	運任せ
うんぱんぐ	運搬具
うんぱんき	運搬機
うんどうや	運動野
うんどうひ	運動費
うんどうじ	運動時
うんどうぐ	運動具
うんどうか	運動家
うんてんび	運転日
うんてんじ	運転時
うんてんし	運転士
うんちょう	雲頂
うんだめし	運試し
うんそうや	運送屋
うんそうひ	運送費
うんじょう	雲上	運上
うんじゃく	雲雀
うんしゅう	雲州	温州	雲集
うんしだい	運次第
うんきゅう	運休
うんがかん	運河間
うんえいぶ	運営部
うんえいひ	運営費
うわのだい	上の台
うわのそら	上の空
うわてひね	上手捻
うわてなげ	上手投げ
うわづつみ	上包み
うわっぱり	上っ張り
うわっつら	上っ面
うわすべり	上滑り
うわさどお	噂通
うわぐすり	釉	釉薬	上薬
うわきもの	浮気者
うろこぐも	鱗雲
うろおぼえ	疎覚え	うろ覚え
うれしなき	嬉し泣き
うれしがな	嬉し悲
うるちまい	粳米
うるしやま	漆山
うるしまけ	漆負け
うるしばた	漆畑
うるしはら	漆原
うるさがた	うるさ型
うるうどし	閏年
うるうづき	閏月
うりわたし	売り渡し	売渡し
うりゅうの	瓜生野
うりもんく	売り文句
うりそうば	売相場
うりことば	売り言葉
うりぐすり	売り薬	売薬
うらわせん	浦和戦
うらわえき	浦和駅
うらやすし	浦安市
うらみぶし	怨み節	恨み節
うらみごと	怨み言	恨み言
うらぶたい	裏舞台
うらびでお	裏ビデオ
うらばんく	裏バンク
うらばなし	裏話
うらにほん	裏日本
うらないし	占い師
うらどおり	裏通り
うらせんけ	裏千家
うらじろど	裏白戸
うらきもん	裏鬼門
うらきばん	裏基盤
うらがめん	裏画面
うらがせん	浦賀線
うらがすみ	浦霞
うらがえし	裏返し
うらかすみ	浦霞
うらおもて	裏表
うよくてき	右翼的
うよくしゅ	右翼手
うもうふく	羽毛服
うめもどき	梅擬
うめびしお	梅醤
うめにしき	梅錦
うめつくし	埋め尽くし
うめだきた	梅田北
うめだがわ	梅田川
うめだえき	梅田駅
うめたてち	埋立地
うめこうじ	梅小路
うめきごえ	呻き声
うめがたに	梅ヶ谷
うめがしま	梅ヶ島
うめがおか	梅が丘
うめあわせ	埋め合わせ	埋め合せ
うみぼうず	海坊主
うみへびざ	海蛇座
うみびらき	海開き
うみのさち	海の幸
うみのおや	生みの親
うみのいえ	海の家
うみそだち	海育ち
うまれどし	生まれ年
うまれつき	生まれつき
うまれかわ	生れ変
うまれあわ	生まれ合
うまふざい	馬不在
うまばしら	馬柱
うまのほね	馬の骨
うまのすけ	右馬助
うまじるし	馬標
うまじたい	馬自体
うまじしん	馬自身
うまごやし	苜蓿
うべんかん	右弁官
うぷしろん	υ	Υ
うひょうえ	右兵衛
うばざくら	姥桜
うばぐるま	乳母車
うばいあい	奪い合い
うなりごえ	唸り声
うなずきあ	頷き合
うなじゅう	鰻重
うなぎめし	鰻飯
うでまくら	腕枕
うでどけい	腕時計
うでっぷし	腕っ節
うでだめし	腕試し
うでたてふ	腕立て伏
うでぞろい	腕揃い
うでずもう	腕相撲
うでじまん	腕自慢
うでくらべ	腕比べ
うでかざり	腕飾り
うつりごし	移り腰
うつりかわ	移り変
うつびょう	鬱病
うつのみや	宇都宮
うつじょう	鬱情
うつじゅう	鬱情
うつけもの	空け者	呆気者
うってかわ	打って変
うっちょう	鬱鬯
うっちゃり	打っ棄り
うちわもめ	内輪揉め
うちわたし	内渡し
うちわうけ	内輪受
うちやまだ	内山田
うちもうこ	内蒙古
うちむそう	内無双
うちまわり	内回り
うちぶくろ	内袋
うちふづめ	打歩詰め
うちひとり	内一人
うちばらい	内払い
うちのうら	内之浦
うちどころ	打ち所
うちっぱな	打ちっ放
うちちがい	打違い
うちだゆき	内田有紀
うちこわし	打ち毀し
うちきょう	打ち興
うちがたな	打ち刀	打刀
うちかんだ	内神田
うちいわい	内祝
うちあわせ	打ち合せ	打合せ	打ち合わせ
うだいべん	右大弁
うだいじん	右大臣
うたまくら	歌枕
うたのかみ	雅楽頭
うたつえき	宇多津駅
うたしない	歌志内
うたごころ	歌心
うたことば	歌詞
うたえもん	歌右衛門
うたいもの	謡い物	歌い物
うたいぼん	謡本
うたいはじ	歌い始
うたいつづ	歌い続
うたいがい	歌以外
うたいかた	歌い方
うたあわせ	歌合
うそっぱち	嘘っぱち
うせんけい	右線形
うせつしゃ	右折車
うずらいし	鶉石
うずゆそう	渦輸送
うずくまる	蹲	踞
うすわらい	薄笑い
うすらばか	薄ら馬鹿
うすらさむ	薄ら寒
うすようし	薄葉紙
うすもよう	薄模様
うすみどり	薄緑
うすびょう	護田鳥尾
うすはなだ	薄縹
うすづきよ	薄月夜
うすっぺら	薄っぺら
うすごおり	薄氷
うすぐもり	うす曇り	薄曇
うすぎたな	薄汚
うすきいろ	薄黄色
うすがたか	薄型化
うすいまち	碓井町
うすいえき	臼井駅
うすあきな	薄商
うじやまだ	宇治山田
うしんぼう	右心房
うしんしつ	右心室
うしろゆび	後ろ指
うしろむき	後向き	後ろ向き
うしろまえ	後ろ前
うしろだて	後ろ楯	後ろだて	後ろ盾	後立
うしろぐら	後ろ暗
うしろきず	後ろ疵
うしろがわ	後側
うしろがみ	後髪	後ろ髪
うしろかわ	後川
うしろかげ	後ろ影
うしろおし	後ろ押し
うしろあし	後ろ足
うしじろう	牛次郎
うしくぬま	牛久沼
うしがえる	牛蛙
うしかいざ	牛飼い座
うしおじる	潮汁
うさんくさ	胡散臭
うさばらし	憂さ晴らし
うさぎどし	卯年
うさぎとび	兎跳び
うさぎごや	ウサギ小屋	兎小屋
うさぎうま	驢
うごきはじ	動き始
うこんいろ	鬱金色
うこっけい	烏骨鶏
うこさべん	右顧左眄
うこうけん	宇航研
うけわたし	受渡	受渡し	受け渡し
うけばらい	受け払い
うけはらい	受払い	受け払い
うけにぬし	受荷主
うけとりて	受け取り手
うけとりご	受取後
うけつけび	受付日
うけたまわ	承
うけこたえ	受け答え
うぐいすな	鶯菜
うくらいな	烏克蘭
うきよぼん	浮世本
うきよぶろ	浮世風呂
うきぶくろ	浮袋	鰾
うきどっく	浮ドック
うきしずみ	浮き沈み
うきあしだ	浮足立	浮き足立
うかんむり	ウ冠
うかぬかお	浮かぬ顔
うかがいし	窺い知
うおんびん	ウ音便
うおごころ	魚心
うおいちば	魚市場
うえのはら	上野原
うえのはつ	上野発
うえのてん	上野店
うえのぐち	上野口
うえのかん	上野間
うえのえき	上野駅
うえつせん	羽越線
うえつかた	上つ方
うえきばち	植え木鉢	植木鉢
うえきぐみ	植木組
うえがめん	上画面
うえがはら	上ヶ原
ういきょう	茴香
いんりょく	引力
いんりょう	飲料
いんようぶ	引用部
いんようふ	引用符
いんようじ	引用時
いんようし	引用始
いんようか	陰陽家	引用可
いんゆほう	隠喩法
いんゆぶん	隠喩文
いんぺいし	隠蔽子
いんびせん	因美線
いんばぬま	印旛沼
いんばぐん	印旛郡
いんのしま	因島
いんにょう	飲尿
いんどよう	インド洋
いんどじん	印度人
いんどしな	印度支那
いんでんし	陰電子
いんでんき	陰電気
いんちょう	院長
いんたいじ	引退時
いんたいご	引退後
いんじれい	印字例
いんじゅん	因循
いんじゅう	陰獣
いんじめい	印字名
いんじはば	印字幅
いんじうむ	Indium	In
いんじいち	印字位置
いんしょく	飲食
いんしょう	印章	引照	印象	引証
いんしゅう	因習	因襲
いんしだい	印紙代
いんしぜい	印紙税
いんさつや	印刷屋
いんさつひ	印刷費
いんさつじ	印刷時
いんさつき	印刷機
いんぎょう	隠形	印形
いんぎゃく	淫虐
いんきょく	陰極
いんきょう	印僑
いんきくさ	陰気臭
いんがりつ	因果律
いんがてき	因果的
いんがせい	因果性
いんかんや	印鑑屋
いんかろん	因果論
いんかてん	引火点
いんかせい	引火性
いんおうご	印欧語
いんいおん	陰イオン
いわみざわ	岩見沢
いわみさわ	岩見沢
いわばやし	岩林
いわぬまや	岩沼屋
いわぬまし	岩沼市
いわでやま	岩出山
いわてけん	岩手県
いわだぬき	岩狸
いわしみづ	岩清水
いわしみず	岩清水
いわしぐも	鰯雲
いわきさん	岩木山
いわおおじ	岩大路
いわいはら	岩井原
いわいずみ	岩泉
いわいざけ	祝い酒
いわいごと	祝事
いろめきた	色めき立
いろめがね	色眼鏡
いろみほん	色見本
いろほせい	色補正
いろふごう	色符号
いろはうた	伊呂波歌
いろはいち	色配置
いろなおし	色直し
いろじかけ	色仕掛け
いろしてい	色指定
いろしすう	色指数
いろごのみ	色好み
いろごとし	色事師
いろきろく	色記録
いろがわり	色変り
いろおんな	色女
いろおんど	色温度
いろおとこ	色男
いろうざき	石廊崎
いろうきん	慰労金
いろうかい	慰労会
いろいがい	色以外
いれぼくろ	入れ黒子
いれちがい	入れ違い
いれかわり	入れ替わり	入れ代わり
いれいさい	慰霊祭
いるまがわ	入間川
いりょうぶ	医療部
いりょうひ	医療費
いりまじり	入交
いりどうふ	煎り豆腐
いりたまご	煎り卵	炒り玉子	炒り卵
いりたはま	入田浜
いりじうむ	Iridium	Ir
いりおもて	西表
いりあいち	入会地
いらんくう	囲卵腔
いらだたし	苛立たし
いらここう	伊良湖港
いらいらし	苛苛し
いらいもと	依頼元
いらいひん	依頼品
いらいぬし	依頼主
いらいにん	依頼人
いらいせい	依頼制
いらいしん	依頼心
いらいしょ	依頼書
いらいしゃ	依頼者
いよみしま	伊予三島
いよくてき	意欲的
いよくさく	意欲作
いやしけい	癒し系
いやしくも	苟も
いやくひん	医薬品
いやくきん	違約金
いやがらせ	嫌がらせ
いやがさこ	伊屋ヶ迫
いやがおう	否が応
いもになべ	芋煮鍋
いもにかい	芋煮会
いむちょう	医務長
いみんぞく	異民族
いみふめい	意味不明
いみふごう	意味符合
いみちしき	意味知識
いみじょう	意味上
いみしょり	意味処理
いみことば	忌み詞	忌み言葉	忌言葉
いみげんご	意味言語
いみきそく	意味規則
いまわだい	今話題
いまりゅう	今流
いまりやき	伊万里焼
いまべっぷ	今別府
いまひとつ	今一つ
いまばやし	今林
いまでがわ	今出川
いまづかん	今津間
いまづえき	今津駅
いまちづき	居待月
いまずせん	今津線
いますこし	今少し
いまじょう	今庄	今城
いまじぶん	今時分
いましばら	今暫
いましがた	今し方
いまこまち	今小町
いまかがみ	今鏡
いまいみき	今井美樹
いまいっぽ	今一歩
いまいちど	今一度
いまいずみ	今泉
いほうろん	違法論
いほうひん	違法品
いほうせい	異方性	違法性
いほうじん	異邦人
いほうきじ	違法記事
いぷしろん	ε
いぶしぎん	燻し銀
いぶきやま	伊吹山
いひょうき	異表記
いばらぎし	茨木市
いはんしゃ	違反車	違反者
いのちびろ	命拾
いのちとり	命取り
いのちづな	命綱
いのちごい	命乞い
いのちがけ	命懸け
いのがしら	井の頭
いのかしら	井の頭
いねちょう	伊根町
いぬやまし	犬山市
いぬくぼう	犬公方
いぬがみけ	犬神家
いぬいもん	乾門
いなわしろ	猪苗代
いなりやま	稲荷山
いなりまち	稲荷町
いなりずし	稲荷鮨
いなびかり	稲光
いなさやま	稲佐山
いなさぐん	引佐郡
いなげえき	稲毛駅
いなかもの	田舎者
いなかみち	田舎道
いなかまち	田舎町
いなかっぺ	田舎っぺ
いなかだて	田舎館
いなかそば	田舎蕎麦
いなかくさ	田舎臭
いなおえき	稲生駅
いどけいど	緯度経度
いどうよう	移動用
いどうもと	移動元
いどうもう	移動網
いどうまえ	移動前
いどうはん	移動班
いどうはば	移動幅
いどうだな	移動棚
いどうたい	移動体
いどうせい	移動性
いどうじき	移動時期
いどうしゃ	移動者
いどうしき	移動式
いどうさき	異動先	移動先
いどうけい	移動系
いどうぐみ	異動組
いどうがた	移動型
いどういち	移動位置
いとまごい	暇乞い
いとふめい	意図不明
いとでんわ	糸電話
いとづくり	糸作り
いとちゅう	伊藤忠
いとぐるま	糸車
いときりば	糸切歯
いとうまん	伊藤萬
いとうはむ	伊藤ハム
いとうせん	伊東線
いとうけん	伊藤研
いとうえん	伊藤園
いといがわ	糸魚川
いでんてき	遺伝的
いでんせい	遺伝性
いでんしざ	遺伝子座
いでんけん	遺伝研
いでんがく	遺伝学
いてんまえ	移転前
いてんさき	移転先
いつつぼし	五つ星
いつつばし	五橋
いつくしま	厳島
いつかいち	五日市
いっぽんめ	一本目
いっぽんだ	一本立
いっぽんさ	一本鎖
いっぽんぎ	一本気
いっぽんか	一本化
いっぽまえ	一歩前
いっぴょう	一票	1票
いっぱんろ	一般路
いっぱんち	一般値
いっぱんし	一般紙	一般誌
いっぱんご	一般語
いっぱんか	一般化
いっぱつや	一発屋
いっぱつめ	一発目
いっぱくめ	一拍目
いっとかん	一斗缶
いっとうち	一頭地	一等地
いってんろ	一点炉
いってんめ	一点目
いってんば	一点張
いってんさ	一点差
いってんき	一転機
いっていち	一定値
いっていじ	一丁字
いっつうわ	一通話
いっつうめ	一通目
いっちょう	一朝	一聴	一兆	一張	一長	一丁
いっちゅう	一中	一籌
いっちゃく	一着
いっちてん	一致点
いっちせい	一致性
いったいか	一体化
いっせつな	一刹那
いっせいに	一斉に
いっしょく	一色	一食
いっしょう	一将	一勝	一升	一笑	一生	一章
いっしゅん	一瞬
いっしゅつ	逸出
いっしゅく	一宿
いっしゅう	一週	一蹴	一周
いっしむく	一矢報
いっしあい	一試合
いっさんか	一酸化
いっさつめ	一冊目
いっさくや	一昨夜
いっさくめ	一作目
いっこぶん	一個分
いっこだて	一戸建て
いっこじん	一個人
いっけんや	一軒家
いっくかん	一区間
いっきょく	一曲	一極	一局
いっきょう	一驚	一興
いっきゅう	一球	一級	一休
いっきゃく	一脚
いっきのみ	一気飲み
いっきせい	一期生
いっきうち	一騎打
いっかりつ	一価律
いっかてき	一過的
いっかせい	一過性
いっかしょ	一カ所	一か所	一ヶ所	一箇所	1カ所
いっかごん	一家言
いっかげん	一家言
いっかげつ	一ヶ月	１ヶ月	１か月	一箇月	一カ月
いっかいめ	１回目	一回目
いっかいき	一回忌
いちろうた	一朗太
いちれつめ	一列目
いちりんざ	一輪挿
いちりんか	一輪花
いちりょう	一両
いちりゅう	一流	一留	一粒
いちりやま	一里山
いちりづか	一里塚
いちよそく	位置予測
いちようそ	一要素
いちようか	一様化
いちやぶん	一夜分
いちやなぎ	一柳
いちやづけ	一夜漬け	一夜漬
いちもんめ	一問目
いちもんな	一文無
いちもんじ	一文字
いちもじめ	一文字目
いちめがさ	市女笠
いちみゃく	一脈
いちまいめ	一枚目
いちまいえ	一枚絵
いちほうし	一法師
いちへいし	一兵士
いちぶんや	一分野
いちぶんし	一分子
いちぶもん	一部門
いちぶぶん	一部分
いちぶいん	一部員
いちびょう	一秒
いちばんめ	1番目	一番目
いちばんて	一番手
いちばんす	一番好
いちばんき	一番機
いちばめん	一場面
いちはらん	一波乱
いちはらの	市原野
いちはらし	市原市
いちはやく	いち早く
いちはざま	一迫
いちはさま	一迫
いちのもと	檪本	櫟本
いちのみや	一ノ宮	一宮	一の宮
いちのぼう	一の坊
いちのせき	一ノ関	一関
いちのくら	一ノ蔵	一の倉	一ノ倉
いちのぎく	市乃菊	市之菊
いちねんめ	一年目
いちねんじ	一年次
いちねんご	1年後	一年後
いちねんき	一年忌
いちにてん	一二点
いちにちめ	一日目
いちにちご	一日後
いちにかい	一二回
いちてんき	一転機
いちだんめ	一段目
いちだいめ	一代目	一台目
いちだいじ	一大事
いちだいき	一代記
いちたんご	一単語
いちたろう	市太郎	一太郎
いちたいた	一対多
いちそうさ	一走査
いちせいど	位置精度
いちじるし	著し
いちじょう	一条	一畳	一場	一定	一城
いちじゅん	一巡	一旬	一順
いちじゅう	一重
いちじへき	一次壁
いちじばん	一字版
いちじてき	一時的	一次的
いちじだい	一時代
いちじしぶ	一次篩部
いちじしき	一次式
いちじげん	一次元	1次元
いちじきん	一時金
いちじがわ	一次側
いちじかん	1時間	一時間
いちじかい	一次会	1次会
いちしみん	一市民
いちしてい	位置指定
いちしじん	一私人
いちごうき	一号機
いちこてい	位置固定
いちこたい	一個体
いちこじん	一個人
いちげんか	一元化
いちぎょう	1行	一行	１行
いちぎてき	一義的
いちきしゅ	一機種
いちがめん	一画面
いちがっき	一学期
いちがしら	市頭
いちがいに	一概に
いちかわし	市川市
いちかたい	一方井
いちかくほ	位置確保
いちえいが	一映画
いちいてき	一意的
いちいせい	一意性
いたんてき	異端的
いたんしゃ	異端者
いたりあご	イタリア語
いたやなぎ	板柳
いたやがい	板屋貝
いたやえき	板谷駅
いためもの	炒め物
いためがみ	板目紙
いたみわけ	傷み分け	痛み分け
いたみどめ	痛み止め
いたぶんこ	板文庫
いたばしく	板橋区
いたばさみ	板挟み
いたちょこ	板チョコ
いたずらに	徒に
いたじょう	板状
いたしかゆ	痛し痒
いたしかた	致し方
いたけだか	居丈高
いたくきん	依託金
いたがらす	板硝子
いたがこい	板囲い
いぞんてき	依存的
いぞんせき	依存積
いぞんせい	依存性
いぞんぎみ	依存気味
いぞんがた	依存型
いぞくかい	遺族会
いそんひん	易損品
いそんせい	依存性
いそじまん	磯自慢
いそごえき	磯子駅
いそぎあし	急ぎ足
いそうろう	居候
いそうてき	位相的
いそうさき	移送先
いそうがく	位相学
いそうかく	位相角
いぜんけい	已然形
いせまいり	伊勢参り
いせはらし	伊勢原市
いせちょう	伊勢町
いせきせつ	移籍説
いせきさき	移籍先
いせきぐみ	移籍組
いせおきつ	伊勢奥津
いせいぶつ	異生物
いせいたい	異性体
いせいじん	異星人
いせいしゃ	為政者
いせいけん	遺生研
いせいあい	異性愛
いずもざき	出雲崎
いずみやま	泉山
いずみたに	泉谷
いずみさの	泉佐野
いずみさき	泉崎
いずみごう	泉郷
いずみがわ	泉川
いずみかわ	泉川
いずはこね	伊豆箱根
いずにった	伊豆仁田
いずちほう	伊豆地方
いずくんぞ	焉
いずきゅう	伊豆急
いすみまち	夷隅町
いすずがわ	五十鈴川
いじんでん	偉人伝
いじんしゅ	異人種
いじんかん	異人館
いじょうふ	偉丈夫
いじょうど	異常度
いじょうち	異常値
いじょうじ	異常時
いじめっこ	苛めっ子
いじっぱり	意地っ張り
いじきたな	意地汚
いじかんり	維持管理
いしんりき	維新力
いしわたり	石渡
いしりょく	意志力
いしょくど	移植度
いしゅぞく	異種族
いしゅせい	異種性
いしゅがえ	意趣返
いしやがわ	石屋川
いしゃやく	医者役
いしぼとけ	石仏
いしのもり	石之森
いしのまき	石巻
いしどりや	石鳥谷
いしづくり	石造り
いしつぶつ	遺失物
いしつせい	異質性
いしだたみ	甃	石畳
いしそつう	意思疎通
いししょう	異嗜症
いししゅぎ	意思主義
いししかく	医師資格
いしごおり	石氷
いしこじん	医師個人
いしきりば	石切場
いしきてき	意識的
いしがきし	石垣市
いしかりし	石狩市
いしおざん	石尾山
いしあたま	石頭
いさんぜい	遺産税
いさんかた	胃酸過多
いさみはだ	勇み肌
いさみあし	勇足	勇み足
いごこうざ	囲碁講座
いこまやま	生駒山
いこうぞう	異構造
いこうそち	移行措置
いこうずみ	移行済
いこうさき	移行先
いこうあん	移行案
いけんらん	意見欄
いけんなど	意見等
いけんせい	違憲性
いけんしょ	意見書
いけぶくろ	池袋
いけのぼう	池坊	池の坊
いけのはた	池の端
いけのうえ	池ノ上
いけつつみ	池堤
いけいれん	胃痙攣
いけいよう	異形葉
いけいしき	異形式
いぐさもく	イグサ目	Juncales
いくらどん	イクラ丼
いくびょう	育苗
いくたはら	生田原
いくたさい	生田祭
いくたがわ	生田川
いくせいぶ	育成部
いくじなし	意気地無し
いくじしょ	育児所	育児書
いくさぼし	軍星
いくさぶね	軍船
いくさがみ	軍神
いくうかん	異空間
いきわかれ	生き別れ
いきりょう	生霊	生き霊
いきょうと	異教徒
いきやすめ	息休め
いきぼとけ	生き仏
いきのした	息の下
いきのこり	生き残り
いきどまり	行き止まり
いきづかい	息遣い
いきちがい	行き違い
いきだおれ	行き倒れ
いきそそう	意気沮喪
いきじびき	生き字引
いきじごく	生き地獄
いきおいよ	勢い良
いきおいづ	勢い付
いきおいこ	勢い込
いきうつし	生き写し
いがりゅう	伊賀流
いがこうべ	伊賀神戸
いがくてき	医学的
いがくせい	医学生
いがくしょ	医学書
いがくしゃ	医学者
いがくけい	医学系
いがくかい	医学界
いがいせい	意外性
いかんそく	維管束
いかわだに	伊川谷
いかりゃく	以下略
いかりそう	碇草
いかりくる	怒り狂
いかりがた	怒り肩
いかのぼり	凧
いかいよう	胃潰瘍	胃かいよう
いおんびん	イ音便
いおうとう	硫黄島
いおうじま	硫黄島	伊王島
いえんけん	以遠権
いえやしき	家屋敷
いえどころ	家所
いえでにん	家出人
いえじゅう	家中
いえがまえ	家構え
いえいがい	家以外
いうなれば	言うなれば
いいんかい	委員会
いいわたし	言い渡し	言渡し
いいまわし	言い回し	言回し
いいのがれ	言い逃れ
いいなずけ	許嫁
いいづかし	飯塚市
いいつたえ	言い伝え
いいつくろ	言い繕
いいだばし	飯田橋
いいだせん	飯田線
いいたがわ	飯田川
いいじょう	言い条
いいがかり	言い掛かり	言い掛り
いいかげん	いい加減	好い加減
いいあらわ	言い表
いいあらた	言い改
いいあらそ	言い争
いいあやま	言い誤
いあんじょ	慰安所
いあんかい	慰安会
いあつてき	威圧的
いあつかん	威圧感
いあいぬき	居合抜き
いあいごし	居合腰
いーふぁん	一翻
あんりゅう	暗流
あんらくし	安楽死
あんないず	案内図
あんどかん	安堵感
あんていど	安定度
あんていき	安定期
あんていか	安定化
あんちょく	安直
あんちゅう	暗中	闇中
あんちゃん	兄ちゃん
あんちゃく	安着
あんちもん	Sb	Antimony
あんだすう	安打数
あんそくび	安息日
あんぜんび	安全日
あんぜんく	安全区
あんぜんき	安全器
あんせいど	安静度
あんせいじ	安静時
あんじょく	鞍褥
あんじょう	鞍上	安城	安生
あんじゅう	安住
あんじてき	暗示的
あんしんど	安心度
あんしょく	暗色
あんしょう	暗礁	暗誦	暗唱	諳誦	暗証
あんしゅつ	案出
あんしゅう	暗愁
あんごうか	暗号化
あんこくじ	安国寺
あんこがた	鮟鱇形
あんぎょう	安行
あんきほう	暗記法
あんかせい	安価性
あわびむす	鮑結
あわてもの	慌て者
あわづはら	粟津原
あわだてき	泡立て器
あわたてき	泡立て器
あわせわざ	合わせ技
あわせみそ	合せ味噌	合わせ味噌
あわじしま	淡路島
あわいけだ	阿波池田
あれもよう	荒れ模様
あれしょう	荒れ性
あるみはく	アルミ箔
あるみせい	アルミ製
あるみかん	アルミ缶
あるふぁは	α波
あるちゅう	アル中
あるきまわ	歩き回
あるきつづ	歩き続
あるきつか	歩き疲
あるきかた	歩き方
あるかなし	有るか無し
ありまぐち	有馬口
ありたやき	有田焼
ありすがわ	有栖川
ありじごく	蟻地獄
ありがとう	有り難う	有難う
ありがたみ	ありがた味	有難味
ありあわせ	有り合わせ
あらりえき	粗利益	荒利益
あらやしき	阿頼耶識	新屋敷
あらものや	荒物屋
あらむもじ	アラム文字
あらむしゃ	荒武者
あらぼとけ	新仏
あらほうし	荒法師
あらぶじん	アラブ人
あらびあご	アラビア語
あらづくり	粗造り
あらためて	改めて
あらしやま	嵐山
あらしごと	荒仕事
あらさがし	あら探し	粗探し
あらごなし	荒ごなし
あらけずり	粗削り
あらぎょう	荒行
あらかわく	荒川区
あらかせぎ	荒稼ぎ
あらかじめ	豫め	予め	予	豫
あらいもの	洗い物
あらいまち	新居町
あらいなが	洗い流
あらいなお	洗い直
あらいだし	洗い出し
あらいしゅ	洗朱
あらいけん	荒井研
あらいぐま	浣熊
あらいがみ	洗い髪
あらいがき	洗柿
あらいおけ	洗い桶
あゆみつづ	歩み続
あゆみいた	歩み板
あゆみあし	歩み足
あやめもく	アヤメ目	Iridales
あやめざけ	菖蒲酒
あやめいけ	あやめ池
あやのみや	礼宮
あやせがわ	綾瀬川
あやせえき	綾瀬駅
あやいがさ	綾藺笠
あめよほう	雨予報
あめもよう	雨模様
あめのもり	雨森
あめおんな	雨女
あめおとこ	雨男
あめあられ	雨霰
あめあがり	雨上がり
あみわたり	網渡
あみのさん	アミノ酸
あみちょう	阿見町
あみだぶつ	阿弥陀仏
あみだどう	阿弥陀堂
あみだくじ	阿弥陀籤
あみたいつ	網タイツ
あみじょう	網状
あみかんり	網管理
あみあぶら	網油
あまりもの	余り物
あまやどり	雨宿り
あまもよう	雨模様
あまもよい	雨催	雨催い
あまほうし	尼法師
あまのがわ	天の河	天の川
あまつつみ	天津罪
あまつさえ	剰え
あまつくに	天津国
あまつかみ	天津神
あまつかぜ	天津風
あまちまり	天地真理
あましょく	甘食
あまざらし	雨曝し
あまくだり	天降り	天下り
あまぎせん	甘木線
あまがさき	尼崎
あまがえる	雨蛙
あまからに	甘辛煮
あまおとめ	天少女
あまえっこ	甘えっ子
あほうどり	信天翁
あへんくつ	阿片窟
あぶれもの	溢れ者
あぶらもと	油本
あぶらむし	蜚	油虫
あぶらぶん	油分
あぶらぬき	油抜き
あぶらなか	アブラナ科
あぶらとり	脂取り
あぶらづけ	油漬
あぶらつぼ	油壷
あぶらぜみ	油蝉
あぶらざら	油皿
あぶらざめ	油鮫
あぶらぐち	油口
あぶらがみ	油紙
あぶらかわ	油川
あぶらいろ	油色
あぶらいし	油石
あぶらあせ	脂汗
あぶらあげ	油揚	油揚げ
あびるもじ	阿比留文字
あびじごく	阿鼻地獄
あばれもの	暴れ者
あばれまわ	暴れ回
あばれうま	暴れ馬
あばらぼね	肋骨
あばしりこ	網走湖
あのくたら	阿耨多羅
あねったい	亜熱帯
あねがさき	姉ヶ崎
あなよそう	穴予想
あなにんき	穴人気
あなたたち	貴方達
あなたがた	貴方方
あともどり	後戻り
あとまわし	後回し
あとばらい	後払い
あとしょり	後処理
あとしまつ	後始末
あとくされ	後腐れ
あとかたづ	後片づ	後片付
あとかいぎ	後会議
あといっぽ	後一歩
あといっこ	後一個
あですがた	艶姿
あてらざわ	左沢
あづまばし	吾妻橋
あづません	吾妻線
あつりょく	圧力	壓力
あつにゅう	圧入
あつじょう	圧条
あつぎきち	厚木基地
あつぎかん	厚木間
あつぎえき	厚木駅
あっちゃく	圧着
あっしょう	圧勝
あっしゅく	圧縮
あっけない	呆気ない
あだしごと	徒し事
あたりやく	当り役	当たり役	当役
あたりまえ	当り前	当たり前
あたりばち	当り鉢	当たり鉢
あたりがね	当り鉦
あたらしや	新屋
あたみかん	熱海間
あたみえき	熱海駅
あたまわり	頭割り
あたまだし	頭出し
あたまきん	頭金
あたまがわ	頭側
あたまかぶ	頭株
あたまかず	頭数
あたまうち	頭打ち
あたごやま	愛宕山
あたごばし	愛宕橋
あたえかた	与え方
あたいよび	値呼び
あそびほう	遊び惚	遊び呆
あそびにん	遊び人	遊人
あそびがみ	遊び紙
あそびがね	遊び金
あそびかた	遊び方
あそびうた	遊び歌
あそうがわ	麻生川
あせっかき	汗っ掻き
あずみぐん	安曇郡
あずまふじ	東富士
あずまばし	吾妻橋
あずません	吾妻線
あずさゆみ	梓弓
あずさみこ	梓巫女
あずさがわ	梓川
あずけきん	預け金
あずけあい	預合
あずきもち	小豆餅
あずきがゆ	小豆粥
あずきいろ	小豆色
あずかりし	与り知
あすぢゅう	明日中
あすたちん	Astatine	At
あすじゅう	明日中
あすかやま	飛鳥山
あすいこう	明日以降
あじみよう	味見用
あじふめい	味不明
あじのもと	味の素
あじじまん	味自慢
あじけない	味気ない
あじきこう	味紀行
あじがさわ	鯵ヶ沢
あじおんち	味音痴
あじあだい	亜細亜大
あしやがわ	芦屋川
あしまわり	足回り
あしまかせ	足任せ
あしばらい	足払い
あしのこう	足の甲
あしでまと	足手纏
あしざわり	足触り
あしきょう	芦響
あしがらみ	足搦み
あしがなえ	足鼎
あしがため	足固め
あしがかり	足掛り	足掛かり
あしかがし	足利氏
あしかがけ	足利家
あしおせん	足尾線
あしおざん	足尾山
あしおえき	足尾駅
あざわらい	嘲笑い
あざみうま	薊馬
あざぶだい	麻布台
あさみなみ	安佐南
あさみどり	浅緑
あさまやま	浅間山
あさました	浅間下
あさぼらけ	朝ぼらけ
あさぶくろ	麻袋
あさひやま	朝日山
あさひむら	朝日村
あさひまち	旭町
あさひはい	朝日杯
あさひだけ	旭岳
あさひだい	旭台
あさひけい	朝日系
あさひがわ	旭川
あさひかわ	旭川
あさはなだ	浅縹
あさねぼう	朝寝坊
あさっぱら	朝っ腹
あさだあめ	浅田飴
あさすおう	浅蘇芳
あさごはん	朝ごはん	朝ご飯
あさげいこ	朝稽古
あさぎまく	浅葱幕
あさぎうら	浅葱裏
あさぎいろ	浅葱色
あさきたく	安佐北区
あさがえり	朝帰り
あこやがい	阿古屋貝
あこうだい	赤魚鯛
あこうそく	亜光速
あこうせん	赤穂線
あげやいり	揚屋入り
あげひばり	揚げ雲雀
あげくだし	上げ下し
あげおえき	上尾駅
あげあぶら	揚げ油
あけっぴろ	開けっ広	明けっ広
あけっぱな	明けっ放	開けっ放
あけがらす	明烏
あくりょく	握力
あくりょう	悪霊
あくりゅう	悪竜
あくみょう	悪名
あくまてき	悪魔的
あくびょう	悪病
あくひょう	悪評
あくねんぴ	悪燃費
あくだまか	悪玉化
あくたろう	悪太郎
あくたがわ	芥川
あくせんと	accent
あくせいど	悪性度
あくしょう	悪性
あくしゅみ	悪趣味
あくしゅう	悪臭	悪習
あくしつか	悪質化
あくこうか	悪効果
あくげんた	悪源太
あくぎょう	悪行	悪業
あくぎゃく	悪虐	悪逆
あくうかん	亜空間
あきれがお	あきれ顔	呆れ顔
あきれかえ	呆れ返
あきりすと	空きリスト
あきやすみ	秋休み
あきやしき	空屋敷
あきまつり	秋祭り	秋祭
あきぶもん	空部門
あきびより	秋日和
あきばしょ	秋場所
あきはばら	秋葉原
あきのそら	秋の空
あきつしま	秋津島
あきたべん	秋田弁
あきただい	秋田大
あきたけん	秋田県	秋田犬
あきたえき	秋田駅
あきたいぬ	秋田犬
あきじかん	空き時間	空時間
あきしまし	昭島市
あきけいば	秋競馬
あきいこう	秋以降
あきあかね	秋茜
あがりだか	上がり高
あがりかた	上がり方
あがのがわ	阿賀野川
あかんぼう	赤ん坊
あかんたい	亜寒帯
あかわいん	赤ワイン
あかりまど	明かり窓	明り窓
あかりとり	明かり取り	明り取り
あからしま	暴
あからがお	赤ら顔
あかめぐち	赤目口
あかまえき	赤間駅
あかはだか	赤裸
あかねもく	アカネ目	Rubiales
あかねぐも	茜雲
あかねいろ	茜色
あかどまり	赤泊
あかとんぼ	赤蜻蛉
あかでんわ	赤電話
あかつつみ	赤堤
あかっぱじ	赤っ恥
あかちゃん	赤ちゃん
あかせがわ	赤瀬川
あかずきん	赤頭巾
あかじはば	赤字幅
あかじがく	赤字額
あかしやき	明石焼
あかしこう	明石港
あかしがわ	明石側
あかざとう	赤砂糖
あかこほん	赤小本
あかぎやま	赤城山
あかぎさん	赤城山
あかぎいろ	赤黄色
あかきっぷ	赤切符
あかおすぎ	赤尾杉
あかえぼし	赤烏帽子
あかいわし	赤鰯
あかいくつ	赤い靴
あかいがわ	赤井川
あおんそく	亜音速
あおやなぎ	青柳
あおもりし	青森市
あおみどろ	水綿
あおみどり	青緑
あおぼうず	青坊主
あおばやま	青葉山
あおばばし	青葉橋
あおばどお	青葉通
あおばだい	青葉台
あおばかい	青葉会
あおのはら	青野原
あおにさい	青二才
あおでんわ	青電話
あおだたみ	青畳
あおたがり	青田刈	青田刈り
あおたがい	青田買い
あおざかな	青魚
あおぎいろ	青黄色
あおきばし	青木橋
あおきっぷ	青切符
あおがしま	青ヶ島
あおがえる	青蛙
あおいもく	Malvales	アオイ目
あいようき	愛用機
あいやぐら	相矢倉
あいまって	相俟って
あいびょう	愛猫
あいのえき	愛野駅
あいねずみ	藍鼠
あいともな	相伴
あいてやく	相手役
あいてさき	相手先
あいてこく	相手国
あいてがわ	相手側
あいてがた	相手方
あいてかた	相手方
あいづだい	会津大
あいちょう	愛鳥	哀調	愛重	愛聴
あいちゃく	愛着	合着
あいちみと	愛知御津
あいちべん	愛知弁
あいちけん	愛知県
あいだがら	間柄
あいそわら	愛想笑
あいずだい	会津大
あいじょう	愛情	愛嬢	哀情
あいしょか	愛書家
あいしょう	哀傷	愛妾	愛称	相性	愛唱	愛誦
あいしゅう	哀愁	愛執
あいしかた	愛し方
あいさつご	挨拶語
あいさいか	愛妻家
あいことば	合言葉
あいこうか	愛好家
あいきょう	愛郷	愛敬	愛嬌
あいきゅう	哀泣
あいきゃく	相客
あいきどう	合気道
あいえんか	愛煙家
あーくとう	アーク灯
おんようどう	陰陽道
おんみょうじ	陰陽師
おんびんけい	音便形
おんばひがさ	乳母日傘
おんばこうか	音場効果
おんはいすい	温排水
おんなやもめ	女寡
おんなひとり	女一人
おんなのひと	女の人
おんなどうし	女同士
おんなたらし	女誑	女誑し
おんなせんし	女戦士
おんなずもう	女相撲
おんなじしん	女自身
おんなしまい	女姉妹
おんなざかり	女盛り
おんなごろし	女殺し
おんなごころ	女心
おんなこども	女子供
おんなことば	女言葉
おんなけいず	婦系図
おんなぐるい	女狂い
おんなあそび	女遊び
おんどほせい	温度補正
おんどへんか	温度変化
おんどはんい	温度範囲
おんどしつど	温度湿度
おんどかんり	温度管理
おんていぶん	音程分
おんていがい	音程外
おんていかん	音程感
おんちくけい	音蓄系
おんだいそつ	音大卒
おんだいせい	音大生
おんぞうえく	怨憎会苦
おんぞういち	音像位置
おんそたんい	音素単位
おんそくいか	音速以下
おんせんやど	温泉宿
おんせんほう	音線法
おんせんがい	温泉街
おんせんえき	温泉駅
おんせつもじ	音節文字
おんせつすう	音節数
おんせいてき	音声的
おんせいけん	音声研
おんせいがく	音声学
おんすうりつ	音数律
おんしつめん	音質面
おんしつてき	音質的
おんししょう	恩賜賞
おんこちしん	温故知新
おんこうろん	音講論
おんげんよう	音源用
おんげんもぎ	音源模擬
おんげんばん	音源版
おんげんすう	音源数
おんげんがわ	音源側	音現側
おんげんいち	音源位置
おんきょうぶ	音響部
おんがっかん	音楽館
おんがっかい	音楽会
おんがくろん	音楽論
おんがくれき	音楽歴
おんがくよう	音楽用
おんがくへん	音楽篇	音楽編
おんがくふう	音楽風
おんがくどう	音楽堂
おんがくてき	音楽的
おんがくたい	音楽隊
おんがくせい	音楽性
おんがくしつ	音楽室
おんがくさい	音楽祭
おんがくげき	音楽劇
おんがくけい	音楽系
おんがくきき	音楽機器
おんがくがわ	音楽側
おんがくがく	音楽学
おんがくかん	音楽観	音楽館
おんがくかい	音楽界	音楽会
おんがくいん	音楽院
おんいんろん	音韻論
おんいんてき	音韻的
おんいんせい	音韻性
おんいんがく	音韻学
おんいんかん	音韻間
おわりこまき	尾張小牧
おわりあさひ	尾張旭
おわだまさこ	小和田雅子
おわかれかい	お別れ会
おろしどんや	卸問屋
おろしそうば	卸相場
おろししょう	卸商
おれおれさぎ	おれおれ詐欺
おれいまいり	御礼参り
おりものきじ	織物生地
おりひめぼし	織姫星
おりがみつき	折り紙付き
おやゆびくん	親指君
おやゆびがわ	親指側
おやぶんやく	親分役
おやしおいき	親潮域
おやこうこう	親孝行
おやくごめん	御役御免
おやがいしゃ	親会社
おやかためい	親方名
おやかたさま	お館様
おもわれびと	思われ人
おもてまんざ	表万座
おもてぶたい	表舞台
おもてばんく	表バンク
おもてにほん	表日本
おもてどおり	表通り
おもてせんけ	表千家
おもてがまえ	表構え
おもちゃばこ	おもちゃ箱	玩具箱
おもだかもく	Alismatales	オモダカ目
おもしろやま	面白山
おもうしこみ	お申込み	お申し込み
おもいわずら	思い煩
おもいどおり	思い通り
おもいでぶか	想い出深	思い出深
おもいっきり	思いっきり
おもいちがい	思い違い
おもいおもい	思い思い
おめんじょう	御免状
おみまいきん	御見舞い金
おぼんやすみ	お盆休み
おぼろどうふ	朧豆腐
おぼろづきよ	朧月夜
おべんきょう	お勉強
おふぃすがい	オフィス街
おびひろえき	帯広駅
おびばんぐみ	帯番組
おびこうこく	帯広告
おひるやすみ	お昼休み
おひさしぶり	お久しぶり
おばすてやま	姨捨山
おばけやしき	お化け屋敷
おはらいばこ	お払い箱
おはなばたけ	御花畑
おはぐろどぶ	御歯黒溝
おののこまち	小野小町
おののいもこ	小野妹子
おのがくえん	小野学園
おのおのがた	各々方
おにがらやき	鬼殻焼
おにいちゃん	お兄ちゃん
おなんどいろ	御納戸色
おどしもんく	脅し文句
おとりそうさ	囮捜査
おとりしらべ	お取り調べ
おとめじゅく	乙女塾
おとめごころ	乙女心
おとべちょう	乙部町
おとひめさま	乙姫様
おとなひとり	大人一人
おとせってい	音設定
おとしんごう	音信号
おとしどころ	落し所	落とし所
おとこやもめ	男鰥
おとこまさり	男勝り	男勝
おとこひとり	男一人
おとこのひと	男の人
おとこなまえ	男名前
おとこどうし	男同士
おとこじゅく	男塾
おとこしゅう	男衆
おとこざかり	男盛り
おとこごころ	男心
おとこことば	男言葉
おとこぐるい	男狂い
おとこおとこ	男男
おとこうぞう	音構造
おとこあそび	男遊び
おとこあいて	男相手
おとくうかん	音空間
おとぎりそう	弟切草
おとぎばなし	御伽話	お伽話
おとぎぞうし	御伽草子
おとおんかい	音音階
おとうとぶん	弟分
おとうとでし	弟弟子
おといあわせ	お問い合わせ
おてんとさま	お天道様	御天道様
おつぼねさま	お局様
おつざいよう	乙剤用
おつがわえき	乙川駅
おつかれさま	お疲れ様
おっぱまえき	追浜駅
おちょぼぐち	おちょぼ口
おちゅうげん	お中元	御中元
おちゃのみば	お茶飲み場
おちゃのみず	御茶ノ水	お茶の水	御茶の水
おちぼひろい	落穂拾い
おちつきはら	落ち着き払
おだわらせん	小田原線
おだわらがた	小田原方
おだわらかん	小田原間
おだまきむし	小田巻蒸し	苧環蒸し
おだのぶひで	織田信秀
おだのぶなが	織田信長
おだかずまさ	小田和正
おだかしょう	尾高賞
おたまやした	霊屋下
おたがいさま	お互い様
おそるおそる	恐る恐る
おそなえもち	御供え餅
おせんちたい	汚染地帯
おすたかやま	御巣鷹山
おじょうさん	御嬢さん	お嬢さん
おじょうさま	お嬢様	御嬢様
おじゃまむし	お邪魔虫
おじまちょう	小島町
おしろいばな	白粉花
おしょうがつ	お正月
おしゃまんべ	長万部
おしゃかさま	御釈迦様
おしもんどう	押し問答	押問答
おしむらくは	惜しむらくは
おしあげせん	押上線
おしあげかん	押上間
おざわりゅう	小沢流
おざきゆたか	尾崎豊
おざきまさし	尾崎将司
おさななじみ	幼馴染み	幼なじみ	幼馴染
おさなごころ	幼心
おさないころ	幼い頃
おさだめがき	御定書
おごうりかん	小郡間
おこりんぼう	怒りん坊
おこのみやき	お好み焼き
おけがやぬま	桶ケ谷沼
おぐらしきし	小倉色紙
おくれじかん	遅れ時間
おくりむかえ	送り迎え
おくりたおし	送り倒し
おくりじょう	送り状
おくゆきかん	奥行感
おくまつしま	奥松島
おくほうこう	奥方向
おくになまり	御国訛り
おくにっこう	奥日光
おくにっかわ	奥新川
おくたまえき	奥多摩駅
おくしりとう	奥尻島
おくきょうと	奥京都
おくがいよう	屋外用
おぎくぼかん	荻窪間
おきゃくさん	お客さん
おきゃくさま	御客様	お客様
おきまつしま	沖松島
おきなわもの	沖縄物
おきなわべん	沖縄弁
おきなわふう	沖縄風
おきなわじん	沖縄人
おきなわさん	沖縄産
おきなわけん	沖縄県
おきなごうし	翁格子
おきとちょう	置戸町
おきつうしん	沖通信
おきたそうじ	沖田総司
おがわちょう	小川町
おがはんとう	男鹿半島
おかやまべん	岡山弁
おかやまだい	岡山大
おかやまけん	岡山県
おかやまがわ	岡山側
おかやまかん	岡山間
おかやまえき	岡山駅
おかやすこう	岡安高
おかべちょう	岡部町
おかどちがい	御門違い
おかだいぞう	岡田以蔵
おかせっけい	岡設計
おかじょうき	陸蒸気
おかしらつき	尾頭付
おかざきえき	岡崎駅
おかえくみこ	岡江久美子
おおわだばく	大和田獏
おおわだかん	大和田間
おおよろこび	大喜び
おおやままち	大山町
おおやまねこ	大山猫
おおやまざき	大山崎
おおやまぐち	大山口
おおやまえき	大山駅
おおやすうり	大安売り	大安売
おおやけごと	公事
おおもりえき	大森駅
おおものかん	大物感
おおもときじ	大元記事
おおむらわん	大村湾
おおむらせん	大村線
おおみやせん	大宮線
おおみやかん	大宮間
おおみやえき	大宮駅
おおまちがい	大間違い
おおまちえき	大町駅
おおぶろしき	大風呂敷
おおふろしき	大風呂敷
おおふなえき	大船駅
おおひらむら	大衡村
おおひらだい	大平台
おおばんよう	大判用
おおばんやき	大判焼
おおばかもの	大莫迦者	大馬鹿者
おおはばやす	大幅安
おおはばだか	大幅高
おおはたせん	大畑線
おおのじょう	大野城
おおにんずう	大人数
おおにしまち	大西町
おおなかぐろ	大中黒
おおとのさま	大殿様
おおとのごも	大殿籠
おおてゆうり	大手有利
おおてしてつ	大手私鉄
おおつちわん	大槌湾
おおつしない	大津市内
おおつしがい	大津市街
おおつごもり	大晦	大晦日
おおつかかん	大塚間
おおつかえき	大塚駅
おおだてもの	大立者
おおたわらし	大田原市
おおたひろみ	太田裕美
おおたてもの	大立者
おおたきむら	王滝村
おおたいさん	太田胃散
おおそとわく	大外枠
おおそとがり	大外刈	大外刈り
おおそうどう	大騒動
おおすみせん	大隅線
おおじょたい	大所帯	大世帯
おおしょうぶ	大勝負
おおしょうぎ	大将棋
おおざけのみ	大酒飲み
おおさんばし	大棧橋
おおさかわん	大阪湾
おおさかやま	逢坂山
おおさかほか	大阪他
おおさかべん	大阪弁
おおさかふう	大阪風
おおさかばん	大阪版
おおさかはつ	大阪発
おおさかはい	大阪杯
おおさかてん	大阪店
おおさかてき	大阪的
おおさかだい	大阪大
おおさかせん	大阪線
おおさかじん	大阪人
おおさかこう	大阪港	大阪校
おおさかけい	大阪系
おおさかがわ	大阪側
おおさかがす	大阪ガス	大阪瓦斯
おおさかかん	大阪間
おおさかえき	大阪駅
おおくらやま	大倉山
おおくぼえき	大久保駅
おおぎがはら	扇ヶ原
おおがねもち	大金持	大金持ち
おおがたまど	大型窓
おおがたぼん	大型本
おおがたてん	大型店
おおがたせん	大型船
おおがたしゃ	大型車
おおがたけん	大型犬
おおがたぎょ	大型魚
おおがたかぶ	大型株
おおがきえき	大垣駅
おおかわばた	大川畑
おおかわぐち	大川口
おおかわかん	大川間
おおかぶぬし	大株主
おおかたびら	大帷子
おおおやぶん	大親分
おおおかやま	大岡山
おおえちょう	大江町
おおえせんり	大江千里
おおうりだし	大売出し	大売り出し
おおうらわざ	大裏技
おおうなばら	大海原
おおうちやま	大内山
おおうちばん	大内版
おおうちがり	大内刈り
おおうずまき	大渦巻
おおいのかみ	大炊頭
おおいとせん	大糸線
おおいちょう	大堰町	大銀杏	大井町
おおいちばん	大一番
おおいただい	大分大
おおいたけん	大分県
おおいたかん	大分間
おおいそがし	大忙し
おおいけいば	大井競馬
おおあみえき	大網駅
おおあきない	大商い
おうれんあか	Coptidoideae	オウレン亜科
おうりょくど	応力度
おうりょうし	押領使
おうらいもの	往来物
おうようれい	応用例
おうようめん	応用面
おうようへん	応用編
おうようてき	応用的
おうようそう	応用層
おうようせい	応用性
おうもんきん	横紋筋
おうめしゃこ	青梅車庫
おうむちょう	雄武町
おうむがえし	鸚鵡返し	おうむ返し
おうみまいこ	近江舞子
おうみしおづ	近江塩津
おうみしおつ	近江塩津
おうみいまづ	近江今津
おうまがとき	逢魔が刻
おうぼりゆう	応募理由
おうぼようし	応募用紙
おうぼはがき	応募葉書
おうぼたすう	応募多数	応募他数
おうぼしかく	応募資格
おうぼきかん	応募期間
おうべいじん	欧米人
おうべいしき	欧米式
おうべいけい	欧米系
おうべいがた	欧米型
おうぶんしゃ	旺文社
おうふくわり	往復割
おうふくよう	往復用
おうふくはん	往復半
おうばくばん	黄檗版
おうばくさん	黄檗山
おうどうたい	黄道帯
おうどうこう	黄銅鉱	黄道光
おうとうぶん	応答文
おうとうてき	応答的
おうとうせい	応答性
おうとうしゃ	応答者
おうでんけん	応電研
おうてびしゃ	王手飛車
おうてひしゃ	王手飛車
おうてっこう	黄鉄鉱
おうだんめん	横断面
おうだんまく	横断幕
おうだんてき	横断的
おうそうだん	応相談
おうせつしつ	応接室
おうせいもう	黄青盲
おうじょさま	王女様
おうじつせい	横日性
おうじせいし	王子製紙
おうさだはる	王貞治
おうごんすう	黄金数
おうぎがやつ	扇ヶ谷
おうかしょう	桜花賞
おうかくまく	横膈膜	横隔膜
おうえんよう	応援用
おうえんだん	応援団
おうえんせき	応援席
おいろなおし	お色直し	御色直し
おいてきぼり	置いてきぼり
おいそがしい	お忙しい
おいこしえき	追越駅
おいえりゅう	御家流
おーぷんせん	オープン戦
おーすとりあ	墺太利
えんれいそう	延齢草
えんりょぶか	遠慮深
えんりょくだ	遠慮下
えんりょがち	遠慮勝ち
えんりゃくじ	延暦寺
えんゆうむげ	円融無碍
えんゆうかい	園遊会	宴遊会
えんもくとじ	鳶目兎耳
えんまちょう	閻魔帳
えんへんこう	円偏光
えんぶんれん	遠文連
えんぶきょく	円舞曲
えんぱくぶん	延泊分
えんばんがた	円盤型
えんどうまめ	豌豆豆
えんとうけい	円筒形	円筒型
えんちょうぶ	延長部
えんたいぶん	延滞分
えんたいきん	延滞金
えんそうれい	演奏例
えんそうほう	演奏法
えんそうしゃ	演奏者
えんそうけん	演奏権
えんそうかい	演奏会
えんぜつほう	演説法
えんせいてき	厭世的
えんせいたい	遠征隊
えんせいさき	遠征先
えんせいがい	袁世凱
えんずいぎり	延髄斬
えんすいめん	円錐面
えんすいだい	円錐台
えんすいこう	塩水港
えんすいけい	円錐形
えんじょぶき	援助武器
えんじょきん	援助金
えんじょがく	援助額
えんじょうじ	円城寺
えんじゅくみ	円熟味
えんじつてん	遠日点
えんしんてき	遠心的
えんしんせい	遠心性
えんしんしき	遠心式
えんしょうじ	円勝寺
えんしゅつじ	演出時
えんしゅつか	演出家
えんざんめい	演算名
えんざんほう	演算法
えんざんすう	演算数
えんざんしき	演算式
えんざんごさ	演算誤差
えんこじょう	円弧上
えんこうるい	円口類
えんげつとう	偃月刀
えんげきろん	演劇論
えんげきよう	演劇用
えんげきてき	演劇的
えんげいよう	園芸用
えんげいめい	園芸名
えんげいてん	園芸店
えんげいしゅ	園芸種
えんぎりょく	演技力
えんぎなおし	縁起直し
えんきんほう	遠近法
えんきんかん	遠近感
えんきりでら	縁切寺	縁切り寺
えんかんさん	円換算
えんかぶもん	演歌部門
えんかつせい	円滑性
えんかちょう	演歌調
えんかかしゅ	演歌歌手
えんかいよう	宴会用
えんかいげい	宴会芸
えんかいおう	塩化硫黄
えんかあえん	塩化亜鉛
えんえきほう	演繹法
えんえきてき	演繹的
えんえきけい	演繹系
えんうんどう	円運動
えりもみさき	襟裳岬
えりだぬすざ	エリダヌス座
えりぜきゅう	エリゼ宮
えようえいが	栄耀栄華
えものがたり	絵物語
えびせんべい	海老煎餅
えびすちょう	恵比寿町
えびすごころ	夷心
えぬかっけい	 n 角形
えなめるせん	エナメル線
えなめるしつ	エナメル質
えなめるがわ	エナメル革
えどむらさき	江戸紫
えどがわばし	江戸川橋
えつらんしゃ	閲覧者
えつらんしつ	閲覧室
えっぺいしき	閲兵式
えっとうたい	越冬隊
えっくすせん	Ｘ線
えちごゆざわ	越後湯沢
えざきれおな	江崎玲於奈
えざきぐりこ	江崎グリコ
えきりんぼん	易林本
えきめいばん	駅名板
えきひょうじ	駅表示
えきばいてん	駅売店
えきじょうか	液状化
えきしゃあと	駅舎跡
えきこうない	駅構内
えきがくしゃ	疫学者
えきかちっそ	液化窒素
えきあんない	駅案内
えがわすぐる	江川卓
えいわじてん	英和辞典
えいわじしょ	英和辞書
えいろんぶん	英論文
えいれんぽう	英連邦
えいりんしょ	営林署
えいりりよう	営利利用
えいりしゅぎ	営利主義
えいりこうい	営利行為
えいようぶん	栄養分
えいようたい	栄養体
えいようざい	栄養剤
えいようげん	栄養源
えいようがく	栄養学
えいゆうでん	英雄伝
えいゆうてき	英雄的
えいめいかん	穎明館
えいべいほう	英米法
えいべいじん	英米人
えいべいぐん	英米軍
えいぶんめい	英文名
えいぶんぽう	英文法
えいぶんがく	英文学
えいだんしゃ	営団車
えいだんえき	営団駅
えいぞくてき	永続的
えいぞくせい	永続性
えいぞうろん	映像論
えいぞうよう	映像用
えいぞうぶつ	営造物
えいぞうとし	映像都市
えいぞうてき	映像的
えいぞうさい	映像祭
えいぞうきき	映像機器
えいせいめん	衛生面
えいせいとし	衛星都市
えいせいてき	衛生的
えいせいだい	衛星第
えいせいぞう	衛星像
えいせいこく	衛星国
えいせいこう	衛生工
えいせいがく	衛生学
えいせいかん	衛星間
えいすうもじ	英数文字
えいすうこく	英数国
えいしゃまく	映写幕
えいしゃぼん	影写本
えいざぶろう	栄三郎
えいさくぶん	英作文
えいごりょく	英語力
えいごぶんか	英語文化
えいごじてん	英語辞典
えいごじしょ	英語辞書
えいごきょく	英語局
えいごかいわ	英語会話
えいごいがい	英語以外
えいこくばん	英国版	英国盤
えいこくない	英国内
えいこくせい	英国製
えいこくじん	英国人
えいこくしゃ	英国車
えいこくしき	英国式
えいこくがわ	英国側
えいこくがた	英国型
えいこうだん	曳光弾
えいぎょうぶ	営業部
えいぎょうび	営業日
えいぎょうひ	営業費
えいぎょうじ	営業時
えいぎょうか	営業課
えいきょうど	影響度
えいきょうか	影響下
えいきゅうし	永久歯
えいがぶもん	映画部門
えいがじたい	映画自体
えいがしょう	映画賞
えいがざっし	映画雑誌
えいがさっか	映画作家
えいがかけん	映画化権
えいかんたい	英艦隊
えいかくてき	鋭角的
えいおおもじ	英大文字
えいおうしつ	英王室
えいいちろう	栄一郎	英一郎
うんようよう	運用用
うんようめん	運用面
うんようほう	運用法
うんようてき	運用的
うんようせい	運用性
うんようすう	運用数
うんようしゃ	運用者
うんようえき	運用益
うんゆしょう	運輸省
うんゆぎいん	運輸議員
うんもじょう	雲母状
うんめいろん	運命論
うんめいてき	運命的
うんぷてんぷ	運否天賦
うんぱんよう	運搬用
うんどんこん	運鈍根
うんどうのう	運動能
うんどうたい	運動体
うんどうせい	運動性
うんどうこう	運動項
うんどうぐつ	運動靴
うんどうがわ	運動側
うんどうがく	運動学
うんどうかく	運動覚
うんどうかい	運動会
うんどういん	運動員
うんでいのさ	雲泥の差
うんてんれき	運転歴
うんてんよう	運転用
うんてんほう	運転法
うんてんだい	運転台
うんてんせき	運転席
うんてんじき	運転時期
うんてんしゅ	運転手
うんてんしゃ	運転者
うんてんしつ	運転室
うんてんかい	運転会
うんちんめん	運賃面
うんちんぶん	運賃分
うんちんばこ	運賃箱
うんちんせい	運賃制
うんそうにん	運送人
うんそうてん	運送店
うんぜんだけ	雲仙岳
うんこうよう	運行用
うんげいせん	雲芸線
うんえいよう	運営用
うんえいもと	運営元
うんえいしゃ	運営者
うんえいしつ	運営室
うんえいがわ	運営側
うわぶたしき	上蓋式
うわてひねり	上手捻り
うわてだしな	上手出し投
うわぢょうし	上調子
うわちょうし	上調子
うわさばなし	噂話
うわくちびる	上唇
うわきちゅう	浮気中
うわきしょう	浮気性
うわきごころ	浮気心
うれしなみだ	嬉し涙
うれしがらせ	嬉しがらせ
うるめいわし	潤目鰯
うるうびょう	閏秒
うりょうけい	雨量計
うりざねがお	瓜実顔
うりかけきん	売掛金
うりあげだか	売上高
うりあげぞう	売上増
うりあげぜい	売上税
うりあげきん	売上金
うりあげがく	売上額
うらわみなみ	浦和南
うらわざてき	裏技的
うらやすかん	浦安間
うらびょうし	裏表紙
うらばんだい	裏磐梯
うらばんぐみ	裏番組
うらはいけい	裏背景
うらとりひき	裏取引
うらせってい	裏設定
うらじじょう	裏事情
うらしゃかい	裏社会
うらしまそう	浦島草
うらこうさく	裏工作
うらぎりもの	裏切者	裏切り者
うらがきにん	裏書人
うらかいどう	裏街道
うらおくみの	裏奥美濃
うもうふとん	羽毛布団
うめわかべや	梅若部屋
うめづしゃこ	梅津車庫
うめだしてん	梅田支店
うめこぶちゃ	梅昆布茶
うめがえもち	梅枝餅
うみしばうら	海芝浦
うみいちめん	海一面
うまづらはぎ	馬面剥
うべこうさん	宇部興産
うぶすながみ	産土神
うばすてやま	姨捨山
うなずきかえ	頷き返
うなぎのぼり	うなぎ登り	うなぎ上り	鰻登り	鰻上り
うどじんぐう	鵜戸神宮
うでたてふせ	腕立伏せ	腕立て伏せ
うてきかんち	雨滴感知
うつりかわり	移り変わり
うつのみやし	宇都宮市
うっとうしい	欝陶しい	鬱陶しい
うったえかた	訴え方
うっこんこう	鬱金香
うっかりもの	うっかり者
うちわばなし	内輪話
うちわけしょ	内訳書
うちょくじこ	右直事故
うちょうてん	有頂天
うちゅうろん	宇宙論
うちゅうれき	宇宙暦	宇宙歴
うちゅうよう	宇宙用
うちゅうべん	右中弁
うちゅうふく	宇宙服
うちゅうとし	宇宙都市
うちゅうてい	宇宙挺
うちゅうせん	宇宙船	宇宙線	宇宙戦
うちゅうじん	宇宙人	宇宙塵
うちゅうこう	宇宙項
うちゅうけん	宇宙研
うちゅうきぼ	宇宙規模
うちゅうきち	宇宙基地
うちゅうがく	宇宙学
うちゅうかん	右中間	宇宙観
うちゅういち	宇宙一
うちぽけっと	内ポケット
うちぼうせん	内房線
うちべんけい	内弁慶
うちひょうじ	内表示
うちなかはら	内中原
うちさぶらい	内侍
うちさいわい	内幸
うちげんかん	内玄関
うだてんのう	宇多天皇
うたばんぐみ	歌番組
うたぐりぶか	疑り深
うたがっせん	歌合戦
うたいもんく	謳文句	歌文句	謡い文句
うぞうむぞう	有象無象
うぜんちとせ	羽前千歳
うせつさせつ	右折左折
うすらわらい	薄ら笑い
うすももいろ	薄桃色
うすむらさき	薄紫
うすべにいろ	薄紅色
うすはないろ	薄花色
うすちゃいろ	薄茶色
うすずみがみ	薄墨紙
うすずみいろ	薄墨色
うすざいしき	薄彩色
うすこうばい	薄紅梅
うすげしょう	薄化粧
うすくれない	薄紅
うすくらがり	薄暗がり
うすきみわる	薄気味悪
うすいとうげ	碓氷峠
うすあきない	薄商い
うすあおいろ	薄青色
うじすじょう	氏素性	氏素姓
うじきんとき	宇治金時
うしんふぜん	右心不全
うしわかまる	牛若丸
うしろすがた	後ろ姿	後姿
うしろあわせ	後ろ合せ
うしょうべん	右少弁
うしおでんき	ウシオ電機
うしおだけん	潮田研
うさんくさい	胡散臭い
うさせつしゃ	右左折車
うさぎだいら	兎平
うけとりにん	受取人
うけとりがわ	受取側	受け取り側
うけとりかた	受け取り方
うけおいにん	請負人
うぐいすもち	鶯餅
うぐいすぶえ	鶯笛
うぐいすばり	鶯張り
うぐいすちゃ	鶯茶
うぐいすだに	鴬谷
うぐいすざわ	鴬沢	鶯沢
うぐいすいろ	鶯色
うきせいこう	雨奇晴好
うきさんばし	浮桟橋
うきくさるい	浮草類
うがいぐすり	うがい薬	嗽薬
うかとうせん	羽化登仙
うかがいしょ	伺い書
うかいろせん	迂回路線
うかいくかん	迂回区間
うおじょうゆ	魚醤油
うおうさおう	右往左往
うえやじるし	上矢印
うえほんまち	上本町
うえほうこう	上方向
うえはんぶん	上半分
うえはらせい	上原成
うえのちゃく	上野着
うえさんかく	上三角
ううろんちゃ	烏龍茶
ういむじょう	有為無常
ういてんぺん	有為転変
ういういしい	初々しい
うーろんちゃ	ウーロン茶	烏龍茶
いんようれい	引用例
いんようもと	引用元
いんようぶん	引用文
いんようふか	引用不可
いんようすい	飲用水
いんようしょ	引用書
いんようきじ	引用記事
いんぼうろん	陰謀論
いんぼうせつ	陰謀説
いんぺいかん	隠蔽艦
いんのしょう	院庄
いんにゅうし	院入試
いんどこうろ	インド航路
いんとくざい	隠匿罪
いんとうえん	咽頭炎
いんたいまえ	引退前
いんたいせつ	引退説
いんたいしき	引退式
いんそつしゃ	引率者
いんせいしつ	院生室
いんすうれつ	引数列
いんじみつど	印字密度
いんじのうど	印字濃度
いんじどうさ	印字動作
いんじそくど	印字速度
いんじけっか	印字結果
いんじかのう	印字可能
いんしょうは	印象派
いんしょうど	印象度
いんしょうづ	印象付
いんしゅりつ	飲酒率
いんしゅふか	飲酒不可
いんさつよう	印刷用
いんさつもじ	印刷文字
いんさつぶつ	印刷物
いんさつだい	印刷代
いんさつたい	印刷体
いんさつじょ	印刷所
いんさつしょ	印刷所
いんさつしつ	印刷室
いんさついち	印刷位置
いんげんまめ	隠元豆
いんぐらんど	英蘭
いんがじょう	印画上
いんかんすう	陰関数
いわにちせん	岩日線
いわなみやく	岩波訳
いわなみばん	岩波版
いわなみえき	岩波駅
いわないこう	岩内港
いわとくせん	岩徳線
いわたしがい	磐田市街
いわずもがな	言わずもがな
いわしたしま	岩下志麻
いわうめもく	Diapensiales	イワウメ目
いろほうしき	色方式
いろぶんかい	色分解
いろふごうか	色符号化
いろひょうじ	色表示
いろばんごう	色番号
いろはんてん	色反転
いろとりどり	色取り取り
いろたいおう	色対応
いろしんごう	色信号
いろさいげん	色再現
いろこいざた	色恋沙汰
いろくうかん	色空間
いろかんけい	色関係
いろえんぴつ	色鉛筆
いれこみすう	入込数
いれかえよう	入換用
いれかえせん	入替戦
いりょうよう	医療用
いりょうみす	医療ミス
いりょうほう	医療法
いりょうひん	医療品	衣料品
いりょうせん	医療船
いりょうじこ	医療事故
いりょうきぐ	医療器具
いりょうきき	医療機器
いりょうかご	医療過誤
いりゅうぶん	遺留分
いりゅうひん	遺留品
いりぐちわき	入口脇
いりぐちがわ	入口側
いりかさやま	入笠山
いりうちじま	入内島
いりあいけん	入会権
いらこみさき	伊良湖岬
いらくさもく	イラクサ目	Urticales
いらいちゅう	依頼中
いらいじょう	依頼状
いよてつどう	伊予鉄道
いよぎんこう	伊豫銀行
いようがぞう	医用画像
いもようかん	芋羊羹
いもづるしき	芋蔓式	芋づる式
いもうとやく	妹役
いみんきょく	移民局
いみろんてき	意味論的
いみめいはく	意味明白
いみないよう	意味内容
いみこうぞう	意味構造
いみきじゅつ	意味記述
いみかんすう	意味関数
いみかいせき	意味解析
いまよういろ	今様色
いましばらく	今暫く
いまげんざい	今現在
いまがわやき	今川焼
いまいちばん	今一番
いまいじょう	今以上
いほうこうい	違法行為
いほうきょく	違法局
いべんとれつ	イベント列
いぶせますじ	井伏鱒二
いぶすきせん	指宿線
いばらももく	イバラモ目	Najadales
いばらのみち	茨の道
いばらぎてん	茨木店
いばらぎけん	茨城県
いばらぎえき	茨木駅
いばらきべん	茨城弁
いばらきてん	茨木店
いばらきけん	茨城県
いばしんえん	意馬心猿
いはんじじつ	違反事実
いはんこうい	違反行為
いはんきっぷ	違反切符
いのちびろい	命拾い
いのししなべ	猪鍋
いのししどし	亥年
いぬやまばし	犬山橋
いぬぼうざき	犬吠埼
いぬぼうさき	犬吠崎	犬吠埼
いぬがみぐん	犬上郡
いにんとうち	委任統治
いにんじょう	委任状
いにんけいり	委任経理
いにゅうしゅ	移入種
いなわしろこ	猪苗代湖
いなりこうじ	稲荷小路
いどほうこう	緯度方向
いどちゃわん	井戸茶碗
いどうりょく	移動力
いどうりょう	移動量
いどうりゆう	移動理由
いどうほどう	移動歩道
いどうひょう	移動票
いどうはんい	移動範囲
いどうどうぎ	移動動議
いどうとどけ	異動届
いどうちゅう	移動中
いどうそくど	移動速度
いどうそうち	移動装置
いどうそうさ	移動操作
いどうじかん	移動時間
いどうきろく	移動記録
いどうきょり	移動距離
いどうきょく	移動局
いどうきゃく	移動客
いどうかのう	移動可能
いどうかいし	移動開始
いとよりだい	糸縒鯛
いとまんせん	糸満線
いとひきあじ	糸引鰺
いとのこぎり	糸鋸
いとうちゅう	伊藤忠
いといがわし	糸魚川市
いでんびょう	遺伝病
いでんしてき	遺伝子的
いでんしげん	遺伝資源
いでんしきき	遺伝子危機
いでんしがく	遺伝子学
いてんとうき	移転登記
いつまでぐさ	常春藤
いつちょうら	一張羅
いっぽんやり	一本槍
いっぽんみち	一本道
いっぽんまつ	一本松
いっぽんぶん	一本分
いっぽんばし	一本橋
いっぽんづり	一本釣り
いっぽんだち	一本立ち
いっぽんせん	一本線
いっぽんすじ	一本筋
いっぽんすぎ	一本杉
いっぽんざし	一本差し
いっぽんあし	一本足
いっぽてまえ	一歩手前
いっぽうてき	一方的
いっぺんとう	一辺倒
いっぺいそつ	一兵卒
いっぷんかん	一分間
いっぷたさい	一夫多妻
いっぷいっぷ	一夫一婦
いっぱんろん	一般論
いっぱんよう	一般用
いっぱんめい	一般名
いっぱんむき	一般向
いっぱんほう	一般法
いっぱんふか	一般不可
いっぱんどう	一般道
いっぱんてん	一般店
いっぱんてき	一般的
いっぱんだい	一般台
いっぱんそく	一般則
いっぱんせい	一般性
いっぱんじん	一般人
いっぱんじむ	一般事務
いっぱんしょ	一般書
いっぱんしゃ	一般車
いっぱんざい	一般材
いっぱんこう	一般項
いっぱんけい	一般型	一般形
いっぱんかく	一般角
いっぱんかい	一般解
いっぱんうけ	一般受け	一般受
いっぱんいし	一般意思
いっぱつどり	一発録り
いっぱつだい	一発台
いっぱつげい	一発芸
いっぱいほど	一杯程
いっぱいぶん	一杯分
いっとりうむ	Y	Yttrium
いっとうぼり	一刀彫り
いっとうへい	一等兵
いっとうそつ	一等卒
いっとうそく	一投足
いっとうせい	一等星
いっとうしん	一等親
いっとうさい	一刀斉
いっとうこく	一等国
いってんばり	一点張り
いっていりつ	一定率
いっていはば	一定幅
いっていすう	一定数
いっていがく	一定額
いっていかく	一定角
いっていいか	一定以下
いっちょまえ	一丁前
いっちょうら	一張羅
いっちょうめ	１丁目	一丁目
いっちゅうや	一昼夜
いっちしすう	一致指数
いったいなに	一体何
いったいなぜ	一体何故
いったいてき	一体的
いったいだれ	一体誰
いったいしき	一体式
いったいけい	一体形
いったいがた	一体型
いったいかん	一体感
いったいいち	一対一
いっそくとび	一足飛び
いっそうおい	一層美味
いっせんまん	一千万
いっせんねん	一千年
いっせきがん	一隻眼
いっせいどう	一誠堂
いっすんさき	一寸先
いっしんろん	一神論
いっしんとう	一親等
いっしょくた	一緒くた
いっしゅるい	一種類
いっしゅうめ	一周目	一週目
いっしゅうき	一周期	一周忌
いっしゃせん	一車線
いっさつぶん	一冊分
いっさくばん	一昨晩
いっさくねん	一昨年
いっさくじつ	一昨日
いっさいむし	一切無視
いっさいてん	一斎点
いっさいたふ	一妻多夫
いっこんぞめ	一斤染
いっこくもの	一刻者
いっけんやど	一軒宿
いっけんしき	一見識
いっきょしゅ	一挙手
いっきょくめ	一曲目
いっきかせい	一気呵成
いっかんぼん	一巻本
いっかんせい	一貫性
いっかりさん	一家離散
いっかつほう	一括法
いっかいぶん	一回分
いっかいてん	一回転
いっかいせん	一回戦	一回線
いっかいせき	一階席
いっかいせい	一回性
いっかいごと	一回毎
いちわりびき	一割引
いちろなんか	一路南下
いちるいしゅ	一塁手
いちるいがわ	一塁側
いちりんしゃ	一輪車
いちりんざし	一輪挿し
いちりゅうば	一流馬
いちらんせい	一卵性
いちようせい	一様性
いちょうやく	胃腸薬
いちょうこう	イチョウ綱	Ginkgopsida
いちょうぎり	銀杏切り
いちょうかん	胃腸管
いちやじょう	一夜城
いちもんふち	一文不知
いちもんなし	一文無し
いちもくさん	一目散
いちもうさく	一毛作
いちめんてき	一面的
いちめんしき	一面識
いちめいれい	一命令
いちみととう	一味徒党
いちまんまい	一万枚
いちまんえん	一万円	壱万円	壱萬圓	1万円
いちまいぶん	一枚分
いちまいした	一枚下
いちまいいわ	一枚岩
いちまいいた	一枚板
いちほうほう	一方法
いちほうこう	一方向
いちへんせい	一編成
いちへんすう	1変数	一変数	位置変数
いちぶんせつ	一文節
いちぶりゃく	一部略
いちぶほけん	一部保険
いちぶふっき	一部復帰
いちぶついか	一部追加
いちぶちいき	一部地域
いちぶしよう	一部仕様
いちぶくかん	一部区間
いちぶきしゅ	一部機種
いちばんらく	一番楽
いちばんやり	一番槍
いちばんみぎ	一番右
いちばんまえ	一番前
いちばんぼし	一番星
いちばんはし	一番端
いちばんのり	一番乗り	一番乗
いちばんどり	一番鶏
いちばんとく	一番得
いちばんでし	一番弟子
いちばんちか	一番近
いちばんそと	一番外
いちばんそこ	一番底
いちばんした	一番下
いちばんさき	一番先
いちばんぐみ	一番組
いちばんかん	壱番館	一番艦
いちばんおく	一番奥
いちばんうえ	一番上
いちばんいや	一番嫌
いちばいはん	一倍半
いちのつかさ	市司
いちのちょう	一の町
いちねんまえ	一年前
いちねんほど	一年程
いちねんぶん	一年分
いちねんはん	一年半
いちねんそう	一年草
いちねんせい	一年生
いちねんかん	1年間	一年間
いちねんいか	一年以下
いちにんまえ	一人前
いちにんしゃ	一人者
いちにちぶん	一日分
いちにちけん	一日券
いちどていど	一度程度
いちどくらい	一度位
いちとくせい	一特性
いちだんらく	一段落
いちだんやす	一段安
いちだんだか	一段高
いちだんした	一段下
いちだんかい	一段階
いちだんうえ	一段上
いちだいぶん	一台分
いちだいがく	一大学
いちたいいち	一対一	1対1
いちそくめん	一側面
いちせいぶん	一成分
いちせいぶつ	一生物
いちせいぎょ	位置制御
いちじんぶつ	一人物
いちじんえい	一陣営
いちじわだい	一時話題
いちじよせん	一次予選
いちじょせい	一女性
いちじょうじ	一条寺	一乗寺
いちじゅんめ	一巡目
いちじもくぶ	一次木部
いちじみゃく	一次脈
いちじほぞん	一時保存
いちじぶんぷ	一次分布
いちじばらい	一時払い
いちじのがれ	一時逃れ
いちじねっと	一次ネット
いちじていし	一時停止
いちじしのぎ	一時凌ぎ
いちじしけん	一次試験
いちじきんじ	一次近似
いちじきこく	一時帰国
いちじかんめ	一時間目
いちじかんご	一時間後
いちじかいこ	一時解雇
いちじおくれ	一次遅れ
いちじいっく	一字一句
いちしゅほう	一手法
いちしゅぞく	一種族
いちざひょう	位置座標
いちごうとう	一号棟
いちごうてん	一号店
いちごうせん	一号線
いちごうかん	一号館
いちごいちえ	一期一会
いちこくみん	一国民
いちこうもく	一項目
いちこうさつ	一考察
いちげんろん	一元論
いちげんてき	一元的
いちげんせい	一元性
いちげんこじ	一言居士
いちげんきん	一弦琴
いちけんとう	一検討
いちけんしき	一見識
いちけってい	位置決定
いちけいとう	一系統
いちけいたい	一形態
いちけいさん	位置計算
いちぎょうめ	一行目
いちきじゅん	位置基準
いちがんれふ	一眼レフ
いちがつまえ	一月前
いちがつごう	1月号
いちがくねん	1学年
いちがくせい	一学生
いちかんたい	一艦隊
いちかんそく	位置観測
いちかんけい	位置関係
いちかくにん	位置確認
いちかいそう	一階層
いちかいいん	一会員
いちおんせつ	一音節
いちおくにん	一億人
いちおくえん	一億円
いちおうふく	一往復
いちえんだま	一円玉
いちいんせい	一院制
いちいしめい	一位指名
いちいこうほ	一位候補
いだしぐるま	出車
いたんぶんし	異端分子
いたんちょう	イ短調
いたんかがく	異端科学
いたやとうげ	板谷峠
いたびょうし	板表紙
いただきもの	戴き物	頂き物
いただきます	戴きます
いたずらっこ	悪戯っ子
いたしんどう	板振動
いたしかゆし	痛し痒し
いたくりょう	委託料
いたきそえき	伊太祁曽駅
いぞんしょう	依存症
いそんしょう	依存症
いそまつもく	Plumbaginales	イソマツ目
いそていえん	磯庭園
いそうぶんぷ	位相分布
いそうそくど	位相速度
いぜんわだい	以前話題
いせほうめん	伊勢方面
いせのたゆう	伊勢大輔
いせなかがわ	伊勢中川
いせてつどう	伊勢鉄道
いせつこうじ	移設工事
いせじんぐう	伊勢神宮
いせざきせん	伊勢佐木線	伊勢崎線
いせざきかん	伊勢崎間
いせきりょう	移籍料
いせきばなし	移籍話
いせきのうき	井関農機
いずものくに	出雲国
いずもしんわ	出雲神話
いずみしきぶ	和泉式部
いずみがたけ	泉ヶ岳
いずみがおか	泉ヶ丘
いずみおおつ	泉大津
いずほうめん	伊豆方面
いずはんとう	伊豆半島
いずながおか	伊豆長岡
いずしょとう	伊豆諸島
いずこうげん	伊豆高原
いずけいとう	伊豆系統
いすらむれき	イスラム暦
いすらむほう	イスラム法
いすみぐんし	夷隅郡市
いすこうげき	椅子攻撃
いじょうせい	異常性
いじょうしゃ	異常者
いじょうけい	異常系
いじゅうしゃ	移住者
いじゅうけん	居住権
いじゅういん	伊集院
いじふくせい	維持複製
いしょくぶつ	移植物
いしょくばん	移植版
いしょくせい	移植性
いしょくすう	移植数
いしょくしゃ	移植者
いしょくさく	異色作
いしょうほう	意匠法
いしょうてき	意匠的
いしょうけん	意匠権
いしょうがえ	衣装替
いしゅこうさ	異種交差
いしゅがえし	意趣返し
いしやまでら	石山寺
いしやまざか	石山坂
いしやきいも	石焼芋	石焼き芋
いしゃりょう	慰謝料
いしめんきょ	医師免許
いしまつえき	石松駅
いしひょうじ	意志表示	意思表示
いしばしかん	石橋間
いしばしえき	石橋駅
いしのまきし	石巻市
いしとうろう	石燈篭
いしでんたつ	意思伝達
いしだりゅう	石田流
いししゅたい	意思主体
いしざきがわ	石崎川
いしざかせん	石坂線
いしこしえき	石越駅
いしけってい	意志決定	意思決定
いしぐろけん	石黒賢
いしきふめい	意識不明
いしきじょう	意識上
いしきかてい	意識過程
いしがきじま	石垣島
いしかわだい	石川台
いしかわせん	石川線
いしかわじま	石川島
いしかわけん	石川県
いしかわえき	石川駅
いしかりなべ	石狩鍋
いしかりがわ	石狩川
いしうちやま	石打山
いさんどうき	遺産動機
いさはやわん	諫早湾
いごたいかい	囲碁大会
いこんじあい	遺恨試合
いこうちゅう	移行中
いこうきかん	移行期間
いけんしんぎ	違憲審議
いけんこうい	違憲行為
いけだりよこ	池田理代子
いけだちょう	池田町
いけしょうじ	池庄司
いけがみせん	池上線
いけいのねん	畏敬の念
いけいちょう	衣掛町
いくゆうかい	育友会
いくもうざい	育毛剤
いくのとうげ	生野峠
いくどうおん	異口同音
いくとしつき	幾年月
いくせんまん	幾千万
いくせいそう	幾星霜
いくせいしょ	育成所
いくせいしゃ	育成者
いくじせいど	育児制度
いくしゅるい	幾種類
いくしゅがく	育種学
いくえいかい	育英会
いぎょうしゅ	異業種
いぎもうした	異議申立
いきようよう	意気揚揚	意気揚々
いきとうごう	意気投合
いきちしょり	閾値処理
いきしゅかん	異機種間
いきけんこう	意気軒昂
いがくようご	医学用語
いがくぶせい	医学部生
いがくはくし	医学博士
いがくはかせ	医学博士
いがくたちば	医学立場
いがくじょう	医学上
いがくじてん	医学事典
いがくじしょ	医学辞書
いがくざっし	医学雑誌
いかりがせき	碇ヶ関
いかほんぶん	以下本文
いかないよう	以下内容
いかどうよう	以下同様
いかどうぶん	以下同文
いかだいがく	医科大学
いかくちょう	胃拡張
いかくしょく	威嚇色
いかいんよう	以下引用
いおうしゅう	硫黄臭
いえんくかん	以遠区間
いいんどうし	委員同士
いいんちょう	委員長
いいもりやま	飯盛山
いいだしっぺ	言い出しっぺ
いいだくだく	唯々諾々	唯唯諾諾
いいあらそい	言い争い
いーじすかん	イージス艦
あんろくざん	安禄山
あんらくこく	安楽国
あんらくいす	安楽椅子
あんやこうろ	暗夜行路
あんもくてき	暗黙的
あんぼれらか	アンボレラ科	Amborellaceae
あんのじょう	案の定
あんなかかん	安中間
あんないよう	案内用
あんないやく	案内役
あんないもう	案内申
あんないぶん	案内文
あんないばん	案内板
あんないにん	案内人
あんないちず	案内地図
あんないじょ	案内所
あんないしょ	案内書
あんないしゃ	案内者
あんないきじ	案内記事
あんないいた	案内致
あんてんほう	鞍点法
あんていてん	安定点
あんていてき	安定的
あんていせい	安定性
あんていざい	安定剤
あんていかん	安定感
あんちょくか	安直過
あんそうおん	暗騒音
あんぜんりつ	安全率
あんぜんよう	安全用
あんぜんめん	安全面
あんぜんべん	安全弁
あんぜんぱい	安全牌
あんぜんとう	安全燈
あんぜんせい	安全性
あんぜんさく	安全策
あんぜんけん	安全研	安全圏
あんぜんぐつ	安全靴
あんぜんがわ	安全側
あんぜんいき	安全域
あんしんくだ	安心下
あんしんかん	安心感
あんしょうぶ	暗証部
あんしょうか	暗証化
あんししょく	暗紫色
あんざんがん	安山岩
あんさつしゃ	暗殺者
あんごうぶん	暗号文
あんころもち	餡ころ餅
あんこくめん	暗黒面
あんこくがい	暗黒街
あんこうなべ	鮟鱇鍋
あんこうがた	鮟鱇形
あんけんさつ	暗剣殺
あんきりょく	暗記力
あんきかもく	暗記科目
あわゆきそば	泡雪蕎麦
あわゆきかん	泡雪羹
あわびむすび	鮑結び
あわせかがみ	合わせ鏡	合せ鏡
あわせいれつ	泡整列
あわじちょう	淡路町
あわこうぞう	泡構造
あるみにうむ	Al	Aluminum
あるふぁばん	α版
あるふぁせん	α線
あるぜんちん	亞爾然丁
あるじもうけ	饗設け
あるかりせい	アルカリ性
ありゅうさん	亜硫酸
ありまきねん	有馬記念
ありしゃかい	蟻社会
ありあけばし	有明橋
ありあけせん	有明線
ありあけかい	有明海
ありーなせき	アリーナ席
あらわしかた	表し方
あらりょうち	荒療治
あらりょうじ	荒療治
あらびあもじ	アラビア文字
あらひとがみ	現人神
あらたまがわ	新田間川
あらそいごと	争い事
あらしがおか	嵐ヶ丘
あらくれもの	荒くれ者
あらきゆみこ	荒木由美子
あらかわだけ	荒川岳
あらかわせん	荒川線
あらかわおき	荒川沖
あらいじゅく	新井宿
あらいざらい	洗い浚い
あやまりりつ	誤り率
あやのこうじ	綾小路
あめりしうむ	Americium	Am
あめりかじん	アメリカ人
あめたいさく	雨対策
あみせつぞく	網接続
あみせいぎょ	網制御
あまみちほう	奄美地方
あまのじゃく	天の邪鬼	天邪鬼
あまのいわと	天の磐戸
あまなっとう	甘納豆
あまくさばん	天草版
あまぎとうげ	天城峠
あまがさきし	尼崎市
あまえんぼう	甘えん坊
あぼうとうげ	安房峠
あべこうぼう	安部公房
あべがくいん	安部学院
あべかわもち	安倍川餅
あぶらしょう	脂性
あぶらぐすり	脂薬	膏薬
あぶくまがわ	阿武隈川
あふりかぞう	アフリカ象
あびせたおし	浴びせ倒し
あばれんぼう	暴れん坊
あばしりえき	網走駅
あなたじしん	貴方自身
あとばんぐみ	後番組
あとのまつり	後の祭	後の祭り
あとすうねん	後数年
あとこうてい	後工程
あとかたづけ	後かたづけ	後片付け	後片付
あてないんじ	宛名印字
あてずっぽう	当てずっぽう
あてさきめい	宛先名
あてさきにん	宛先人
あづちじょう	安土城
あづかりきん	預かり金
あつりょくは	圧力波
あつりょくさ	圧力差
あつりょくか	圧力下
あつらえむき	誂え向き
あつもりそう	敦盛草
あつみちょう	渥美町
あつへいこお	圧平衡
あつでんたい	圧電体
あつでんざい	圧電材
あつさしのぎ	暑さ凌ぎ
あつげしょう	厚化粧
あつぎしない	厚木市内
あつぎいえん	厚木以遠
あつがましき	厚釜式
あつかいてん	扱店
あつかいだか	扱い高
あつかいさき	扱先
あつかいかた	扱い方
あっぱくかん	圧迫感
あっとうてき	圧到的	圧倒的
あっちゃくぶ	圧着部
あっせつしゃ	圧雪車
あっしゅくひ	圧縮比
あっしゅくど	圧縮度
あっしゅくご	圧縮後
あっしゅくき	圧縮機
あっきらせつ	悪鬼羅刹
あっかんども	悪漢共
あだっきゅう	亜脱臼
あだたらやま	阿達太良山	安達太良山
あたりさわり	当たり障り	当り障り
あたまごなし	頭ごなし
あたまいがい	頭以外
あたいひょう	値表
あたいていぎ	値定義
あそびどうぐ	遊び道具
あそびごころ	遊び心
あそびぐるま	遊び車
あそびあいて	遊び相手
あずまかがみ	吾妻鏡	東鑑
あずかりもの	預かり物
あずかりしょ	預かり所
あずかりきん	預かり金	預り金
あすかぶんか	飛鳥文化
あすかじだい	飛鳥時代
あすあさって	明日明後日
あじつけのり	味付け海苔
あしょうさん	亜硝酸
あしゅらぞう	阿修羅像
あしびょうし	足拍子
あしだひとし	芦田均
あしぞこばん	足底板
あしごしらえ	足拵え
あしがらしも	足柄下
あしがらかみ	足柄上
あしがらえき	足柄駅
あさめしまえ	朝飯前
あさみなみく	安佐南区
あさほうそう	朝放送
あさひるばん	朝昼晩
あさひぶんこ	朝日文庫
あさひびーる	朝日麦酒
あさひちょう	朝日町
あさひがらす	旭硝子
あさひがおか	朝日ヶ丘	旭ケ丘	旭が丘	旭ヶ丘
あさひかわし	旭川市
あさひかせい	旭化成
あさだみよこ	浅田美代子
あさだあきら	浅田彰
あさくらえき	朝倉駅
あさくさばし	浅草橋
あさくさのり	浅草海苔
あさくさせん	浅草線
あさくさえき	浅草駅
あさがおいち	朝顔市
あさいちばん	朝一番
あこうそくか	亜光速下
あげはちょう	揚羽蝶
あげくのはて	挙句の果て	挙げ句の果て
あげあしとり	揚げ足取り
あけぼのばし	曙橋
あけぼのいろ	曙色
あくりるせい	アクリル製
あくめいたか	悪名高
あくまじょう	悪魔城
あくはつとほ	握髪吐哺
あくてんこう	悪天候
あくちにうむ	Actinium	Ac
あくだまきん	悪玉菌
あくだいかん	悪代官
あくせすすう	アクセス数
あくしゅけん	握手券
あくしゅかい	握手会
あくえきしつ	悪液質
あきれすけん	アキレス腱
あきよしだい	秋吉台
あきゅうせい	亜急性
あきないぐち	商い口
あきたこまち	秋田小町
あきしょせん	秋初戦
あきしのでら	秋篠寺
あがりがまち	上がり框
あかんちょう	阿寒町
あかむらさき	赤紫
あかふじょう	赤不浄
あかぴーまん	赤ピーマン
あかびょうし	赤表紙
あかばねせん	赤羽線
あかばねえき	赤羽駅
あかのひろば	赤の広場
あかにんじゃ	赤忍者
あかつめくさ	赤詰草
あかちゃいろ	赤茶色
あかたにせん	赤谷線
あかじろせん	赤字路線
あかじかくご	赤字覚悟
あかしんぶん	赤新聞
あかしんごう	赤信号
あかさかえき	赤坂駅
あかげわしゅ	褐毛和種
あかけいとう	赤系統
あかぎちょう	赤城町
あかいわぐん	赤磐郡
あかいわえき	赤岩駅
あかいでんき	赤井電機
あかいしだけ	赤石岳
あかいけえき	赤池駅
あおやまぼち	青山墓地
あおやません	青山線
あおもりはつ	青森発
あおもりけん	青森県
あおもりえき	青森駅
あおむらさき	青紫
あおびょうし	青標紙	青表紙
あおばどおり	青葉通
あおばじょう	青葉城
あおばしょう	青葉賞
あおどうしん	青道心
あおとつうか	青砥通過
あおじゃしん	青写真
あおしんごう	青信号
あおけいとう	青系統
あおきがはら	青木ヶ原
あおきいさお	青木功
あおがくだい	青学大
あおいまつり	葵祭
あおいのうえ	葵上
あいろんだい	アイロン台
あいるらんど	愛蘭
あいようしゃ	愛用者
あいみるちゃ	藍海松茶
あいみつもり	合い見積もり
あいみたがい	相身互い
あいまいもこ	曖昧模糊
あいまいせい	曖昧性
あいべつりく	愛別離苦
あいのみなこ	愛野美奈子
あいのちょう	愛野町
あいどくしょ	愛読書
あいどくしゃ	愛読者
あいてりきし	相手力士
あいてだしゃ	相手打者
あいてせいふ	相手政府
あいてしだい	相手次第
あいてきょく	相手局
あいづたじま	会津田島
あいづたかだ	会津高田
あいちいだい	愛知医大
あいだちょう	英田町
あいだじゅう	間中
あいぞうばん	愛蔵版
あいぞうげき	愛憎劇
あいそわらい	愛想笑い
あいそづかし	愛想尽かし
あいしょうか	愛唱歌
あいさつがわ	挨拶代
あいさいごう	愛妻号
あいこくしん	愛国心
あいこうぼん	愛好本
あいこうしん	愛校心
あいこうしゃ	愛好者
あいこうかい	愛好会
あいがんけん	愛玩犬
あいかわらず	相変わらず
あいいちろう	愛一郎
あいあいがさ	相合い傘	相合傘
おんみょうどう	陰陽道
おんぷふごうか	音符符号化
おんぴょうもじ	音標文字
おんなべんじょ	女便所
おんなべんごし	女弁護士
おんなともだち	女友達
おんなだいがく	女大学
おんなそうばし	女相場師
おんなじょたい	女所帯
おんなしゅじん	女主人
おんなしゃかい	女社会
おんなざちょう	女座長
おんなげいしゃ	女芸者
おんなかんけい	女関係
おんどやくそう	温度躍層
おんどほしょう	温度補償
おんどせってい	温度設定
おんどこうばい	温度勾配
おんどかんかく	温度感覚
おんとろうろう	音吐朗朗
おんたいしょう	御大将
おんぞうていい	音像定位
おんぞうきょり	音像距離
おんそくひこう	音速飛行
おんせんたまご	温泉卵
おんせんじるし	温泉印
おんせつちょう	音節長
おんせいりかい	音声理解
おんせいぶぶん	音声部分
おんせいはけい	音声波形
おんせいちかく	音声知覚
おんせいしょり	音声処理
おんせいげんご	音声言語
おんせいくかん	音声区間
おんせいきごう	音声記号
おんすいぷーる	温水プール
おんじょうない	音場内
おんじょうけん	音情研
おんじょうかん	音場感
おんしんふつう	音信不通
おんしょくめい	音色名
おんしょくすう	音色数
おんしょうかた	恩賞方
おんしつれっか	音質劣化
おんしつどけい	温湿度計
おんしつそだち	温室育ち
おんしつこうか	温室効果
おんげんぶぶん	音源部分
おんげんはいち	音源配置
おんげんいがい	音源以外
おんぎみしょう	音義未詳
おんきょうふか	音響負荷
おんきょうてき	音響的
おんきょうけん	音響研
おんきょうけい	音響系
おんきょうきき	音響機器
おんきょうがく	音響学
おんきょうかん	音響管
おんがくろんぎ	音楽論議
おんがくりろん	音楽理論
おんがくりかい	音楽理解
おんがくようご	音楽用語
おんがくぶんか	音楽文化
おんがくびがく	音楽美学
おんがくばたけ	音楽畑
おんがくのとも	音楽之友	音樂之友
おんがくにんち	音楽認知
おんがくづくり	音楽作り
おんがくちかく	音楽知覚
おんがくずかん	音楽図鑑
おんがくじてん	音楽辞典
おんがくじたい	音楽自体
おんがくしょり	音楽処理
おんがくしょう	音楽賞
おんがくしゅう	音楽集
おんがくしこう	音楽指向
おんがくざっし	音楽雑誌
おんがくがくぶ	音楽学部
おんがくえいが	音楽映画
おんがくいがい	音楽以外
おんいんへんか	音韻変化
おんいんたんい	音韻単位
おんいんじょう	音韻上
おんあつれべる	音圧レベル
おんあつへんか	音圧変化
おんあつぶんぷ	音圧分布
おんあつけいど	音圧傾度
おわりもりおか	尾張盛岡
おろしうりてん	卸売店
おりくちしのぶ	折口信夫
おりかえしてん	折り返し点
およばずながら	及ばず乍ら
おやぶんこぶん	親分子分
おやこかんけい	親子関係
おやきょうだい	親兄弟
おやきゅうだん	親球団
おもみけいすう	重み係数
おもてろっこう	表六甲
おもてさんどう	表参道
おもてげんかん	表玄関
おもてかんばん	表看板
おもいでばなし	思い出話
おめいばんかい	汚名挽回
おまつりさわぎ	御祭騒ぎ
おまえざきおき	御前崎沖
おびぎょうれつ	帯行列
おばまおんせん	小浜温泉
おはなしちゅう	お話中
おののたかむら	小野篁
おのだせめんと	小野田セメント
おとりはからい	お取り計らい
おとりあつかい	お取り扱い
おとなせんよう	大人専用
おとなけいかく	大人計画
おとじょうほう	音情報
おとしなちょう	音更町
おとこみょうり	男冥利
おとこべんじょ	男便所
おとこともだち	男友達
おとこじょたい	男所帯
おとこしゃかい	男社会
おとこげいしゃ	男芸者
おとこかんけい	男関係
おとけんしゅつ	音検出
おてんとうさま	お天道様
おづやすじろう	小津安二郎
おっとりがたな	押っ取り刀
おちょうしもの	お調子者
おちゃづけのり	御茶漬海苔
おだわらじょう	小田原城
おだきゅうせん	小田急線
おだうらくさい	織田有楽斎
おたんじょうび	お誕生日
おたまじゃくし	蝌蚪	御玉杓子
おせんぶっしつ	汚染物質
おすいしょりき	汚水処理機
おしょくじけん	汚職事件	お食事券
おしょくぎいん	汚職議員
おしまはんとう	渡島半島
おざきなおみち	尾崎直道
おざきこうよう	尾崎紅葉
おさらぎじろう	大仏次郎
おさなともだち	幼友達
おさないみえこ	小山内美江子
おさきまっくら	御先真っ暗
おごおりちょう	小郡町
おこっぺちょう	興部町
おくみのちほう	奥美濃地方
おくびょうもの	臆病者
おくびょうかぜ	臆病風
おくひえいがわ	奥比叡側
おくのほそみち	奥の細道
おくないぷーる	屋内プール
おくないしせつ	屋内施設
おくじょちゅう	奥女中
おくじょうおく	屋上屋
おぎゅうそらい	荻生徂徠
おぎのめようこ	荻野目洋子
おぎくぼししゃ	荻窪支社
おきのとりしま	沖ノ鳥島
おきこうぎょう	沖工業
おがたこうりん	尾形光琳
おかやまひがし	岡山東
おかやまちほう	岡山地方
おかやまじょう	岡山城
おかもとあやこ	岡本綾子
おかめはちもく	傍目八目
おかだけいすけ	岡田啓介
おかざわちょう	岡沢町
おかがきちょう	岡垣町
おおわだちょう	大和田町
おおやまちょう	大山町
おおものかしゅ	大物歌手
おおもときょう	大本教
おおもじこもじ	大文字小文字
おおもじえいじ	大文字英字
おおむらいなん	大村以南
おおみやちょう	大宮町
おおみなとせん	大湊線
おおまんどころ	大政所
おおまみゅうだ	大豆生田
おおまがりせん	大曲線
おおまがりかん	大曲間
おおふなとせん	大船渡線
おおひらちょう	大平町
おおひとちょう	大仁町
おおばんぶるま	大盤振る舞	大盤振舞
おおばかやろう	大馬鹿野郎
おおはばねびき	大幅値引き
おおのやすまろ	太安万侶
おおとのごもり	大殿籠り
おおてんじょう	大天井
おおてみんてつ	大手民鉄
おおてとしぎん	大手都市銀
おおてしんぶん	大手新聞
おおてしょてん	大手書店
おおてきぎょう	大手企業
おおつかあきら	大塚明
おおたちまわり	大立ち回り	大立回り
おおたけしのぶ	大竹しのぶ
おおたがわばし	太田川橋
おおしまつむぎ	大島紬
おおしまちょう	大島町
おおさかみやげ	大阪土産
おおさかふりつ	大阪府立
おおさかふみん	大阪府民
おおさかふだい	大阪府大
おおさかふけい	大阪府警
おおさかばしょ	大阪場所
おおさかなんぶ	大阪南部
おおさかなんば	大阪難波
おおさかちゃく	大阪着
おおさかちほう	大阪地方
おおさかそーだ	大阪曹達
おおさかじょう	大阪城
おおさかしない	大阪市内
おおさかしでん	大阪市電
おおさかしてん	大阪支店
おおさかしだい	大阪市大
おおさかししゃ	大阪支社
おおさかしこう	大阪市交
おおさかしがい	大阪市街
おおさかしえい	大阪市営
おおさかさやま	大阪狭山
おおさかうめだ	大阪梅田
おおさかいだい	大阪医大
おおさかいがい	大阪以外
おおくらしょう	大蔵省
おおくぼどおり	大久保通り
おおくちばかま	大口袴
おおきかいがん	大岐海岸
おおがたにりん	大型二輪
おおがたすうち	大型数値
おおがたじゅう	大型獣
おおがたじどう	大型自動
おおがたきかい	大型機械
おおがたかもつ	大型貨物
おおがきやこう	大垣夜行
おおかみおんな	狼女
おおかみおとこ	狼男
おおえのちさと	大江千里
おおえどはなび	大江戸花火
おおうほんせん	奥羽本線
おおうちどおり	大内通
おおいりぶくろ	大入袋
おおいまちせん	大井町線
おおいまちかん	大井町間
おおいたしない	大分市内
おうりょくこう	鴨緑江
おうりょうざい	横領罪
おうようりょく	応用力
おうようぶんや	応用分野
おうようぶつり	応用物理
おうようはんい	応用範囲
おうようでんし	応用電子
おうようすうり	応用数理
おうようじょう	応用上
おうようげんば	応用現場
おうようきのう	応用機能
おうようかがく	応用科学
おうめんきょう	凹面鏡
おうめとっかい	青梅特快
おうめかいどう	青梅街道
おうみはちまん	近江八幡
おうみてつどう	近江鉄道
おうぼようこう	応募要項
おうぼほうほう	応募方法
おうぼないよう	応募内容
おうぼそうすう	応募総数
おうぼしょるい	応募書類
おうぼしゃたち	応募者達
おうぼしめきり	応募締切
おうぼさくひん	応募作品
おうふくはがき	往復葉書
おうふくじかん	往復時間
おうふくきっぷ	往復切符
おうばんぶるま	椀飯振る舞	椀飯振舞
おうばくしゅう	黄檗宗
おうねつびょう	黄熱病
おうにんのらん	応仁の乱
おうどうらくど	王道楽土
おうとうちょう	応答長
おうとうそくど	応答速度
おうとうじかん	応答時間
おうちゃくもの	横着者
おうだんほどう	横断歩道
おうだんちゅう	横断中
おうだんきょう	横断橋
おうだんかのう	応談可能
おうせいふっこ	王政復古
おうせいこっか	王政国家
おうじょうけん	応用情報学研究センター	応情研
おうじょうぎわ	往生際
おうしょうせん	王将戦
おうしょうくん	王昭君
おうしょうぎむ	応召義務
おうしょうかい	王将会
おうしゅうばん	欧州版
おうしゅうなみ	欧州並
おうしゅうぜい	欧州勢
おうしゅうせい	欧州製
おうしゅうしゃ	欧州車
おうしゅうけい	欧州系
おうざぼうえい	王座防衛
おうざてんらく	王座転落
おうざだっしゅ	王座奪取
おうざだっかい	王座奪回
おうざけってい	王座決定
おうごんちゅう	黄金虫
おうごんじだい	黄金時代
おうごんきょう	黄金郷
おうこうきぞく	王侯貴族
おうこうかっぽ	横行闊歩
おうきゅうてき	応急的
おうきゅうそち	応急措置
おうからんまん	桜花爛漫
おうかっしょく	黄褐色
おうかしょうば	桜花賞馬
おうえんぶいん	応援部員
おいわけちょう	追分町
おいえそうどう	御家騒動
おーぷんかかく	オープン価格
おーすとらりあ	濠太剌利
えんりょねがい	遠慮願
えんらくちょう	猿楽町
えんめいこうじ	延命工事
えんまだいおう	閻魔大王
えんぺんたいざ	縁辺胎座
えんぶんのうど	塩分濃度
えんぱくかのう	延泊可能
えんばんじょう	円盤状
えんとうじょう	円筒状
えんちょくせん	鉛直線
えんちょうせん	延長戦	延長線
えんちゅうめん	円柱面
えんちくでんち	鉛蓄電池
えんたくかいぎ	円卓会議
えんたいりょう	延滞料
えんたいりそく	延滞利息
えんそうりょく	演奏力
えんそうふのう	演奏不能
えんそうちゅう	演奏中
えんそうじょう	演奏上
えんそうじたい	演奏自体
えんそうじかん	演奏時間
えんそうこうか	演奏効果
えんそうきょく	演奏曲
えんそうきかい	演奏機会
えんそうかのう	演奏可能
えんそうかいし	演奏開始
えんぜつしゅう	演説集
えんせんちいき	沿線地域
えんせんかくし	沿線各市
えんせいちゅう	遠征中
えんすいじょう	円錐状
えんじょぶっし	援助物資
えんしんりょく	遠心力
えんしんぶんり	遠心分離
えんしんぶぶん	延伸部分
えんしゅつめん	演出面
えんしゅつてき	演出的
えんしゅつしゃ	演出者
えんしゅついと	演出意図
えんしゅうりつ	円周率
えんしゅうべん	遠州弁
えんしゅうしょ	演習書
えんしゅうしつ	演習室
えんしゃっかん	円借款
えんざんりょう	演算量
えんざんそくど	演算速度
えんざんせいど	演算精度
えんざんじかん	演算時間
えんざんけっか	演算結果
えんざんきごう	演算記号
えんざんかいろ	演算回路
えんごしゃげき	援護射撃	掩護射撃
えんこうじばん	円光寺版
えんげきりろん	演劇理論
えんげいじょう	演芸場
えんげいざっし	園芸雑誌
えんきょりがわ	遠距離側
えんきはいれつ	塩基配列
えんかんじょう	円環状
えんかくりょく	遠隔力
えんかくそうさ	遠隔操作
えんかくかんし	遠隔監視
えんかいじょう	宴会場
えんかいしょく	鉛灰色
えんかいしゅう	沿海州
えんかいがかり	宴会係
えんえききこう	演繹機構
えんえきかのう	演繹可能
えりまきとかげ	襟巻蜥蜴
えぽきしじゅし	エポキシ樹脂
えぷろんすがた	エプロン姿
えびすほうめん	恵比寿方面
えびすほうこう	恵比寿方向
えひめだいがく	愛媛大学
えねるぎーぐん	エネルギー群
えどやまてべん	江戸山手弁
えどがわらんぽ	江戸川乱歩
えどがわじょし	江戸川女子
えどがわくみん	江戸川区民
えつらんきょひ	閲覧拒否
えつらんかのう	閲覧可能
えっちゅうじま	越中島
えっけんこうい	越権行為
えっきょうしゃ	越境者
えちぜんみさき	越前岬
えちごこうつう	越後交通
えしゃじょうり	会者定離
えきりようしゃ	駅利用者
えきめいひょう	駅名表	駅名票	駅名標
えきまえひろば	駅前広場
えきまえどおり	駅前通り
えきびょうがみ	疫病神
えきちょうしつ	駅長室
えきちょうあて	駅長宛
えきたいちっそ	液体窒素
えきしゅうへん	駅周辺
えきかんきょり	駅間距離
えきかかりいん	駅係員
えきいんじしん	駅員自身
えきあつぷれす	液圧プレス
えうぽまちあか	Eupomatiaceae	エウポマチア科
えいんせっかい	会陰切開
えいりもんだい	営利問題
えいりもくてき	営利目的
えいりほうじん	営利法人
えいりだんたい	営利団体
えいりきぎょう	営利企業
えいりかつどう	営利活動
えいようりょう	栄養量
えいようしょく	栄養食
えいようきかん	栄養器官
えいようかてい	栄養過程
えいようえいが	栄耀栄華
えいぶんざっし	英文雑誌
えいふくちょう	永福町
えいちだいがく	英知大学
えいだんちよだ	営団千代田
えいぞうりょく	映像力
えいぞうぶんか	映像文化
えいぞうてんじ	映像展示
えいぞうたんし	映像端子
えいぞうそうち	映像装置
えいぞうせかい	映像世界
えいぞうかいろ	映像回路
えいせいだいに	衛星第二
えいせいせつび	衛生設備
えいせいじょう	衛生上
えいせいきょく	衛生局
えいせいかんり	衛生管理
えいじゅうけん	永住権
えいじへんかん	英字変換
えいじせんたく	英字選択
えいじしんぶん	英字新聞
えいしょうぼん	影照本	影鈔本
えいごろんぶん	英語論文
えいごほうそう	英語放送
えいごひょうじ	英語表示
えいごひょうき	英語表記
えいごはつおん	英語発音
えいごとうろん	英語討論
えいごけんてい	英語検定
えいごきょうし	英語教師
えいごがっこう	英語学校
えいごうかいき	永劫回帰
えいごあんない	英語案内
えいこせいすい	栄枯盛衰
えいこさくけん	永小作権
えいこくりょう	英国領
えいこくりゅう	英国流
えいこくこうし	英国公使
えいこくきかく	英国規格
えいぎょうよう	営業用
えいぎょうめん	営業面
えいぎょうまん	営業マン
えいぎょうてん	営業店
えいぎょうてき	営業的
えいぎょうせん	営業線
えいぎょうしょ	営業所
えいぎょうしゃ	営業車	営業者
えいぎょうけん	営業権
えいぎょうけい	営業系
えいぎょうがわ	営業側
えいぎょうがい	営業外
えいぎょういん	営業員
えいきょうだい	影響大
えいきょうあた	影響与
えいきゅうてき	永久的
えいがびじゅつ	映画美術
えいがひゃっか	映画百科
えいがはいゆう	映画俳優
えいがぜんたい	映画全体
えいがじんこう	映画人口
えいがしじょう	映画史上
えいがさくひん	映画作品
えいががいしゃ	映画会社
えいがかんめい	映画館名
えいがかんとく	映画監督
えいがかんけん	映画館券
えいがかんけい	映画関係
えいがおんがく	映画音楽
えいえんふめつ	永遠不滅
えいえいじてん	英英辞典
えいえいじしょ	英英辞書
えいいどりょく	鋭意努力
えーげぶんめい	エーゲ文明
うんようほんぶ	運用本部
うんようひょう	運用表
うんようばしょ	運用場所
うんようていし	運用停止
うんようちゅう	運用中
うんようじょう	運用上
うんようじかん	運用時間
うんようがかり	運用掛
うんようかのう	運用可能
うんようかいし	運用開始
うんゆとうけい	運輸統計
うんゆだいじん	運輸大臣
うんゆせいさく	運輸政策
うんめいとうげ	運命峠
うんぱんりょく	運搬力
うんぱんちゅう	運搬中
うんぱんかのう	運搬可能
うんのじゅうざ	海野十三
うんなんしょう	雲南省
うんどうりょく	運動力
うんどうりょう	運動量
うんどうようそ	運動要素
うんどうぶそく	運動不足
うんどうちゅう	運動中
うんどうそしき	運動組織
うんどうじょう	運動場
うんどうきのう	運動機能
うんてんひんど	運転頻度
うんてんちゅう	運転中
うんてんたいど	運転態度
うんてんそうさ	運転操作
うんてんせきぶ	運転席部
うんてんじょう	運転上
うんてんじかん	運転時間
うんてんしれい	運転指令
うんてんしよう	運転士用
うんてんしゅし	運転手氏
うんてんしほん	運転資本
うんてんしどう	運転指導
うんてんしきん	運転資金
うんてんくかん	運転区間
うんてんぎほう	運転技法
うんてんいがい	運転以外
うんちんふたん	運賃負担
うんちんひょう	運賃表
うんちんくぶん	運賃区分
うんちんきそく	運賃規則
うんちんかくさ	運賃格差
うんそうりょう	運送料
うんそうほけん	運送保険
うんそうひよう	運送費用
うんそうちゅう	運送中
うんそうじょう	運送状
うんそうぎょう	運送業
うんこうみつど	運行密度
うんこうていし	運航停止
うんこうちゅう	運航中	運行中
うんこうじかん	運行時間
うんえいりねん	運営理念
うんえいぼたい	運営母体
うんえいちゅう	運営中
うんえいじょう	運営上
うんえいしきん	運営資金
うんえいいこう	運営移行
うんえいいいん	運営委員
うんうんびうむ	Ununbium	Uub
うわてだしなげ	上手出し投げ
うわっちょうし	上っ調子
うわじまひがし	宇和島東
うわきちょうさ	浮気調査
うわきがんぼう	浮気願望
うりばめんせき	売場面積
うりてしじょう	売手市場	売り手市場
うりだてぎょく	売建玉
うりだしちゅう	売出中	売り出し中
うりだしきかん	売出期間
うりあげふしん	売上不振
うりあげげんか	売上原価
うりあげかくほ	売上確保
うりあげかかく	売上価格
うらわにしぐち	浦和西口
うらわだいもん	浦和大門
うらわしとうぶ	浦和市東部
うらわざつかい	裏技使い
うらまちどおり	裏町通り
うらばなしてき	裏話的
うらじろれんが	裏白連歌
うらじょうほう	裏情報
うらしまたろう	浦島太郎
うらさんしょう	裏参照
うらがみしゃこ	浦上車庫
うらがすみぜん	浦霞禅
うらがすいどう	浦賀水道
うらがききんし	裏書禁止
うらおもてがみ	裏表紙
うよくだんたい	右翼団体
うよきょくせつ	紆余曲折
うめだはんしん	梅田阪神
うみはらかわせ	海腹川背
うみのなかみち	海の中道
うまれこきょう	生まれ故郷
うまのはなむけ	餞
うのめたかのめ	鵜の目鷹の目
うてんちゅうし	雨天中止
うてんけっこう	雨天決行
うつむきかげん	俯き加減
うつのみやだい	宇都宮大
うつのみやせん	宇都宮線
うつのみやえき	宇都宮駅
うつじょうたい	鬱状態
うつくしがはら	美ヶ原
うつくしがおか	美しが丘
うちゅうぶつり	宇宙物理
うちゅうひこう	宇宙飛行
うちゅうたんさ	宇宙探査
うちゅうそくど	宇宙速度
うちゅうしょく	宇宙食
うちゅうしゅし	宇宙種子
うちゅうくうぼ	宇宙空母
うちゅうかぞく	宇宙家族
うちでのこづち	打出の小槌
うちだようこう	内田洋行
うちざいこぶん	内在庫分
うちあけばなし	打ち明け話
うだがわちょう	宇田川町
うたかいはじめ	歌会始
うそはっぴゃく	嘘八百
うそはっけんき	嘘発見器	嘘発見機
うせつやじるし	右折矢印
うせつしゃせん	右折車線
うずまきもよう	渦巻模様
うずでんりゅう	渦電流
うすみどりいろ	薄緑色
うすばかげろう	薄羽蜉蝣
うすはなざくら	薄花桜
うじょうみゃく	羽状脈
うじやまだせん	宇治山田線
うしろほうこう	後方向
うしろはんぶん	後半分
うさこうじょう	宇佐工場
うごほんじょう	羽後本庄
うごうのしゅう	烏合の衆
うこうこくどう	宇高国道
うけとりてがた	受取手形
うけとりきょひ	受取拒否
うけとりかのう	受取可能
うけてしゅどう	受け手主導
うけつけちゅう	受付中
うけつけじょう	受付嬢
うけつけじかん	受付時間
うけつけきげん	受付期限
うけつけきかん	受付期間
うけつけかいし	受付開始
うけおいぎょう	請負業
うかいうんてん	迂回運転
うえのちかえき	上野地下駅
うえのこうえん	上野公園
うえのがくえん	上野学園
うえつほんせん	羽越本線
うえつほうめん	羽越方面
うえちゅうだん	上中段
うえだあきなり	上田秋成
いんりょくけん	引力圏
いんりょうよう	飲料用
いんりょうすい	飲料水
いんようぶぶん	引用部分
いんようちゅう	引用中
いんようじゅん	引用順
いんようぎょう	引用行
いんようきょか	引用許可
いんようきごう	引用記号
いんようかいし	引用開始
いんよういがい	引用以外
いんぺいりょく	隠蔽力
いんぺいしょく	隠蔽色
いんどねしあご	インドネシア語
いんどてつがく	インド哲学
いんでぃかまい	インディカ米
いんでぃあんざ	インディアン座
いんたいずもう	引退相撲
いんたいじあい	引退試合
いんせんしょり	陰線処理
いんせきじにん	引責辞任
いんすうていり	因数定理
いんじほしょう	印字保証
いんじほうしき	印字方式
いんじひんしつ	印字品質
いんじしょたい	印字書体
いんじくろっく	印字クロック
いんしょくぶつ	飲食物
いんしょくてん	飲食店
いんしょくだい	飲食代
いんしょうぶか	印象深
いんしょうてき	印象的
いんしゅきんし	飲酒禁止
いんしゅうてき	因襲的
いんしぶんせき	因子分析
いんさつようし	印刷用紙
いんさつようご	印刷用語
いんさつぶすう	印刷部数
いんさつはんい	印刷範囲
いんさつちゅう	印刷中
いんさつそくど	印刷速度
いんさつそうち	印刷装置
いんさつじゅつ	印刷術
いんさつけっか	印刷結果
いんさつけいひ	印刷経費
いんさつぎょう	印刷業
いんさつきょく	印刷局
いんさつきのう	印刷機能
いんさつかんじ	印刷漢字
いんぎんぶれい	慇懃無礼
いんきんたむし	陰金田虫
いんきょくせん	陰極線
いんきょくかん	陰極管
いんがしじょう	印画紙上
いんがかんけい	因果関係
いんがおうほう	因果応報
いんかでんあつ	印加電圧
いんかていこく	インカ帝国
いわなみぶんこ	岩波文庫
いわなみじしょ	岩波辞書
いわなみこうざ	岩波講座
いわてんじょう	岩天井
いわてほうそう	岩手放送
いわてだいがく	岩手大学
いわてこうげん	岩手高原
いわさきでんき	岩崎電気
いわくらともみ	岩倉具視
いろぶんかいき	色分解機
いろじょうほう	色情報
いりょうほけん	医療保険
いりょうふたん	医療負担
いりょうふくし	医療福祉
いりょうせいど	医療制度
いりょうしょち	医療処置
いりょうしせつ	医療施設
いりょうこうい	医療行為
いりょうげんば	医療現場
いりょうきかん	医療機関
いりょういがい	医療以外
いりぐちふきん	入口付近
いりおもてじま	西表島
いらくせんそう	イラク戦争
いらいげんこう	依頼原稿
いよほうじょう	伊予北条
いようこうがく	医用工学
いもうとふうふ	妹夫婦
いむらやせいか	井村屋製菓
いみりょういき	意味領域
いみめいりょう	意味明瞭
いみてきりかい	意味的理解
いみしんちょう	意味深長
いみかいしゃく	意味解釈
いまにしきんじ	今西錦司
いまづほうめん	今津方面
いぼきょうだい	異母兄弟
いほうとりつけ	違法取付
いほうとうこう	違法投稿
いほうかいぞう	違法改造
いへんさんぜつ	韋編三絶
いふきょうだい	異父兄弟
いふうどうどう	威風堂々
いはんないよう	違反内容
いはらさいかく	井原西鶴
いのしかちょう	猪鹿蝶
いのかしらせん	井の頭線
いのうただたか	伊能忠敬
いのうえやすし	井上靖
いぬやまじょう	犬山城
いぬちくしょう	犬畜生
いぬかいつよし	犬養毅
いにんりっぽう	委任立法
いにんめいれい	委任命令
いなりしんこう	稲荷信仰
いなしろしがわ	稲城市側
いなさくぶんか	稲作文化
いながきたるほ	稲垣足穂
いなかしゅたい	田舎主体
いどばたかいぎ	井戸端会議
いどうもんだい	移動問題
いどうめいれい	移動命令
いどうほうほう	移動方法
いどうほうこう	移動方向
いどうへいきん	移動平均
いどうぶったい	移動物体
いどうてじゅん	移動手順
いどうていあん	移動提案
いどうつうしん	移動通信
いどうしゅだん	移動手段
いどうかんけい	移動関係
いどうかいしび	移動開始日
いどううんよう	移動運用
いとこんにゃく	糸こんにゃく	糸コンニャク	糸蒟蒻
いとくてんのう	懿徳天皇
いとうひろぶみ	伊藤博文
いとうおんせん	伊東温泉
いといしげさと	糸井重里
いといがわせん	糸魚川線
いでんほうそく	遺伝法則
いでんしそうさ	遺伝子操作
いでんがくしゃ	遺伝学者
いでんあんごう	遺伝暗号
いてんしゅうし	移転収支
いてんけいかく	移転計画
いつきひろゆき	五木寛之
いつかいちせん	五日市線
いっぽんぜおい	一本背負い	一本背負
いっぽんがたな	一本刀
いっぽぜんしん	一歩前進
いっぷんいない	一分以内
いっぷいっさい	一夫一妻
いっぱんろめん	一般路面
いっぱんりろん	一般理論
いっぱんりょく	一般力
いっぱんよぼう	一般予防
いっぱんようご	一般用語
いっぱんめいし	一般名詞
いっぱんぶもん	一般部門
いっぱんどうろ	一般道路
いっぱんちしき	一般知識
いっぱんだんし	一般男子
いっぱんせつび	一般設備
いっぱんじどう	一般児童
いっぱんじこう	一般事項
いっぱんじげん	一般次元
いっぱんしよう	一般使用
いっぱんしょく	一般職	一般色
いっぱんしゅふ	一般主婦
いっぱんしみん	一般市民
いっぱんざっし	一般雑誌
いっぱんさんか	一般参加
いっぱんこうぼ	一般公募
いっぱんげんり	一般原理
いっぱんきゃく	一般客
いっぱんかてい	一般家庭
いっぱんかがく	一般科学
いっぱんえいが	一般映画
いっぱつやろう	一発野郎
いっぱつにはつ	一発二発
いっぱくふつか	一泊二日
いっぱいきげん	一杯機嫌
いっとうしょう	一等賞
いってんとうし	一点透視
いってんさせん	一点鎖線
いってるびうむ	Ytterbium	Yb
いっていりょう	一定量
いっていふへん	一定不変
いっていていど	一定程度
いっていそくど	一定速度
いっていじかん	一定時間
いっていきょり	一定距離
いっていきかん	一定期間
いっついひかく	一対比較
いっちょくせん	一直線
いっちはんてい	一致判定
いっちはんかい	一知半解
いっちだんけつ	一致団結
いっちせいぎょ	一致制御
いったんもめん	一反木綿
いったんていし	一旦停止
いっそうべんり	一層便利
いっせんごりん	一銭五厘
いっせんきゅう	一戦級	一線級
いっせいちだい	一世一代
いっすんぼうし	一寸法師
いっしんふらん	一心不乱
いっしんはいそ	一審敗訴
いっしんじょう	一身上
いっしんきょう	一神教
いっしょうびん	一升瓶
いっしょうせつ	一小節
いっしょうがい	一生涯
いっしゅんかん	一瞬間
いっしゅうねん	一周年
いっしゅうかん	一週間
いっしゃせんり	一瀉千里
いっしまんるい	一死満塁
いっしはんせん	一紙半銭
いっしどうじん	一視同仁
いっしつりえき	逸失利益
いっしそうでん	一子相伝
いっさくねんど	一昨年度
いっさいきんし	一切禁止
いっさいきょう	一切経
いっこくしゅぎ	一国主義
いっこうしゅう	一向宗	一向衆
いっこういっき	一向一揆
いっきゅうひん	一級品
いっきとうせん	一騎当千
いっきつうかん	一気通貫
いっきたいさく	一揆対策
いっきいちゆう	一喜一憂
いっかつばらい	一括払い
いっかつとうち	一括統治
いっかつしょり	一括処理
いっかだんらん	一家団欒
いっかげつまえ	一箇月前
いっかくじゅう	一角獣
いっかいろんり	一階論理
いっかいていど	一回程度
いちわかんけつ	一話完結
いちわいじょう	一話以上
いちりようしゃ	一利用者
いちりょうじつ	一両日
いちりょうしゃ	一両車
いちりょういき	一領域
いちりつかぜい	一律課税
いちりいちがい	一利一害
いちらんひょう	一覧表
いちようぶんぷ	一様分布
いちょうびょう	胃腸病
いちょうひょう	異聴表
いちょうちょう	イ長調
いちょうがっき	移調楽器
いちもんふつう	一文不通
いちもうだじん	一網打尽
いちみどうしん	一味同心
いちまつもよう	市松模様
いちまいうわて	一枚上手
いちぼうせんり	一望千里
いちぶゆうこう	一部有効
いちぶへんこう	一部変更
いちぶばっすい	一部抜粋
いちぶはんけつ	一部判決
いちぶていせい	一部訂正
いちぶしろくろ	一部白黒
いちぶしじゅう	一部始終
いちぶきんえん	一部禁煙
いちぶきぎょう	一部企業
いちぶかいつう	一部開通
いちぶいんよう	一部引用
いちびょうかん	一秒間
いちびょういか	一秒以下
いちばんべんり	一番便利
いちばんふしぎ	一番不思議
いちばんひだり	一番左
いちばんにんき	一番人気
いちばんてまえ	一番手前
いちばんちょう	一番丁	一番町
いちばんだいじ	一番大事
いちばんさいご	一番最後
いちばんごうか	一番豪華
いちばんこうか	一番高価
いちばんくろう	一番苦労
いちばんきたい	一番期待
いちねんほっき	一念発起
いちねんていど	一年程度
いちねんじゅう	一年中
いちねんけいか	一年経過
いちねんいない	一年以内
いちにんしょう	一人称
いちにちじゅう	一日中
いちにちくらい	一日位
いちとうかせい	位置透過性
いちちょうせい	位置調整
いちちほうとし	一地方都市
いちだんどうし	一段動詞
いちだいろんぎ	一大論議
いちだいけつい	一大決意
いちだいかぎり	一代限り
いちじれんさい	一時連載
いちじょうほう	位置情報
いちじへんすう	一時変数
いちじへんかん	一次変換
いちじふさいり	一事不再理
いちじふぁいる	一時ファイル
いちじはんしゃ	1次反射
いちじとうごう	一次統合
いちじていすう	一時定数
いちじていしゃ	一時停車
いちじちゅうし	一時中止
いちじせんたく	一次選択
いちじせんきん	一字千金
いちじしりょう	一次資料
いちじしょとく	一時所得
いちじさんらん	一次散乱
いちじげんてき	一次元的
いちじきゅうし	一時休止
いちじききゅう	一時帰休
いちじかんまえ	一時間前
いちじかんはん	一時間半
いちじかんすう	一次関数
いちじおんげん	1次音源
いちしんきょう	一神教
いちしょうじょ	一少女
いちさんかしゃ	一参加者
いちごんはんく	一言半句
いちごんいっく	一言一句
いちげんかんり	一元管理
いちげきりだつ	一撃離脱
いちけんしゅつ	位置検出
いちがくしょう	一楽章
いちかわふさえ	市川房枝
いちかわけおり	市川毛織
いちかたりゅう	一方流	都方流
いちいたいすい	一衣帯水
いちいせんしん	一意専心
いちあくのすな	一握の砂
いたんしんもん	異端審問
いたひょうめん	板表面
いたくばいばい	委託売買
いたくはんばい	委託販売
いぞんたいしつ	依存体質
いぞんかんけい	依存関係
いぞんかいせき	依存解析
いぞくねんきん	遺族年金
いそんざいげん	依存財源
いそぎんちゃく	磯巾着
いそうはんてい	移送判定
いそうとくせい	位相特性
いそうせいぎょ	位相制御
いそうくうかん	位相空間
いそうきかてき	位相幾何的
いそうきかがく	位相幾何学
いそうがいねん	位相概念
いそうかんけい	位相関係
いそうかいせき	位相解析
いぜんもんだい	以前問題
いぜんほうそう	以前放送
いぜんとうこう	以前投稿
いせものがたり	伊勢物語
いせはらしみん	伊勢原市民
いせざきちょう	伊勢崎町
いせきもんだい	移籍問題
いせきはっくつ	遺跡発掘
いせきけってい	移籍決定
いせききんがく	移籍金額
いせいこうゆう	異性交友
いせいかんけい	異性関係
いせいあいしゃ	異性愛者
いずものおくに	出雲阿国
いずもたいしゃ	出雲大社
いずみたまがわ	和泉多摩川
いずみきょうか	泉鏡花
いずきゅうこう	伊豆急行
いすらむきょう	イスラム教
いじょうにんき	異常人気
いじょうどうさ	異常動作
いじょうつうち	異常通知
いじょうじたい	異常事態
いじょうかしょ	異常箇所
いしんでんしん	以心伝心
いしんぐんだん	維新軍団
いしわおんせん	石和温泉
いしょくちゅう	移植中
いしょくじょう	委嘱状	移植上
いしょくじゅう	衣食住
いしょくしょう	異食症
いしまるでんき	石丸電気
いしほういはん	医師法違反
いしべきんきち	石部金吉
いしひょうめい	意志表明	意思表明
いしはらかんじ	石原莞爾
いしはくじゃく	意志薄弱	意思薄弱
いしのまきせん	石巻線
いしのまきえき	石巻駅
いしのうりょく	意思能力
いしだみつなり	石田三成
いしきちょうさ	意識調査
いしきかいかく	意識改革
いしかわちょう	石川町
いしかわじゅん	石川淳
いしかりぬまた	石狩沼田
いしかりちょう	石狩町
いざよいのつき	十六夜の月
いざなぎけいき	伊弉諾景気
いさんぶんかつ	遺産分割
いさんそうぞく	遺産相続
いさんしょぶん	遺産処分
いごしょうぎぶ	囲碁将棋部
いごきょうかい	囲碁協会
いこんたいけつ	遺恨対決
いこつちょうさ	遺骨調査
いこうちょうさ	意向調査
いこうだんかい	移行段階
いこうさぎょう	移行作業
いけんようぼう	意見要望
いけんはんけつ	違憲判決
いけんこうこく	意見広告
いけんこうかん	意見交換
いけぶくろてん	池袋店
いけぶくろせん	池袋線
いけぶくろぐち	池袋口
いけぶくろかん	池袋間
いけぶくろえき	池袋駅
いけのはたもん	池の端門
いけだこうこう	池田高校
いけがみきみこ	池上季実子
いけいようせい	異形葉性
いけいさいぼう	異形細胞
いくたじんじゃ	生田神社
いくじぶんたん	育児分担
いくじけいけん	育児経験
いくじきゅうか	育児休暇
いくさぶぎょう	軍奉行
いぎもうしたて	異議申立て
いきのまつばら	生の松原
いきにんぎょう	生き人形
いきしょうにん	生き証人
いきしょうてん	意気衝天
いきしょうちん	意気消沈
いがさてつどう	井笠鉄道
いがぐりあたま	毬栗頭
いがくもくてき	医学目的
いがくそうだん	医学相談
いがくしょいん	医学書院
いがくげんてい	医学限定
いがくかんれん	医学関連
いがくかんけい	医学関係
いかんそくたい	衣冠束帯
いかほおんせん	伊香保温泉
いかさんしょう	以下参照
いかくしゃげき	威嚇射撃
いおんこうかん	イオン交換
いえらいしゃん	夜来香
いいんぜんたい	委員全体
いいんかいせい	委員会制
いいんかいあん	委員会案
いいわけむよう	言訳無用
いいやまでんき	飯山電機
いいだばしえき	飯田橋駅
いあんりょこう	慰安旅行
あんらくしがた	安楽死型
あんぽりじかい	安保理事会
あんぽりけつぎ	安保理決議
あんぽもんだい	安保問題
あんぽたいせい	安保体制
あんにんどうふ	杏仁豆腐
あんないそうち	案内装置
あんないじょう	案内状
あんないがかり	案内係
あんどろめだざ	アンドロメダ座
あんどうでんき	安藤電気
あんでんりゅう	暗電流
あんていひこう	安定飛行
あんていどうさ	安定動作
あんていたすう	安定多数
あんていかどう	安定稼働
あんたくせいろ	安宅正路
あんぜんていし	安全停止
あんぜんちたい	安全地帯
あんぜんそうち	安全装置
あんぜんせつび	安全設備
あんぜんじょう	安全上
あんぜんきょり	安全距離
あんぜんきかく	安全規格
あんぜんかんり	安全管理
あんぜんかくほ	安全確保
あんせきしょく	暗赤色
あんじゅんのう	暗順応
あんしんりょう	安心料
あんさつしれい	暗殺指令
あんごうひょう	暗号表
あんごうちょう	暗号帳
あんこくちたい	暗黒地帯
あんこくじだい	暗黒時代
あんこうしょく	暗紅色
あんがいようい	案外容易
あんかっしょく	暗褐色
あわゆきどうふ	泡雪豆腐
あわづおんせん	粟津温泉
あわせじょうゆ	合わせ醤油	合せ醤油
あれるぎーせい	アレルギー性
あるぷすでんき	アルプス電気
あるときばらい	有る時払い
あるかりでんち	アルカリ電池
ありまおんせん	有馬温泉
ありたてつどう	有田鉄道
ありしまたけお	有島武郎
あらびあせきゆ	アラビア石油
あらびあすうじ	アラビア数字
あらいはくせき	新井白石
あゆついじゅう	阿諛追従
あめいせんそう	蛙鳴蝉噪
あまみおおしま	奄美大島
あまのはしだて	天の橋立	天橋立
あまくさしろう	天草四郎
あまぎゆがしま	天城湯ヶ島
あまがさきかん	尼崎間
あほだらきょう	阿呆陀羅経
あほうれっしゃ	阿房列車
あべのなかまろ	阿倍仲麻呂
あべのせいめい	安倍晴明
あぶらあげぼん	油揚本
あぶはちとらず	虻蜂取らず
あびきょうかん	阿鼻叫喚
あなきょうだい	穴兄弟
あどれすちょう	アドレス帳
あとみがくえん	跡見学園
あてずいりょう	当て推量
あてさきふめい	宛先不明
あてさきじゅん	宛先順
あつりょくなべ	圧力鍋
あつりょくけい	圧力計
あつりょくがま	圧力釜
あつみはんとう	渥美半島
あつたじんぐう	熱田神宮
あつぎほうめん	厚木方面
あつぎないろん	厚木ナイロン
あつかいりょう	扱い量
あっぴこうげん	安比高原
あっしゅくりつ	圧縮率
あっしゅくよう	圧縮用
あっしゅくまえ	圧縮前
あっしゅくほう	圧縮法
あっしゅくばん	圧縮版
あっしゅくけい	圧縮系
あっしゅくがわ	圧縮側
あっしゅくがす	圧縮ガス
あっかんじょう	悪感情
あたまでっかち	頭でっかち
あたいせんきん	値千金
あそびはんぶん	遊び半分
あずかりしょう	預かり証
あすかいちょう	飛鳥井町
あしやがわえき	芦屋川駅
あしはらちゅう	芦原中
あしずりみさき	足摺岬
あしくびねんざ	足首捻挫
あしがらとうげ	足柄峠
あしかがじだい	足利時代
あしかがけいば	足利競馬
あさんかちっそ	亜酸化窒素
あさまじんじゃ	浅間神社
あさまおんせん	浅間温泉
あさひゆうかん	朝日夕刊
あさひほうそう	朝日放送
あさひなたかし	朝比奈隆
あさひそのらま	朝日ソノラマ
あさひせんしょ	朝日選書
あさひせいめい	朝日生命
あさひしんぶん	朝日新聞
あさひこうよう	朝日航洋
あさひけいれつ	朝日系列
あさひぎんこう	あさひ銀行
あさひかわせん	旭川線
あさひかわえき	旭川駅
あこうざんたい	亜高山帯
あげだしどうふ	揚出し豆腐	揚げ出し豆腐
あけちみつひで	明智光秀
あけちたんてい	明智探偵
あけちこごろう	明智小五郎
あくりるじゅし	アクリル樹脂
あくりょくけい	握力計
あくようかのう	悪用可能
あくみょうだか	悪名高
あくまごうせい	悪魔合成
あくまがったい	悪魔合体
あくびょうどう	悪平等
あくひょうばん	悪評判
あくてんこうじ	悪天候時
あくそうきゅう	悪送球
あくせんくとう	悪戦苦闘
あくじょうけん	悪条件
あくじゅんかん	悪循環
あくざいりょう	悪材料
あくかんじょう	悪感情
あくかんきょう	悪環境
あくえいきょう	悪影響
あくいんしょう	悪印象
あくいんあっか	悪因悪果
あきりょういき	空領域
あきよしくみこ	秋吉久美子
あきようりょう	空き容量	空容量
あきものがたり	秋物語
あきはばらえき	秋葉原駅
あきづきでんし	秋月電子
あきただいがく	秋田大学
あきたしょてん	秋田書店
あきたぎんこう	秋田銀行
あきしののみや	秋篠宮
あかまじんぐう	赤間神宮
あかとうがらし	赤唐辛子
あかつかふじお	赤塚不二夫
あかちょうちん	赤提灯
あかぞめえもん	赤染衛門
あかすいしょう	赤水晶
あかしんぶんか	赤新聞化
あかさかみつけ	赤坂見付	赤坂見附
あかぎこうげん	赤城高原
あかいっしょく	赤一色
あかあおみどり	赤青緑
あおやまちょう	青山町
あおみどりけい	青緑系
あおばだいえき	青葉台駅
あおばじょうし	青葉城址
あおはたていじ	青旗提示
あおねおんせん	青根温泉
あおとていしゃ	青砥停車
あおとうがらし	青唐辛子
あおてんじょう	青天井
あおだいしょう	青大将
あおぞらぶんこ	青空文庫
あおきこんよう	青木昆陽
あおえきしょう	青液晶
あおいっしょく	青一色
あおいきといき	青息吐息
あいてとうしゅ	相手投手
あいてせんしゅ	相手選手
あいてじんない	相手陣内
あいてぎんこう	相手銀行
あいてきぎょう	相手企業
あいづわかまつ	会津若松
あいづてつどう	会津鉄道
あいづだいがく	会津大学
あいちょうばん	愛聴盤
あいちこうだい	愛知工大
あいちけんない	愛知県内
あいちけんじん	愛知県人
あいちけんけい	愛知県警
あいちぎんこう	愛知銀行
あいずだいがく	会津大学
あいすみちょう	愛住町
あいしんせいき	アイシン精機
あいしんかくら	愛新覺羅
あいしょうめい	愛称名
あいさつまわり	挨拶回り
あいさつじょう	挨拶状
あいこういしだ	愛甲石田
おんみつどうしん	隠密同心
おんばしらまつり	御柱祭
おんなきょうだい	女姉妹
おんどちょうせつ	温度調節
おんだんかさよう	温暖化作用
おんたけさんえき	御嶽山駅
おんぞうせいぎょ	音像制御
おんせんりょこう	温泉旅行
おんせんりょかん	温泉旅館
おんせつたいおう	音節対応
おんせつこうぞう	音節構造
おんせいぶんせき	音声分析
おんせいふごうか	音声符号化
おんせいひんしつ	音声品質
おんせいひょうき	音声表記
おんせいにんしき	音声認識
おんせいでんたつ	音声伝達
おんせいたじゅう	音声多重
おんせいたいおう	音声対応
おんせいたいいき	音声帯域
おんせいせいせい	音声生成
おんせいしんごう	音声信号
おんせいさんぷる	音声サンプル
おんせいごうせい	音声合成
おんせいがくてき	音声学的
おんせいかんけい	音声関係
おんせいかいせき	音声解析
おんじょうしょり	音情処理
おんしつさいばい	温室栽培
おんしつかいぜん	音質改善
おんこちしんしょ	温故知新書
おんこうとくじつ	温厚篤実
おんげんほうしき	音源方式
おんげんほうこう	音源方向
おんげんとくせい	音源特性
おんげんぜんたい	音源全体
おんくんみしょう	音訓未詳
おんくんさくいん	音訓索引
おんきょうせつび	音響設備
おんきょうじょう	音響上
おんきょうしんり	音響心理
おんきょうこうか	音響効果
おんがくりょだん	音楽旅団
おんがくりょこう	音楽旅行
おんがくほんらい	音楽本来
おんがくばんぐみ	音楽番組
おんがくてききそ	音楽的基礎
おんがくだいがく	音楽大学
おんがくたんとう	音楽担当
おんがくたいけん	音楽体験
おんがくそうほう	音楽双方
おんがくせいさく	音楽制作
おんがくじむしょ	音楽事務所
おんがくじしょう	音楽事象
おんがくしんごう	音楽信号
おんがくしじょう	音楽市場
おんがくさくひん	音楽作品
おんがくこうぼう	音楽工房
おんがくけいしき	音楽形式
おんがくきょうし	音楽教師
おんがくがっかい	音楽学会
おんがくがくしゃ	音楽学者
おんがくがくいん	音楽学院
おんがくかんとく	音楽監督
おんがくかんけい	音楽関係
おんがくかつどう	音楽活動
おんがくえんそう	音楽演奏
おんいんにんしき	音韻認識
おんいんたいけい	音韻体系
おんいんしきべつ	音韻識別
おんいんがくてき	音韻学的
おんあつぶんぷず	音圧分布図
おわりいちのみや	尾張一宮
おやまゆうえんち	小山遊園地
おやまこうじょう	小山工場
おやくそくどおり	お約束どおり	御約束通り	お約束通り	御約束どおり
おもだかもくぐん	オモダカ目群
おもしろはんぶん	面白半分
おもいだしわらい	思い出し笑い
おもいかねのかみ	思兼神
おめいへんじょう	汚名返上
おとりこみちゅう	お取り込み中
おとにゅうりょく	音入力
おとこきょうだい	男兄弟
おとぎりそうもく	Hypericales	Dilleniales	オトギリソウ目	Guttiferales
おだわらほうめん	小田原方面
おださかえちょう	小田栄町
おたのしみぶくろ	お楽しみ袋
おそかれはやかれ	遅かれ早かれ
おくればせながら	遅ればせながら
おくりてしゅどう	送り手主導
おくりあしばらい	送り足払い
おくないはいせん	屋内配線
おくたまほうめん	奥多摩方面
おくさわほうめん	奥沢方面
おきなわみんよう	沖縄民謡
おきなわほんとう	沖縄本島
おきなわほうげん	沖縄方言
おきなわふじつう	沖縄富士通
おきなわてつどう	沖縄鉄道
おきなわすいさん	沖縄水産
おきあがりこぼし	起き上がり小法師
おがさわらりゅう	小笠原流
おかやまめいぶつ	岡山名物
おかやまだいがく	岡山大学
おかやまけんじん	岡山県人
おかやまくうこう	岡山空港
おかやまえきまえ	岡山駅前
おおやまやすはる	大山康晴
おおものじょせい	大物女性
おおみわじんじゃ	大神神社
おおみやえきまえ	大宮駅前
おおほりこうえん	大濠公園
おおびゃくしょう	大百姓
おおばんぶるまい	大盤振舞い	大盤振舞	大盤振る舞い
おおはらほうめん	大原方面
おおはらそうどう	大原騒動
おおはばへんこう	大幅変更
おおはばひきさげ	大幅引下げ
おおはばげんぜい	大幅減税
おおはしきょせん	大橋巨泉
おおぬまこうえん	大沼公園
おおとりじんじゃ	大鳥神社
おおともそうりん	大友宗麟
おおてしょうよう	大手商用
おおつまこうこう	大妻高校
おおつきしょてん	大月書店
おおつかせいやく	大塚製薬
おおたしゅっぱん	太田出版
おおたくたいかい	太田区大会
おおそうじちゅう	大掃除中
おおすみはんとう	大隅半島
おおさかめいぶつ	大阪名物
おおさかほんしゃ	大阪本社
おおさかほうめん	大阪方面
おおさかばんぱく	大阪万博
おおさかねやがわ	大阪寝屋川
おおさかとういん	大阪桐蔭
おおさかちかてつ	大阪地下鉄
おおさかだいがく	大阪大学
おおさかたいかい	大阪大会
おおさかせめんと	大阪セメント
おおさかしょてん	大阪書店
おおさかさんだい	大阪産大
おおさかこうれい	大阪恒例
おおさかこうだい	大阪工大
おおさかこうえん	大阪公演
おおさかげいにん	大阪芸人
おおさかげいだい	大阪芸大
おおさかくうこう	大阪空港
おおさかぎじゅつ	大阪技術
おおさかきんこう	大阪近郊
おおさかきたこう	大阪北港
おおさかがくいん	大阪学院
おおさかえきまえ	大阪駅前
おおくらだいじん	大蔵大臣
おおくましげのぶ	大隈重信
おおきさいのみや	皇太后宮
おおがためんきょ	大型免許
おおがたひこうき	大型飛行機
おおがたとくしゅ	大型特殊
おおがただつぜい	大型脱税
おおがたせんぱく	大型船舶
おおがたせんしゅ	大型選手
おおがたしょてん	大型書店
おおがたけんいん	大型牽引
おおがたえいぞう	大型映像
おおがきほうめん	大垣方面
おおおかやまかん	大岡山間
おおおかやまえき	大岡山駅
おおおかえちぜん	大岡越前
おおいたほうそう	大分放送
おおいただいがく	大分大学
おおいたたいかい	大分大会
おおいたこうつう	大分交通
おおいたけんみん	大分県民
おおあまのおうじ	大海人皇子
おうりょくしょく	黄緑色
おうりつがっかい	王立学会
おうようりきがく	応用力学
おうようもんだい	応用問題
おうようでんしぶ	応用電子部
おうようせいめい	応用生命
おうようせいひん	応用製品
おうようすうがく	応用数学
おうようぎじゅつ	応用技術
おうようがっかい	応用学会
おうようかんれん	応用関連
おうようかがくか	応用化学科
おうようかいせき	応用解析
おうゆうがくえん	鴎友学園
おうみじかいそく	近江路快速
おうみしおつかん	近江塩津間
おうみいまづえき	近江今津駅
おうみいまずえき	近江今津駅
おうぼしゃりまわ	応募者利回
おうぼしゃたすう	応募者多数
おうぼしゃしめい	応募者氏名
おうぼしめきりご	応募締切後
おうべいしょこく	欧米諸国
おうふくわりびき	往復割引
おうふくにじかん	往復二時間
おうふくじかんさ	往復時間差
おうばんぶるまい	椀飯振舞	椀飯振る舞い	椀飯振舞い
おうどうざひょう	黄道座標
おうどうこうたい	黄道光帯
おうとうしんごう	応答信号
おうとうしょぼう	桜桃書房
おうとうかんすう	応答関数
おうじんてんのう	応神天皇
おうじゃにちだい	王者日大
おうじゃてんらく	王者転落
おうしゅうしよう	欧州仕様
おうごんでんせつ	黄金伝説
おうきゅうてあて	応急手当
おうきゅうしょち	応急処置
おうかしょうぐみ	桜花賞組
おうえんだんいん	応援団員
おうえんかいせつ	応援解説
おうえんえんぜつ	応援演説
おういんこうこう	桜蔭高校
おういけいしょう	王位継承
おいしょうこきん	追証拠金
おいこししゃせん	追越車線
おーやんふぃふぃ	欧陽菲菲
えんようこうかい	遠洋航海
えんゆうてんのう	円融天皇
えんゆうさんだい	円融三諦
えんめいほうほう	延命方法
えんめいちりょう	延命治療
えんまんかいけつ	円満解決
えんぼうしんりょ	遠謀深慮
えんのぎょうじゃ	役行者
えんないあんない	園内案内
えんてんかつだつ	円転滑脱
えんてつはままつ	遠鉄浜松
えんてつでんしゃ	遠鉄電車
えんちょうぶぶん	延長部分
えんちょうじょう	延長上
えんちょうこくい	円頂黒衣
えんちょうこうじ	延長工事
えんちょうくかん	延長区間
えんちょうきゅう	円頂丘
えんちゅうじょう	円柱状
えんそひょうはく	塩素漂白
えんそしょうどく	塩素消毒
えんそうりょこう	演奏旅行
えんそうようしき	演奏様式
えんそうないよう	演奏内容
えんそうせいぎょ	演奏制御
えんそうしゃめい	演奏者名
えんそうごうせい	演奏合成
えんそうけいたい	演奏形態
えんそうけいしき	演奏形式
えんそうぎじゅつ	演奏技術
えんそうかつどう	演奏活動
えんせんぜんたい	沿線全体
えんせんじんこう	沿線人口
えんせきもんだい	円積問題
えんせきがいせん	遠赤外線
えんすいせきそう	円錐積層
えんじょだんたい	援助団体
えんじょこうさい	援助交際
えんしんぶんりき	遠心分離器	遠心分離機
えんしゅつじょう	演出上
えんしゅうじょう	円周上	演習場
えんしゅうしえん	演習支援
えんざんせいのう	演算性能
えんざんじゅんい	演算順位
えんざんこうがく	演算工学
えんざんかいすう	演算回数
えんこうきんこう	遠交近攻
えんげきかんけい	演劇関係
えんげきかつどう	演劇活動
えんけいだんめん	円形断面
えんきどうそくど	円軌道速度
えんかつうんてん	円滑運転
えんかしょうじょ	演歌少女
えんかくいりょう	遠隔医療
えんかいもくてき	宴会目的
えんえきたいけい	演繹体系
えびすこうじょう	恵比寿工場
えどじだいこうき	江戸時代後期
えっきょうろせん	越境路線
えちぜんかいがん	越前海岸
えちごゆざわえき	越後湯沢駅
えすえすせいやく	エスエス製薬
えくすおーじゃん	XO醤
えきめいひょうじ	駅名表示
えきめいかしょう	駅名仮称
えきまえりょかん	駅前旅館
えきべんだいがく	駅弁大学
えきでんたいかい	駅伝大会
えきたいはみがき	液体歯磨
えきたいにんげん	液体人間
えきたいせんざい	液体洗剤
えきせいかくめい	易姓革命
えきしょうぱねる	液晶パネル
えきしょうてれび	液晶テレビ
えきしょうがめん	液晶画面
えきしゃさんゆう	益者三友
えいんれっしょう	会陰裂傷
えいわだいじてん	英和大辞典
えいろたんちょう	嬰ロ短調
えいりもくてきか	営利目的可
えいようほきゅう	栄養補給
えいようしゅーと	栄養シュート
えいようがくしゃ	栄養学者
えいゆうれつでん	英雄列伝
えいゆうでんせつ	英雄伝説
えいゆうしゅだい	英雄主題
えいゆうぐんぞう	英雄群像
えいもじひょうき	英文字表記
えいほたんちょう	嬰ホ短調
えいへたんちょう	嬰ヘ短調
えいぶんもくろく	英文目録
えいぶんひょうき	英文表記
えいぶんせつめい	英文説明
えいはたんちょう	嬰ハ短調
えいねんきんぞく	永年勤続
えいにたんちょう	嬰ニ短調
えいとたんちょう	嬰ト短調
えいちしゅっぱん	英知出版
えいだんちかてつ	営団地下鉄
えいだんかんざん	営団換算
えいぞうようひん	映像用品
えいぞうぶんぽう	映像文法
えいぞうとくてん	映像特典
えいぞうしんごう	映像信号
えいぞうしりょう	映像資料
えいぞうさくひん	映像作品
えいぞうぎじゅつ	映像技術
えいせいめいじん	永世名人
えいせいほうそう	衛星放送
えいせいつうしん	衛星通信
えいせいだいいち	衛星第一
えいせいこうがく	衛生工学
えいせいかいせん	衛星回線
えいすうかなもじ	英数仮名文字
えいざんほんせん	叡山本線
えいざんでんてつ	叡山電鉄
えいざんでんしゃ	叡山電車
えいごめいしょう	英語名称
えいごひょうげん	英語表現
えいごのうりょく	英語能力
えいごきょういく	英語教育
えいごがくしゅう	英語学習
えいこくこうくう	英国航空
えいこくかいぐん	英国海軍
えいぎょうりょく	営業力
えいぎょうりえき	営業利益
えいぎょうほんぶ	営業本部
えいぎょうぶもん	営業部門
えいぎょうひみつ	営業秘密
えいぎょうばたけ	営業畑
えいぎょうねんど	営業年度
えいぎょうていし	営業停止
えいぎょうちゅう	営業中
えいぎょうじょう	営業上
えいぎょうじかん	営業時間
えいぎょうしょく	営業職
えいぎょうこうい	営業行為
えいぎょうきょか	営業許可
えいぎょうきそく	営業規則
えいぎょうかいし	営業開始
えいきょうりょく	影響力
えいきゅうほぞん	永久保存
えいきゅうほうき	永久放棄
えいきゅうとうど	永久凍土
えいきゅうていし	永久停止
えいきゅうきかん	永久機関
えいがひょうろん	映画評論
えいがないえいが	映画内映画
えいがげきじょう	映画劇場
えいがげいじゅつ	映画芸術
えいがかんしょう	映画鑑賞	映画観賞
えいいたんちょう	嬰イ短調
うんようほうほう	運用方法
うんようばんごう	運用番号
うんようたいせい	運用体制
うんようじっせき	運用実績
うんようじっけん	運用実験
うんようけいけん	運用経験
うんようきゅうし	運用休止
うんゆしょうがわ	運輸省側
うんゆぎょうせい	運輸行政
うんぱんしゅだん	運搬手段
うんぱんさいぼう	運搬細胞
うんどうほうそく	運動法則
うんどうほうこう	運動方向
うんどうぶったい	運動物体
うんどうせいぶん	運動成分
うんどうせいのう	運動性能
うんどうせいぎょ	運動制御
うんどうしんけい	運動神経
うんどうこうぞう	運動構造
うんどうこうえん	運動公園
うんどうきこうか	運動機構課
うんどうがくてき	運動学的
うんてんめんきょ	運転免許
うんてんほんすう	運転本数
うんてんほうほう	運転方法
うんてんていしゃ	運転停車
うんてんせきよこ	運転席横
うんてんせきがわ	運転席側
うんてんしゃせき	運転者席
うんてんさいかい	運転再開
うんてんけいとう	運転系統
うんてんけいたい	運転形態
うんてんぎりょう	運転技量
うんてんぎじゅつ	運転技術
うんてんかんかく	運転間隔	運転感覚
うんちんひょうじ	運賃表示
うんちんたいけい	運賃体系
うんちんけいさん	運賃計算
うんちんかんけい	運賃関係
うんちんかいてい	運賃改定
うんちんかいせい	運賃改正
うんそうやっかん	運送約款
うんそうけいやく	運送契約
うんそうがいしゃ	運送会社
うんぜんこうえん	雲仙公園
うんしょうむさん	雲消霧散
うんしゅうむさん	雲集霧散
うんしゅうみかん	温州蜜柑
うんさんむしょう	雲散霧消
うんこうにってい	運航日程
うんこうちゅうし	運航中止
うんこうけいたい	運行形態
うんけいじょうぎ	雲型定規
うんえいほうほう	運営方法
うんえいほうしん	運営方針
うんえいどりょく	運営努力
うんえいしゃがわ	運営者側
うんえいがいしゃ	運営会社
うんえいかつどう	運営活動
うんうんにりうむ	Uun	Ununnilium
うんうんうにうむ	Uuu	Unununium
うりあげだいすう	売上台数
うりあげぞうだい	売上増大
うりあげさいけん	売上債権
うらわでんしゃく	浦和電車区
うらめんさいせい	裏面再生
うらじおすとっく	浦鹽斯徳
うらがみえきまえ	浦上駅前
うらがきじょうと	裏書譲渡
うめだかもつせん	梅田貨物線
うめだかもつえき	梅田貨物駅
うみせんやません	海千山千
うまのすずくさか	Aristolochiaceae	ウマノスズクサ科
うてんじゅんえん	雨天順延
うつほものがたり	宇津保物語
うちゅうりょこう	宇宙旅行
うちゅうひこうし	宇宙飛行士
うちゅうていすう	宇宙定数
うちゅうていおう	宇宙帝王
うちゅうつうしん	宇宙通信
うちゅうそうせい	宇宙創成
うちゅうぜんたい	宇宙全体
うちゅうぜろねん	宇宙零年
うちゅうせんない	宇宙船内
うちゅうせんとう	宇宙戦闘
うちゅうせんそう	宇宙戦争
うちゅうせんかん	宇宙戦艦
うちゅうじっけん	宇宙実験
うちゅうこうがく	宇宙工学
うちゅうくうかん	宇宙空間
うちゅうかいぶつ	宇宙怪物
うちゅうかいはつ	宇宙開発
うちゅうかいぞく	宇宙海賊
うちゅうえいゆう	宇宙英雄
うちむらかんぞう	内村鑑三
うちまたごうやく	内股膏薬
うちぼうせんそが	内房線蘇我
うたひめでんせつ	歌姫伝説
うたがわひろしげ	歌川広重
うたがわくによし	歌川国芳
うせつしゃかいひ	右折車回避
うずどほぞんそく	渦度保存則
うすくちしょうゆ	薄口醤油
うじょうふくよう	羽状複葉
うじじゅうじょう	宇治十帖
うしろまわしげり	後ろ廻し蹴り
うしおしゅっぱん	潮出版
うげつものがたり	雨月物語
うけつけばんごう	受付番号
うぐいすだにえき	鶯谷駅
うかいうんてんじ	迂回運転時
うおざききたまち	魚崎北町
うえのひろこうじ	上野広小路
うえのちょくつう	上野直通
うえすぎまさとら	上杉政虎
うえすぎてるとら	上杉輝虎
うえすぎけんしん	上杉謙信
うぇるたーきゅう	ウェルター級
いんようほうほう	引用方法
いんようぶんけん	引用文献
いんぷくかんすう	陰伏関数
いんにんじちょう	隠忍自重
いんないかんせん	院内感染
いんだすぶんめい	インダス文明
いんたいせんげん	引退宣言
いんたいじょゆう	引退女優
いんたいあいさつ	引退挨拶
いんそつきょうし	引率教師
いんぜみしりょう	院ゼミ資料
いんせきかんけい	姻戚関係
いんせいぜんたい	院生全体
いんすうぶんかい	因数分解
いんじゅんこそく	因循姑息
いんじひょうげん	印字表現
いんじかんきょう	印字環境
いんしょくぎょう	飲食業
いんしょうしゅぎ	印象主義
いんしゅうんてん	飲酒運転
いんさつまいすう	印刷枚数
いんさつほうほう	印刷方法
いんさつばいたい	印刷媒体
いんさつていさい	印刷体裁
いんさつげんこう	印刷原稿
いんさつけいしき	印刷形式
いんさつぎじゅつ	印刷技術
いんさつがいしゃ	印刷会社
いんがてきけっか	因果的結果
いんかんとうろく	印鑑登録
いんかしょくぶつ	隠花植物
いわにちきたせん	岩日北線
いわなみぜんしょ	岩波全書
いわなみしんしょ	岩波新書
いわなみしょてん	岩波書店
いわさきつうしん	岩崎通信
いわさきしょてん	岩崎書店
いわさききょうこ	岩崎恭子
いろさいげんせい	色再現性
いるましていしゃ	入間市停車
いるいがっちゃく	異類合着
いりょうもんだい	医療問題
いりょうもくてき	医療目的
いりょうほうじん	医療法人
いりょうひんてん	衣料品店
いりょうひふたん	医療費負担
いりょうてんすう	医療点数
いりょうそくてい	医療測定
いりょうそうだん	医療相談
いりょうせいひん	医療製品	衣料製品
いりょうしんだん	医療診断
いりょうこうがく	医療工学
いりょうぎじゅつ	医療技術
いりょうかんけい	医療関係
いりょういっぱん	医療一般
いらいたいしょく	依頼退職
いようこうぶんし	医用高分子
いやくぶんぎょう	医薬分業
いやくぶがいひん	医薬部外品
いみふめいりょう	意味不明瞭
いみてきひょうき	意味的表記
いまでがわどおり	今出川通り
いほうちゅうしゃ	違法駐車
いほうじょうたい	違法状態
いほうかいぞうき	違法改造機
いぷしろんせんい	ε遷移
いぶすきおんせん	指宿温泉
いばらぎほうそう	茨城放送
いばらぎだいがく	茨城大学
いばらぎけんみん	茨城県民
いばらぎけんない	茨城県内
いはんしゃりょう	違反車両
いはんこうほしゃ	違反候補者
いのうえようすい	井上陽水
いにんけいりきん	委任経理金
いなもりざいだん	稲盛財団
いなさくでんらい	稲作伝来
いなおりごうとう	居直り強盗
いどうたいでんわ	移動体電話
いどうこうひょう	移動公表
いとーよーかどう	イトーヨーカ堂
いでんじょうほう	遺伝情報
いでんしはいれつ	遺伝子配列
いでんしちりょう	遺伝子治療
いでんしぜんたい	遺伝子全体
いでんししっかん	遺伝子疾患
いでんしさいぼう	遺伝子細胞
いでんしごうせい	遺伝子合成
いでんしこうがく	遺伝子工学
いでんしくみかえ	遺伝子組み換え	遺伝子組換え
いでんしかんれん	遺伝子関連
いでんしかんけい	遺伝子関係
いでんしかいせき	遺伝子解析
いでんしいじょう	遺伝子異常
いっぽんぢょうし	一本調子
いっぽんしょうぶ	一本勝負
いっぽうてききじ	一方的記事
いっぽうつうこう	一方通行
いっぷたさいせい	一夫多妻制
いっぴんりょうり	一品料理
いっぴきおおかみ	一匹狼
いっぱんろんぶん	一般論文
いっぱんろんてき	一般論的
いっぱんれっしゃ	一般列車
いっぱんりょこう	一般旅行
いっぱんまどぐち	一般窓口
いっぱんほうそく	一般法則
いっぱんはつばい	一般発売
いっぱんにゅうし	一般入試
いっぱんどくしゃ	一般読者
いっぱんとうろく	一般登録
いっぱんとうしか	一般投資家
いっぱんとうえい	一般投影
いっぱんせんしゅ	一般選手
いっぱんせんきょ	一般選挙
いっぱんせつびひ	一般設備費
いっぱんせいかつ	一般生活
いっぱんじょせい	一般女性
いっぱんしょもつ	一般書物
いっぱんしょみん	一般庶民
いっぱんしょてん	一般書店
いっぱんしょせき	一般書籍
いっぱんしゃしん	一般写真
いっぱんしゃかい	一般社会
いっぱんしゃいん	一般社員
いっぱんしつもん	一般質問
いっぱんしじょう	一般市場	一般誌上
いっぱんざひょう	一般座標
いっぱんざいげん	一般財源
いっぱんさつえい	一般撮影
いっぱんこくみん	一般国民
いっぱんこくどう	一般国道
いっぱんこうどう	一般公道
いっぱんこうつう	一般交通
いっぱんこうかい	一般公開
いっぱんこうえん	一般講演
いっぱんぐんじん	一般軍人
いっぱんきじゅん	一般基準
いっぱんきぎょう	一般企業
いっぱんかりょく	一般化力
いっぱんかいけい	一般会計
いっぱんかいいん	一般会員
いっぱんえんだい	一般演題
いっぱつろくおん	一発録音
いっぱつへんかん	一発変換
いっぱつしょうぶ	一発勝負
いっぱつけいそく	一発計測
いっぱくりょこう	一泊旅行
いっぱくえんぱく	一泊延泊
いっぱいいっぱい	一杯一杯
いっとくいっしつ	一得一失
いっとうどくさい	一党独裁
いってんとうしず	一点透視図
いってきせんきん	一擲千金
いっていねんげん	一定年限
いっていじかんご	一定時間後
いっていしゅうき	一定周期
いっていきょうど	一定強度
いっていかんかく	一定間隔
いっていかいてん	一定回転
いっていいじょう	一定以上
いっちょういっし	一張一弛
いったんでんげん	一端電源
いったんちゅうし	一旦中止
いったいなにもの	一体何者
いったいぜんたい	一体全体
いったいせいけい	一体成形
いっせんまんえん	一千万円
いっせんねんまえ	一千年前
いっせつたしょう	一殺多生
いっせきにちょう	一石二鳥
いっせいしゃげき	一斉射撃
いっせいこうげき	一斉攻撃
いっせいいちだい	一世一代
いっしんどうたい	一心同体
いっしんいったい	一進一退
いっしょけんめい	一所懸命
いっしゅんでんき	一瞬電気
いっしゅどくとく	一種独特
いっしゅうかんご	一週間後
いっさんかちっそ	一酸化窒素
いっさんかたんそ	一酸化炭素
いっさいふかのう	一切不可能
いっさいせきにん	一切責任
いっさいがっさい	一切合財	一切合切
いっこくたいざい	一国滞在
いっこくせんきん	一刻千金
いっこうじゅつご	1項述語
いっこうかんけい	1項関係	一項関係
いっきょこうかい	一挙公開
いっきょいちどう	一挙一動
いっかつほしょう	一括補償
いっかつへんかん	一括変換
いっかつとうろく	一括登録
いっかつそうしん	一括送信
いっかつさくじょ	一括削除
いっかくせんにん	一角仙人
いっかくせんきん	一獲千金	一攫千金
いっかくじゅうざ	一角獣座
いちわりいじょう	一割以上
いちろくぎんこう	一六銀行
いちるいそうしゃ	一塁走者
いちりつふなばし	市立船橋
いちりつひかぜい	一律非課税
いちらんひょうじ	一覧表示
いちらんさくせい	一覧作成
いちようらんすう	一様乱数
いちようらいふく	一陽来復
いちょうけいこう	異聴傾向
いちもんはんせん	一文半銭
いちもんいっとう	一問一答
いちもじひょうじ	一文字表示
いちみとうがらし	一味唐辛子
いちまんえんぶん	一万円分
いちまんえんさつ	一万円札
いちまいかんばん	一枚看板
いちぼくいっそう	一木一草
いちぶんかいのう	位置分解能
いちぶりょうがえ	一部両替
いちぶへんしゅう	一部編集
いちぶふくせんか	一部複線化
いちぶはっぴょう	一部発表
いちぶしゅうせい	一部修正
いちぶしゃりょう	一部車両
いちぶしていせき	一部指定席
いちぶかっそうか	一部滑走可
いちびょうたんい	一秒単位
いちひめにたろう	一姫二太郎
いちばんもんだい	一番問題
いちばんみぎがわ	一番右側
いちばんていとう	一番抵当
いちばんたいせつ	一番大切
いちばんじょうず	一番上手
いちばんざんねん	一番残念
いちばんさいしょ	一番最初
いちばんさいきん	一番最近
いちばんさいあく	一番最悪
いちばんこうりつ	一番効率
いちばんかんたん	一番簡単
いちばんかんじん	一番肝腎	一番肝心
いちばんかくじつ	一番確実
いちばんあんてい	一番安定
いちばんあんぜん	一番安全
いちばんあんしん	一番安心
いちねんけいやく	一年契約
いちねんいじょう	一年以上
いちにんとうせん	一人当千
いちにちにしょく	一日二食
いちにちたいざい	一日滞在
いちにちいっかい	一日一回
いちにちいちぜん	一日一善
いちちほうそしき	一地方組織
いちだんへんそく	一段変速
いちだんかつよう	一段活用
いちだんかくした	一段格下
いちだくせんきん	一諾千金
いちだいざっしゅ	一代雑種
いちだいけっしん	一大決心
いちぞくろうとう	一族郎党
いちじちゅうだん	一時中断
いちじせいちょう	一次生長
いちじしょうがい	一次障害
いちじこくゆうか	一時国有化
いちじきもんだい	一時期問題
いちじきざいせき	一時期在籍
いちじきかつどう	一時期活動
いちじかんいない	一時間以内
いちじいかんそく	一次維管束
いちしょうじょう	一症状
いちしゅうきょう	一宗教
いちしちょうしゃ	一視聴者
いちげきひっさつ	一撃必殺
いちけんしゅつぶ	位置検出部
いちぐんとうろく	一軍登録
いちぎょうやろう	一行野郎
いちぎゅうめいち	一牛鳴地
いちがくねんした	一学年下
いちかわだいもん	市川大門
いちかいけつほう	一解決法
いちおうふくぶん	一往復分
いちおうかくにん	一応確認
いちいんとうてい	一韻到底
いたれりつくせり	至れり尽くせり	至れり尽せり
いたくけんきゅう	委託研究
いたがきたいすけ	板垣退助
いぞんじょうほう	依存情報
いぞんかいせきぶ	依存解析部
いそうぶんかつき	位相分割器
いそうとうかせい	移送透過性
いそうじょうほう	位相情報
いせざきほんせん	伊勢崎本線
いずみちゅうおう	泉中央
いずきゅうしもだ	伊豆急下田
いすずじどうしゃ	いすゞ自動車
いじょうぶんさん	異常分散
いじょうはんざい	異常犯罪
いじょうはっせい	異常発生
いじょうそうこう	異常走行
いじょうせいよく	異常性欲
いじょうじんかく	異常人格
いじょうしんどう	異常振動
いじょうこうどう	異常行動
いじょうきしょう	異常気象
いじょういでんし	異常遺伝子
いじげんくうかん	異次元空間
いしょくどうげん	医食同源
いしょくてじゅん	移植手順
いしょくさぎょう	移植作業
いしょうとうろく	意匠登録
いしゅかんきょう	異種環境
いしゅかくとうぎ	異種格闘技
いしやかわしゃこ	石屋川車庫
いしゃきぼうしゃ	医者希望者
いしこっかしけん	医師国家試験
いしけっていしゃ	意思決定者
いしきしょうがい	意識障害
いしがきくうこう	石垣空港
いしかわたくぼく	石川啄木
いしかわごえもん	石川五右衛門
いしかわこうせん	石川高専
いしかわけんない	石川県内
いざなぎのみこと	伊邪那岐命	伊弉諾尊
いさんかたしょう	胃酸過多症
いこくじょうちょ	異国情緒
いこうそちきかん	移行措置期間
いけんひょうめい	意見表明
いけんじょうこう	違憲条項
いけぶくろとうぶ	池袋東武
いけぶくろせいぶ	池袋西武
いけじりおおはし	池尻大橋
いくせいじぎょう	育成事業
いくじさんぎょう	育児産業
いくさものがたり	軍物語
いきさきひょうじ	行先表示
いきさきあんない	行先案内
いがんめんしょく	依願免職
いがんたいしょく	依願退職
いがくてきちしき	医学的知識
いがくけんきゅう	医学研究
いがくおんきょう	医学音響
いかしょうりゃく	以下省略
いえでしょうじょ	家出少女
いいんちょうあて	委員長宛
いいんかいないぶ	委員会内部
いいんかいそしき	委員会組織
いいんかいせいど	委員会制度
いいんかいかんり	委員会管理
いいんかいいにん	委員会委任
いいざかおんせん	飯坂温泉
いいくらかたまち	飯倉片町
いあくじょうそう	帷幄上奏
あんりょくしょく	暗緑色
あんねいてんのう	安寧天皇
あんねいちつじょ	安寧秩序
あんないほうそう	案内放送
あんないぶんしょ	案内文書
あんないひょうじ	案内表示
あんないどうこう	案内同行
あんないかんばん	案内看板
あんどうひろしげ	安藤広重
あんとくてんのう	安徳天皇
あんていせいそう	安定成層
あんていこうぞう	安定構造
あんちゅうもさく	暗中模索
あんちゅうひやく	暗中飛躍
あんそくこうさん	安息香酸
あんぜんほしょう	安全保障
あんぜんひょうか	安全評価
あんぜんだいいち	安全第一
あんぜんたいさく	安全対策
あんぜんそうこう	安全走行
あんぜんせんげん	安全宣言
あんぜんきじゅん	安全基準
あんぜんがわせん	安全側線
あんぜんかくにん	安全確認
あんぜんかくじつ	安全確実
あんぜんえいせい	安全衛生
あんぜんうんてん	安全運転
あんじりょうほう	暗示療法
あんじょうふあん	鞍上不安
あんしんりつめい	安心立命
あんさつめいれい	暗殺命令
あんさつけいかく	暗殺計画
あんごうさくひん	暗号作品
あんこくぶっしつ	暗黒物質
あんこくたいりく	暗黒大陸
あんこくせいうん	暗黒星雲
あんこくくうかん	暗黒空間
あんこうてんのう	安康天皇
あんがいとくてん	案外得点
あんがいかんたん	案外簡単
あんかんてんのう	安閑天皇
あわじちょうえき	淡路町駅
あるふぁりゅうし	α粒子
あるふぁほうかい	α崩壊
ありがためいわく	有り難迷惑
あらかわおきえき	荒川沖駅
あやめもくあぐん	アヤメ目亜群
あめやよこちょう	アメヤ横丁
あめふりょうばば	雨不良馬場
あまみぐんとうく	奄美群島区
あまどりのみこと	天鳥命
あまがさばんぐみ	雨傘番組
あへんちゅうどく	阿片中毒
あなろぐほうそう	アナログ放送
あっしゅくくうき	圧縮空気
あっしゅくきのう	圧縮機能
あっこうぞうごん	悪口雑言
あっかんたんてい	悪漢探偵
あだたらこうげん	安達良高原	安達太良高原
あすてかぶんめい	アステカ文明
あしょうさんえん	亜硝酸塩
あしやがんのすけ	芦屋雁之助
あしひっさつわざ	足必殺技
あしかがよしみつ	足利義満
あしかがたかうじ	足利尊氏
あしかがこうこう	足利高校
あざぶじゅうばん	麻布十番
あさひやしょてん	旭屋書店
あさひちょうかん	朝日朝刊
あさくらしょてん	朝倉書店
あさくさほうめん	浅草方面
あさくさばしえき	浅草橋駅
あさぎりこうげん	朝霧高原
あくにんしょうき	悪人正機
あくとくだんたい	悪徳団体
あくとくがくえん	悪徳学園
あくたがわやすし	芥川也寸志
あくたがわしょう	芥川賞
あくせんときごう	アクセント記号
あくせいしゅよう	悪性腫瘍
あくじょうけんか	悪条件下
あくしょついほう	悪書追放
あくぎゃくむどう	悪逆無道
あくうかんひこう	亜空間飛行
あきゅーせいでん	阿Ｑ正伝
あきはばらかかく	秋葉原価格
あきさめぜんせん	秋雨前線
あきかわけいこく	秋川渓谷
あかふくほんてん	赤福本店
あかでみーしょう	アカデミー賞
あかしかいきょう	明石海峡
あかさかほんしゃ	赤坂本社
あおやまほうめん	青山方面
あおやまがくいん	青山学院
あおもりけんじん	青森県人
あおもりうんゆく	青森運輸区
あおしんごうがわ	青信号側
あおくびだいこん	青首大根
あおいろしんこく	青色申告
あいばじょうほう	愛馬情報
あいてしゃりょう	相手車両
あいてきゅうだん	相手球団
あいづわかまつし	会津若松市
あいちこうじょう	愛知工場
あいたいばいばい	相対売買
あいしょうひょう	相性表
あいしょうきょく	愛唱曲
あいしゃせいしん	愛社精神
あいこくこうこう	愛国高校
あいがんどうぶつ	愛玩動物
あいうえおじゅん	アイウエオ順	あいうえお順
おんねつりょうほう	温熱療法
おんなじゅうどうか	女柔道家
おんどじょうしょう	温度上昇
おんだんかよういん	温暖化要因
おんたいていきあつ	温帯低気圧
おんぞんりょうほう	温存療法
おんせんりょうほう	温泉療法
おんせんよくじょう	温泉浴場
おんせんじょうほう	温泉情報
おんせんかんこうち	温泉観光地
おんせいじょうほう	音声情報
おんせいしゅうろく	音声収録
おんせいけんきゅう	音声研究
おんじょうせいぎょ	音場制御
おんじょうさいせい	音場再生
おんじょうかいせき	音場解析
おんじゅうとんこう	温柔敦厚
おんしょくはいれつ	音色配列
おんしつこうじょう	音質向上
おんこうろんしゅう	音講論集
おんきょうほうそく	音響法則
おんきょうぶんせき	音響分析
おんきょうはいぶん	音強配分
おんきょうとくせい	音響特性
おんきょうつうしん	音響通信
おんきょうせっけい	音響設計
おんきょうじゅしん	音響受信
おんきょうしんごう	音響信号
おんきょうごうせい	音響合成
おんきょうこうけん	音響工研
おんきょうこうがく	音響工学
おんきょうくうかん	音響空間
おんきょうぎじゅつ	音響技術
おんきょうがっかい	音響学会
おんがくのともしゃ	音楽之友社
おんがくてきようと	音楽的用途
おんがくぜんしゅう	音楽全集
おんがくじょうほう	音楽情報
おんがくしんりがく	音楽心理学
おんがくしゅっぱん	音楽出版
おんがくしゅうだん	音楽集団
おんがくさんぎょう	音楽産業
おんがくさいせいき	音楽再生機
おんがくこうぎょう	音楽工業
おんがくげいじゅつ	音楽芸術
おんがくけんきゅう	音楽研究
おんがくぎょうしゃ	音楽業者
おんがくぎょうかい	音楽業界
おんがくきょうしつ	音楽教室
おんがくきょういく	音楽教育
おんがくきかいろん	音楽機械論
おんがくかんしょう	音楽鑑賞
おんがくおんきょう	音楽音響
おんかいれんしゅう	音階練習
おんいんじょうほう	音韻情報
おんいんかんきょり	音韻間距離
おろしうりしじょう	卸売市場
おやひとりこひとり	親一人子一人
おもてさんどうてん	表参道店
おもてさんどうえき	表参道駅
おもてうらいったい	表裏一体
おぷしょんとりひき	オプション取引
おぶじぇくとしこう	オブジェクト指向
おねがいいたします	お願いいたします
おなみだちょうだい	お涙頂戴
おちくぼものがたり	落窪物語
おだきゅうれんらく	小田急連絡
おだきゅうたません	小田急多摩線
おだきゅうせんない	小田急線内
おだきゅうえんせん	小田急沿線
おせんじょうきょう	汚染状況
おしくらまんじゅう	押し競饅頭
おくまんちょうじゃ	億万長者
おきなわりょうりや	沖縄料理屋
おきあいぎょぎょう	沖合漁業
おがさわらしょとう	小笠原諸島
おがさわらきんかい	小笠原近海
おかさんしょうけん	岡三証券
おおもじえいすうじ	大文字英数字
おおみやこうじょう	大宮工場
おおふなでんしゃく	大船電車区
おおとものやかもち	大伴家持
おおつまじょしだい	大妻女子大
おおつせんぜんせん	大津線全線
おおぜきしょうしん	大関昇進
おおさきでんしゃく	大崎電車区
おおさかべんわしゃ	大阪弁話者
おおさかぶんかけん	大阪文化圏
おおさかふりつだい	大阪府立大
おおさかにほんばし	大阪日本橋
おおさかじゅうたい	大阪渋滞
おおさかしゃかいぶ	大阪社会部
おおさかしちかてつ	大阪市地下鉄
おおさかこうべかん	大阪神戸間
おおさかおうしょう	大阪王将
おおげつひめのかみ	大宜津比売神	大気津比売神
おおぐちこうにゅう	大口購入
おおくにぬしのかみ	大国主神
おおぎまちこうえん	扇町公園
おおがたれんきゅう	大型連休
おおがたはんようき	大型汎用機
おおがたつりぐてん	大型釣具店
おおがたすいはんき	大型炊飯器
おおがたしゃりょう	大型車両
おおがたさんきゃく	大型三脚
おおがたけいさんき	大型計算機
おおがたきょうたい	大型筐体
おおがたかもつしゃ	大型貨物車
おおかわこうぎょう	大川興業
おおかみしょうねん	狼少年
おおえどそうさもう	大江戸捜査網
おおえけんざぶろう	大江健三郎
おおいむさしのかん	大井武蔵野館
おおいまちほうめん	大井町方面
おおいずみがくえん	大泉学園
おおいがわてつどう	大井川鉄道
おうようりょういき	応用領域
おうようぶつりがく	応用物理学
おうようすうがっか	応用数学科
おうようすうがくか	応用数学科
おうようすいしんか	応用推進課
おうようじょうほう	応用情報
おうようけんきゅう	応用研究
おうようぎじゅつぶ	応用技術部
おうようおんきょう	応用音響
おうむしんりきょう	オウム真理教
おうぼじょうきょう	応募状況
おうぼしゃりまわり	応募者利回り
おうぼしゃふくすう	応募者複数
おうぼしゃぜんいん	応募者全員
おうべいれっきょう	欧米列強
おうぶんしゃぶんこ	旺文社文庫
おうふくえんちょう	往復延長
おうびりんだいがく	桜美林大学
おうびりんこうこう	桜美林高校
おうとうしゅっぱん	桜桃出版
おうとうきょくせん	応答曲線
おうちょうぶんがく	王朝文学
おうだんほこうしゃ	横断歩行者
おうじゅほうしょう	黄綬褒章
おうしゅうほうめん	欧州方面
おうしゅうふじわら	奥州藤原
おうしゅうしょこく	欧州諸国
おうしゅうしじょう	欧州市場
おうしゅうかっこく	欧州各国
おうざとういつせん	王座統一戦
おうざけっていせん	王座決定戦
おうごんものがたり	黄金物語
おうごんしゅうかん	黄金週間
おうきゅうたいさく	応急対策
おうきゅうしゅうり	応急修理
おうえんだんちょう	応援団長
おううせんやまがた	奥羽線山形
えんようぎょぎょう	遠洋漁業
えんぱくりょうきん	延泊料金
えんどうしゅうさく	遠藤周作
えんちょくほうこう	鉛直方向
えんちょくこうぞう	鉛直構造
えんちょうぜんはん	延長前半
えんちょうけいかく	延長計画
えんちょううんてん	延長運転
えんそうれんしゅう	演奏練習
えんそうひょうげん	演奏表現
えんそうのうりょく	演奏能力
えんそうじょうほう	演奏情報
えんそうきょくもく	演奏曲目
えんそうあいこうか	演奏愛好家
えんせんじゅうみん	沿線住民
えんしょくはんのう	炎色反応
えんしょうこばなし	艶笑小噺
えんしゅうもんだい	演習問題
えんしゅうてつどう	遠州鉄道
えんしゅうおおはし	遠州大橋
えんざんのうりょく	演算能力
えんざんじゅんじょ	演算順序
えんざんこうそくか	演算高速化
えんげきしゅうだん	演劇集団
えんげいたいしょう	演芸大賞
えんけいひょうしき	円形標識
えんけいげきじょう	円形劇場
えんきょりつうきん	遠距離通勤
えんきょりじゅしん	遠距離受信
えんきょりこうげき	遠距離攻撃
えんきどううんどう	円軌道運動
えんがんゆうしょう	沿岸湧昇
えんがんけいびたい	沿岸警備隊
えんがんぎょぎょう	沿岸漁業
えんかびにるじゅし	塩化ビニル樹脂
えひめしんぶんしゃ	愛媛新聞社
えねるぎーそんしつ	エネルギー損失
えぬじげんくうかん	Ｎ次元空間
えぬえちけいほーる	ＮＨＫホール
えつらんせいきゅう	閲覧請求
えっちゅうふんどし	越中褌
えすびーしょくひん	エスビー食品	ヱスビー食品
えきめいしょういん	駅名小印
えきめいかいしょう	駅名改称
えきべんぎょうしゃ	駅弁業者
えきたいねんりょう	液体燃料
えきたいすいしょう	液体水晶
えきそんしつじかん	駅損失時間
えきせいぎょそうち	駅制御装置
えきしょうもにたー	液晶モニター
えきしょうひょうじ	液晶表示
えきしゅうへんちず	駅周辺地図
えきおんちょうせつ	液温調節
えきいんはいちえき	駅員配置駅
えいわちゅうじてん	英和中辞典
えいろちょうちょう	嬰ロ長調
えいりんしょちょう	営林署長
えいりもくてきふか	営利目的不可
えいりもくてききじ	営利目的記事
えいようはんしょく	栄養繁殖
えいようせいしょく	栄養生殖
えいようじょうたい	栄養状態
えいようしょうがい	栄養障害
えいようしっちょう	栄養失調
えいようけいちょう	栄養茎頂
えいようかけいさん	栄養価計算
えいほちょうちょう	嬰ホ長調
えいべいりょうこく	英米両国
えいへちょうちょう	嬰ヘ長調
えいぶんかいしゃく	英文解釈
えいふつかいきょう	英仏海峡
えいはちょうちょう	嬰ハ長調
えいにちょうちょう	嬰ニ長調
えいとちょうちょう	嬰ト長調
えいだんりょうきん	営団料金
えいだんひびやせん	営団日比谷線
えいだんちよだせん	営団千代田線
えいだんぎんざせん	営団銀座線
えいだいさんぎょう	永大産業
えいぞうひょうげん	映像表現
えいぞうたいしょう	映像大賞
えいぞうせいさくぶ	映像制作部
えいぞうじょうほう	映像情報
えいせいちゅうりつ	永世中立
えいせいちゅうけい	衛星中継
えいせいじょうたい	衛生状態
えいせいかんきょう	衛生環境
えいせいおうしょう	永世王将
えいじにゅうりょく	英字入力
えいさいきょういく	英才教育
えいごにゅうりょく	英語入力
えいぎょうれっしゃ	営業列車
えいぎょうぼうがい	営業妨害
えいぎょうぶちょう	営業部長
えいぎょうにっすう	営業日数
えいぎょうたんとう	営業担当
えいぎょうせいさく	営業政策
えいぎょうじょうと	営業譲渡
えいぎょうしょめい	営業所名
えいぎょうしょとく	営業所得
えいぎょうしょすう	営業所数
えいぎょうしゃてき	営業車的
えいぎょうけいすう	営業係数	営業系数
えいぎょうきょてん	営業拠点
えいぎょうきゅうし	営業休止
えいぎょうかんりか	営業管理課
えいぎょうかつどう	営業活動
えいぎょうかちょう	営業課長
えいぎょううんてん	営業運転
えいぎょうあんない	営業案内
えいきょうちょうさ	影響調査
えいきょうけんちょ	影響顕著
えいきゅうほしょう	永久保証
えいきゅうついほう	永久追放
えいきゅうじしゃく	永久磁石
えいきゅうけつばん	永久欠番
えいきゅうかいいん	永久会員
えいがひょうろんか	映画評論家
えいがせいさくしゃ	映画製作者
えいがかびんじょう	映画化便乗
えいかいわがっこう	英会話学校
えいかいわかんけい	英会話関係
えいいちょうちょう	嬰イ長調
えーきゅうせんぱん	Ａ級戦犯
うんようじょうたい	運用状態
うんようぎじゅつぶ	運用技術部
うんようかんりしゃ	運用管理者
うんゆしょうあいて	運輸省相手
うんどうぶそくぎみ	運動不足気味
うんどうのうりょく	運動能力
うんどうちゅうすう	運動中枢
うんどうじょうたい	運動状態
うんてんびちゅうい	運転日注意
うんてんのうりょく	運転能力
うんてんせきじょう	運転席上
うんてんしれいしょ	運転指令所
うんてんしゅこじん	運転手個人
うんてんしゃいがい	運転者以外
うんちんりょうきん	運賃料金
うんちんひょうじき	運賃表示機	運賃表示器
うんそうぎょうしゃ	運送業者
うんそうぎょうかい	運送業界
うんぜんふげんだけ	雲仙普賢岳
うんこうじょうけん	運行条件
うんこうじかんたい	運行時間帯
うんこうかいしまえ	運行開始前
うんえいのうりょく	運営能力
うんえいいいんかい	運営委員会
うんうんへきしうむ	Uuh	Ununhexium
うんうんくあじうむ	Ununquadium	Uuq
うんうんおくちうむ	Uuo	Ununoctium
うわじまじどうしゃ	宇和島自動車
うりあげこうせいひ	売上構成比
うらばんだいねこま	裏磐梯猫魔
うらぐちにゅうがく	裏口入学
うまのすずくさもく	ウマノスズクサ目	Aristolochiales
うてんきょうしゅう	雨天教習
うづきゅうめいがん	宇津救命丸
うつのみやだいがく	宇都宮大学
うちゅうろんばたけ	宇宙論畑
うちゅうねんだいき	宇宙年代記
うちゅうせんとうき	宇宙戦闘機
うちゅうじょうほう	宇宙情報
うちゅうげんしょう	宇宙現象
うちゅうかんきょう	宇宙環境
うちさいわいちょう	内幸町
うずどほうていしき	渦度方程式
うこうれんらくせん	宇高連絡船
うけわたしほうほう	受渡方法
うけとりしょうしょ	受取証書
うけとりかんじょう	受取勘定
うけつけねんがっぴ	受付年月日
うおざききたちょう	魚崎北町
うえのどうぶつえん	上野動物園
うえのえきまえてん	上野駅前店
うえのあおもりかん	上野青森間
うえつせんほうめん	羽越線方面
いんようぶんちゅう	引用文中
いんようさんしょう	引用参照
いんめんしょうきょ	隠面消去
いんぱるすおうとう	インパルス応答
いんたいひょうめい	引退表明
いんじしゅつりょく	印字出力
いんしょくてんがい	飲食店街
いんしょうひひょう	印象批評
いんしぶんせきほう	因子分析法
いんさつたいしょう	印刷対象
いんさつせいはんき	印刷製版機
いんさつしゅっぱん	印刷出版
いんさつぎょうかい	印刷業界
いんさつかのうもじ	印刷可能文字
いんぎょうてんのう	允恭天皇
いんきょくきんぼう	陰極近傍
いんがけっていろん	因果決定論
いんかんしょうめい	印鑑証明
いわなみぶんこばん	岩波文庫版
いわなみばんじしょ	岩波版辞書
いろはじるいしょう	色葉字類抄
いろしんごうしょり	色信号処理
いろこうじょうせい	色恒常性
いるいこんいんたん	異類婚姻譚
いりょうほうしゅう	医療報酬
いりょうひぜんたい	医療費全体
いりょうぎょうせい	医療行政
いりおもてやまねこ	西表山猫
いらくさもくあぐん	イラクサ目亜群
いほうようにんろん	違法容認論
いほうせんゆうぶつ	違法占有物
いほうせいそきゃく	違法性阻却
いほうかいぞうしゃ	違法改造車
いほううんてんしゃ	違法運転者
いばらぎけんほくぶ	茨城県北部
いのがしらこうえん	井の頭公園
いのかしらこうえん	井の頭公園
いにんとうちりょう	委任統治領
いどうりょくひょう	移動力表
いどうゆうよきかん	移動猶予期間
いどうつうしんもう	移動通信網
いどうたいつうしん	移動体通信
いどうさきさくせい	移動先作成
いどうけんけつしゃ	移動献血車
いとてきぎゃくさつ	意図的虐殺
いとうじゃくちゅう	伊藤若冲
いでんてきげんいん	遺伝的原因
いでんせいしっかん	遺伝性疾患
いでんしひょうげん	遺伝子表現
いでんしじょうほう	遺伝子情報
いでんあるごりずむ	遺伝アルゴリズム
いつくしまじんじゃ	厳島神社
いつかいちかいどう	五日市街道
いっぽんあしだほう	一本足打法
いっぽうつうこうろ	一方通行路
いっぷんはんていど	一分半程度
いっぴんいっしょう	一顰一笑
いっぴょういじょう	一票以上
いっぴつけいじょう	一筆啓上
いっぱんりようしゃ	一般利用者
いっぱんようてびき	一般用手引
いっぱんめいしょう	一般名称
いっぱんはつさんか	一般初参加
いっぱんはっぴょう	一般発表
いっぱんはいきぶつ	一般廃棄物
いっぱんにほんじん	一般日本人
いっぱんでんわよう	一般電話用
いっぱんてきりかい	一般的理解
いっぱんてきしよう	一般的使用
いっぱんたいしょく	一般退職
いっぱんたいしゅう	一般大衆
いっぱんぜいしゅう	一般税収
いっぱんせいきょう	一般生協
いっぱんじょうせい	一般情勢
いっぱんじょうしき	一般常識
いっぱんじゅうみん	一般住民
いっぱんじゅうたく	一般住宅
いっぱんしゃりょう	一般車両
いっぱんしていせき	一般指定席
いっぱんさんかしゃ	一般参加者
いっぱんこうかいび	一般公開日
いっぱんけんきゅう	一般研究
いっぱんきょうよう	一般教養
いっぱんきょうそう	一般競争
いっぱんきょうしょ	一般教書
いっぱんきょうかい	一般境界
いっぱんきょういく	一般教育
いっぱんきゃくしゃ	一般客車
いっぱんかんこうち	一般観光地
いっぱんかもんだい	一般化問題
いっぱんかばいあす	一般化バイアス
いっぱんかざひょう	一般化座標
いっぱんかがくしょ	一般科学書
いっぱんかいほうび	一般解放日
いっぱつぎゃくてん	一発逆転
いっぱつがくしゅう	一発学習
いっとうりょうだん	一刀両断
いっとうこうかいし	一等航海士
いってんしゅうごう	一点集合
いっていりょうきん	一定料金
いっていじかんない	一定時間内
いっついひかくほう	一対比較法
いっちょくせんてき	一直線的
いっちょういったん	一長一短
いっちょういっせき	一朝一夕
いっそうこうかてき	一層効果的
いっせいゆうきゅう	一斉有休
いっせいじゅぎょう	一斉授業
いっしょくそくはつ	一触即発
いっしょうけんめい	一生懸命
いっしょういっぱい	一勝一敗
いっしゅふじょうり	一種不条理
いっしゅくいっぱん	一宿一飯
いっしゅうようぶん	一周要聞
いっしゅうかんまえ	一週間前
いっしゅうかんほど	一週間程
いっしゅうかんぶん	一週間分
いっしゃていきょう	一社提供
いっしきにゅうしゅ	一式入手
いっさいむかんけい	一切無関係
いっこすうせんえん	一個数千円
いっこくせんしゅう	一刻千秋
いっこくいちじょう	一国一城
いっけんらくちゃく	一件落着
いっきょりょうどく	一挙両得
いっきょりょうとく	一挙両得
いっきょくこうぞう	一極構造
いっかんきょういく	一貫教育
いっかつこうにゅう	一括購入
いちれんたくしょう	一蓮托生
いちりゅうまんばい	一粒万倍
いちりゅうだいがく	一流大学
いちりゅうせんしゅ	一流選手
いちようしゅうそく	一様収束
いちょうしょうがい	胃腸障害
いちやくきゃっこう	一躍脚光
いちもじそうしゅつ	一文字送出
いちもくりょうぜん	一目瞭然
いちまんえんしへい	一万円紙幣
いちぶじょうじょう	一部上場
いちぶしょうりゃく	一部省略
いちぶきんえんせき	一部禁煙席
いちびょうそくさい	一病息災
いちばんひだりがわ	一番左側
いちばんたんじゅん	一番単純
いちばんじゅうよう	一番重要
いちばんこうかてき	一番効果的
いちばんきほんてき	一番基本的
いちばつひゃっかい	一罰百戒
いちねんかんしよう	一年間使用
いちにちてんちょう	一日店長
いちにちせんしゅう	一日千秋
いちにちしょちょう	一日署長
いちにちいっしょく	一日一食
いちじょうてんのう	一条天皇
いちじゅういっさい	一汁一菜
いちじほうていしき	一次方程式
いちじつせんしゅう	一日千秋
いちじつさんしゅう	一日三秋
いちじしょうりゃく	一字省略
いちじきどうにゅう	一時期導入
いちじかりいれきん	一時借入金
いちじおくれようそ	一次遅れ要素
いちげつさんしゅう	一月三舟
いちぎてきせきにん	一義的責任
いちかわえんのすけ	市川猿之助
いちおくえんきょう	一億円強
いたばしほんちょう	板橋本町
いたくほしょうきん	委託保証金
いたくはんばいひん	委託販売品
いたくしょうこきん	委託証拠金
いたいいたいびょう	イタイイタイ病
いそうくうかんろん	位相空間論
いそうきかこうぞう	位相幾何構造
いせじどうしゃどう	伊勢自動車道
いずもたいしゃまえ	出雲大社前
いずみたまがわかん	和泉多摩川間
いずはこねてつどう	伊豆箱根鉄道
いずながおかちょう	伊豆長岡町
いじょうはんしょく	異常繁殖
いじょうねんしょう	異常燃焼
いじょうぞうしょく	異常増殖
いじょうじょうたい	異常状態
いじょうしょくよく	異常食欲
いじょうげんしょう	異常現象
いじょうけんしゅつ	異常検出
いしょくじょうほう	移植情報
いしゅせいめいたい	異種生命体
いしはらゆうじろう	石原裕次郎
いしはらしんたろう	石原慎太郎
いしはらさんぎょう	石原産業
いしけっていかてい	意志決定過程
いしかわちょうえき	石川町駅
いしかわじまはりま	石川島播磨
いさんそうぞくけん	遺産相続権
いこまこうさくせん	生駒鋼索線
いこうゆうよきかん	移行猶予期間
いこうきかんちゅう	移行期間中
いけぶくろにしぐち	池袋西口
いけがみつうしんき	池上通信機
いくせいぼくじょう	育成牧場
いくじけいけんしゃ	育児経験者
いくじきゅうぎょう	育児休業
いくさひょうじょう	軍評定
いきさきせっていき	行先設定機
いきあたりばったり	行き当たりばったり
いがくてきもんだい	医学的問題
いがくてきこうさつ	医学的考察
いがくせいぶつけい	医学生物系
いがくけんきゅうか	医学研究科
いがくかんけいしゃ	医学関係者
いいんかいほうしき	委員会方式
いいんかいたいせい	委員会体制
いいんかいぜんたい	委員会全体
いいんかいせつりつ	委員会設立
いいんかいさくせい	委員会作成
いいんかいこうにん	委員会公認
いいんかいぎちょう	委員会議長
いいだばしほうめん	飯田橋方面
いあんふちょうよう	慰安婦徴用
いあんじょせつりつ	慰安所設立
あんないひょうしき	案内標識
あんどうしょうえき	安藤昌益
あんでぱんだんてん	アンデパンダン展
あんていせいりろん	安定性理論
あんていじょうたい	安定状態
あんていかでんげん	安定化電源
あんぜんせいかくほ	安全性確保
あんぜんこうしゅう	安全講習
あんぜんきょういく	安全教育
あんじょうきょうか	鞍上強化
あんじてきいんよう	暗示的引用
あんしょうばんごう	暗証番号
あんこくげいじゅつ	暗黒芸術
あるたみらどうくつ	アルタミラ洞窟
あるかりかんでんち	アルカリ乾電池
ありわらのなりひら	在原業平
ありむらさんぎょう	有村産業
ありのとうぐさもく	アリノトウグサ目	Haloragales
ありあけころしあむ	有明コロシアム
あらかわほうすいろ	荒川放水路
あらかわしゃこまえ	荒川車庫前
あやつりにんぎょう	操人形	操り人形
あまみおおしません	奄美大島線
あぼがどろていすう	アボガドロ定数
あぶくまきゅうこう	阿武隈急行
あつりょくだんたい	圧力団体
あつりょくこうばい	圧力勾配
あつりょくこうどう	圧力行動
あつりょくいじょう	圧力以上
あつぎえんそうかい	厚木演奏会
あっとうてきゆうり	圧倒的有利
あっとうてきたすう	圧倒的多数
あっせつじょうたい	圧雪状態
あっしゅくほうほう	圧縮方法
あっしゅくほうしき	圧縮方式
あっしゅくひょうき	圧縮表記
あっしゅくはいれつ	圧縮配列
あっしゅくこうりつ	圧縮効率
あっしゅくけいしき	圧縮形式
あっしゅくぎじゅつ	圧縮技術
あっしゅくきちょう	圧縮記帳
あしょうさんのうど	亜硝酸濃度
あしきしゅうきゅう	ア式蹴球
あさひつうしんしゃ	旭通信社
あさひしんぶんしゃ	朝日新聞社
あさひしんぶんけい	朝日新聞系
あさとうちゃくぶん	朝到着分
あくりょうたいさん	悪霊退散
あくとくしょうほう	悪徳商法
あくしつかめいてん	悪質加盟店
あかせがわげんぺい	赤瀬川原平
あかしんごうてまえ	赤信号手前
あかさかみつけてん	赤坂見附店
あかさかみつけえき	赤坂見附駅
あおぞらちゅうしゃ	青空駐車
あおぞらきょうしつ	青空教室
あおぞらかいがてん	青空絵画展
あいんすたいにうむ	Einsteinium	Es
あいどくしゃしょう	愛読者賞
あいづばんだいさん	会津磐梯山
あいづてつどうせん	会津鉄道線
あいちがくせんだい	愛知学泉大
あいちいかだいがく	愛知医科大学
あいぜんみょうおう	愛染明王
あいずばんだいさん	会津磐梯山
あいしょううらない	相性占い
あいしゃだいずかん	愛車大図鑑
おんりょうちょうせつ	音量調節
おんりょうちょうせい	音量調整
おんぞうきょりていい	音像距離定位
おんそべんべつそせい	音素弁別素性
おんそいちょうひょう	音素異聴表
おんせいりょうかいど	音声了解度
おんせいにゅうりょく	音声入力
おんせいてきたいおう	音声的対応
おんせいしょりかいろ	音声処理回路
おんせいしゅつりょく	音声出力
おんせいげんごしょり	音声言語処理
おんせいきょうちょう	音声強調
おんきょうてきこうい	音響的行為
おんきょうじょうほう	音響情報
おんきょうげんしょう	音響現象
おんきょうがっかいし	音響学会誌
おんきょうがいしょう	音響外傷
おんがくひょうろんか	音楽評論家
おんがくてきしゅほう	音楽的手法
おんがくてきこうぞう	音楽的構造
おんがくてきけいしき	音楽的形式
おんがくじょうきょう	音楽状況
おんがくじむしょなど	音楽事務所等
おんがくしょせんもん	音楽書専門
おんがくしょしんしゃ	音楽初心者
おんがくさいぜんせん	音楽最前線
おんがくがくせいよう	音楽学生用
おんがくかんけいしゃ	音楽関係者
おんがくいちばんかん	音楽壱番館
おんがくあいこうしゃ	音楽愛好者
おんいんせいくうかん	音韻性空間
おもしろやまこうげん	面白山高原
おばらりゅうかいかん	小原流会館
おのうえおんせんえき	小野上温泉駅
おにへいはんかちょう	鬼平犯科帳
おとしんごうでんそう	音信号伝送
おとぎりそうもくぐん	オトギリソウ目群	Hypericales
おでいはっせいりょう	汚泥発生量
おだわらひょうじょう	小田原評定
おだきゅうりようしゃ	小田急利用者
おだきゅうしんじゅく	小田急新宿
おだきゅうしゃりょう	小田急車両
おぐらにっけいしょう	小倉日経賞
おくないせつぞくよう	屋内接続用
おきなわほんとうない	沖縄本島内
おきなわけんてつどう	沖縄県鉄道
おきでんきこうぎょう	沖電気工業
おかやまきゅうじょう	岡山球場
おおふなえきかいさつ	大船駅改札
おおはらさんぜんいん	大原三千院
おおとりじんじゃまえ	大鳥神社前
おおてでんきがいしゃ	大手電気会社
おおてせきゆがいしゃ	大手石油会社
おおてしゅっぱんしゃ	大手出版社
おおたくたいいくかん	大田区体育館
おおしこうちのみつね	凡河内躬恒
おおしおへいはちろう	大塩平八郎
おおさかでんつうだい	大阪電通大
おおさかつうきんけん	大阪通勤圏
おおさかじぎょうしょ	大阪事業所
おおさかしょうちくざ	大阪松竹座
おおさかきゅうじょう	大阪球場
おおさかいかだいがく	大阪医科大学
おおごんはくぶつかん	黄金博物館
おおぐちしゅっししゃ	大口出資者
おおぐちさいけんしゃ	大口債権者
おおくらしょうぎょう	大倉商業
おおくにぬしのみこと	大国主命
おおがたじどうにりん	大型自動二輪
おおがたかんせつぜい	大型間接税
おおがたうちゅうせん	大型宇宙船
おおうらてんしゅどう	大浦天主堂
おうようぶつりがっか	応用物理学科
おうようでんしぶだい	応用電子部第
おうようすうがくてき	応用数学的
おうようぎじゅつしつ	応用技術室
おうようかいはつしつ	応用開発室
おうみちょうしじょう	近江町市場
おうぶんしょりきのう	欧文処理機能
おうふくぶんうんちん	往復分運賃
おうふくこうくうけん	往復航空券
おうしゅうふじわらし	奥州藤原氏
おうけんしんじゅせつ	王権神授説
おううほんせんほくぶ	奥羽本線北部
おういけいしょうしゃ	王位継承者
おいまわしじゅうたく	追廻住宅
おいこししゃせんがわ	追越車線側
えんちょうせんじょう	延長線上
えんそうかいけいしき	演奏会形式
えんしんちゅうぞうき	遠心鋳造機
えんしゅつたいしょう	演出対象
えんきょりりようしゃ	遠距離利用者
えんきょりたいしょう	遠距離対象
えどがわらんぽしょう	江戸川乱歩賞
えきめいひょうきばん	駅名表記板
えきまえさいかいはつ	駅前再開発
えきがくてきちょうさ	疫学的調査
えいりもくてきりよう	営利目的利用
えいりもくてきこうい	営利目的行為
えいりもくてききんし	営利目的禁止
えいりきょうげんぼん	絵入狂言本
えいようしどうかんり	栄養指導管理
えいようきけいちょう	栄養期茎頂
えいめいかんこうこう	穎明館高校
えいぶんかいせつしょ	英文解説書
えいでんでまちやなぎ	叡電出町柳
えいだんなんぼくせん	営団南北線
えいだんとうざいせん	営団東西線
えいぞうはくぶつかん	映像博物館
えいぞうしんごうよう	映像信号用
えいぞうしゅつりょく	映像出力
えいぞうきょうりょく	映像協力
えいざんてつどうせん	叡山鉄道線
えいこくたいざいしゃ	英国滞在者
えいぎょうじかんがい	営業時間外
えいぎょうがいひよう	営業外費用
えいぎょううんてんび	営業運転日
えいきゅうほぞんばん	永久保存版
えいがだいぜんしゅう	映画大全集
えいがじょうえいかい	映画上映会
えいがしゅだいきょく	映画主題曲
えいかくさんかくけい	鋭角三角形
えいかいわきょうしつ	英会話教室
えいかいわきょうざい	英会話教材
えいいしっぴつちゅう	鋭意執筆中
うんようしゅうりょう	運用終了
うんゆしょうかんりか	運輸省管理課
うんどうりょうゆそう	運動量輸送
うんどうほうていしき	運動方程式
うんどうこうえんない	運動公園内
うんてんせきこうほう	運転席後方
うんちんひょうじまく	運賃表示幕
うんちんしゅうにゅう	運賃収入
うんこうまえてんけん	運行前点検
うんこうじょうむいん	運航乗務員
うんこうじょうきょう	運行状況
うりあげけいさんしょ	売上計算書
うめだはんきゅうまえ	梅田阪急前
うまみちょうみりょう	旨味調味料
うつのみやこうじょう	宇都宮工場
うちゅうろんかんけい	宇宙論関係
うちゅうれきがんねん	宇宙歴元年
うちゅうにんじゃたい	宇宙忍者隊
うちゅうしょくみんち	宇宙植民地
うじがわきょうりょう	宇治川橋梁
うしごめやなぎちょう	牛込柳町
うしおしゅっぱんしゃ	潮出版社
うきよえびじゅつかん	浮世絵美術館
うかいうんてんちゅう	迂回運転中
いんようしゅうりょう	引用終了
いんぜいしゅうにゅう	印税収入
いんさつようげんこう	印刷用原稿
いんさつもじにんしき	印刷文字認識
いんさつしゅつりょく	印刷出力
いわなみこくごじてん	岩波国語辞典
いろしんごうせいぶん	色信号成分
いろしきべつばんごう	色識別番号
いれかわりたちかわり	入れ替わり立ち替わり
いりょうほけんせいど	医療保険制度
いりょうてきこうさつ	医療的考察
いりょうそうだんてき	医療相談的
いりょうじゅうじしゃ	医療従事者
いりょうかんけいしゃ	医療関係者
いよくてきはっぴょう	意欲的発表
いみひょうげんちゅう	意味表現中
いほうかいぞうぶひん	違法改造部品
いどうはんいへんこう	移動範囲変更
いどうたいじょうほう	移動体情報
いどうそくどせってい	移動速度設定
いどうしゅうりょうび	移動終了日
いとうちゅうしょうじ	伊藤忠商事
いでんてきえいきょう	遺伝的影響
いっぽうてきすいろん	一方的推論
いっぱんよやくかいし	一般予約開始
いっぱんみんかんじん	一般民間人
いっぱんふきゅうせい	一般普及性
いっぱんにゅうじょう	一般入場
いっぱんてきもんだい	一般的問題
いっぱんてきけんかい	一般的見解
いっぱんてきけいこう	一般的傾向
いっぱんそうたいろん	一般相対論
いっぱんじょうきゃく	一般乗客
いっぱんしょくじょし	一般職女子
いっぱんしょうひぜい	一般消費税
いっぱんしはんかかく	一般市販価格
いっぱんこうどうよう	一般公道用
いっぱんこうかいまえ	一般公開前
いっぱんこうえんしゃ	一般講演者
いっぱんきょういくぶ	一般教育部
いっぱんかのうりょく	一般化能力
いっぱんかにゅうよう	一般加入用
いっぱつかいかんがた	一発快感型
いっていすういじょう	一定数以上
いっていしゅうはすう	一定周波数
いっていきぼいじょう	一定規模以上
いっていがくいじょう	一定額以上
いっていかいてんすう	一定回転数
いっちょくせんじょう	一直線上
いったんしゅうりょう	一旦終了
いっしゅうかんていど	一週間程度
いっしゅうかんくらい	一週間位
いっさいしょうりゃく	一切省略
いっかつにゅうりょく	一括入力
いちりょうじつちゅう	一両日中
いちようしゅうはすう	一様周波数
いちまんえんいじょう	一万円以上
いちぶじょういきしゅ	一部上位機種
いちばんみりょくてき	一番魅力的
いちねんはんほどまえ	一年半程前
いちねんせいそうほん	一年生草本
いちねんかんげんてい	一年間限定
いちねんいじょうまえ	一年以上前
いちにちじゅうほうち	一日中放置
いちにちじゅうきどう	一日中起動
いちにちいちおうふく	一日一往復
いちたいいちたいおう	一対一対応
いちじぶんれつそしき	一次分裂組織
いちぐんこうしきせん	一軍公式戦
いちぎょういちぎょう	一行一行
いちがやさないちょう	市谷左内町
いぞんせんたくこうり	依存選択公理
いぞんじゅんじょせい	依存順序性
いぞんかんけいきそく	依存関係規則
いずかいようこうえん	伊豆海洋公園
いじょうしゅうりょう	異常終了
いしゅかくとうぎせん	異種格闘技戦
いしやまさかもとせん	石山坂本線
いしもりしょうたろう	石森章太郎
いしけっていほうほう	意思決定方法	意志決定方法
いしけっていほうしき	意思決定方式
いけんりっぽうしんさ	違憲立法審査
いけんこうかんちゅう	意見交換中
いけいほうしゃそしき	異形放射組織
いくゆうかいかつどう	育友会活動
いがくてきじょうほう	医学的情報
いがくてきけんきゅう	医学的研究
いがくじっしゅうよう	医学実習用
いがくじっけんちゅう	医学実験中
いがくけんきゅうしゃ	医学研究者
いいんかいせいりつご	委員会成立後
いいんかいせいいこう	委員会制移行
あんないじどうそうふ	案内自動送付
あんていせいじゅうし	安定性重視
あんていきょうしんき	安定共振器
あんていきょうきゅう	安定供給
あんていかんばつぐん	安定感抜群
あんぜんがわひょうか	安全側評価
あんじんりょうみょう	安心立命
あんじんりゅうみょう	安心立命
あるこーるちゅうどく	アルコール中毒
ありゅうさんえんるい	亜硫酸塩類
あやせぶんかかいかん	綾瀬文化会舘
あまてらすおおみかみ	天照大神
あまぎゆがしまちょう	天城湯ヶ島町
あぶくまがわていぼう	阿武隈川堤防
あづちももやまじだい	安土桃山時代
あつぎえいぎょうしょ	厚木営業所
あっとうてきたすうは	圧倒的多数派
あさひしゅっぱんしゃ	朝日出版社
あさくさこうかいどう	浅草公会堂
あげはましきえんでん	揚浜式塩田
あくにんしょうきせつ	悪人正機説
あくとくふどうさんや	悪徳不動産屋
あおやまがくいんだい	青山学院大
あおやまいっちょうめ	青山一丁目
あおもりはこだてかん	青森函館間
あおもりうんてんじょ	青森運転所
あおばきねんかいかん	青葉記念会館
あうすとろばいれやか	Austrobaileyaceae
あいちきょういくだい	愛知教育大
あいこうだいめいでん	愛工大名電
おんせいろくさいきのう	音声録再機能
おんせいにんしきそうち	音声認識装置
おんせいせいせいかてい	音声生成過程
おんせいしんごうしょり	音声信号処理
おんせいしゅつりょくき	音声出力機
おんせいごうせいそうち	音声合成装置
おんせいけんきゅうしゃ	音声研究者
おんせいけんきゅうしつ	音声研究室
おんせいけんきゅうかい	音声研究会
おんしつこうじょうほう	音質向上法
おんしつかいぜんこうか	音質改善効果
おんきょうばくろれべる	音響暴露レベル
おんがくしゅっぱんしゃ	音楽出版社
おんがくこくさいかいぎ	音楽国際会議
おんいんせいじょうほう	音韻性情報
おろしうりぶっかしすう	卸売物価指数
おだきゅうせんえんせん	小田急線沿線
おだきゅうじこくひょう	小田急時刻表
おたるしょうかだいがく	小樽商科大学
おきなわかいはつちょう	沖縄開発庁
おおなかとみのよしのぶ	大中臣能宣
おおてりょこうがいしゃ	大手旅行会社
おおつかほんちょうえき	大塚本町駅
おおたくひがしゆきがや	大田区東雪谷
おおぜきしょうしんまえ	大関昇進前
おおさきひろこうじかん	大崎広小路間
おおさかふりつだいがく	大阪府立大学
おおさかじょうこうえん	大阪城公園
おおさかしりつだいがく	大阪市立大学
おおさかしょうばいにん	大阪商売人
おおさかさんぎょうだい	大阪産業大
おおさかこうだいふぞく	大阪工大付属
おおさかきょういくだい	大阪教育大
おおさかかんじょうせん	大阪環状線
おおさかいだいびょうり	大阪医大病理
おおがたろじょうしけん	大型路上試験
おおがたじょうようしゃ	大型乗用車
おおがたしゃとうにゅう	大型車投入
おおいけしぜんこうえん	大池自然公園
おうようぶつりがっかい	応用物理学会
おうようてきのうりょく	応用的能力
おうようじょうほうがく	応用情報学
おうようけんきゅうじょ	応用研究所
おうようけんきゅうしつ	応用研究室
おうふくわりびききっぷ	往復割引切符
おうふくわりびききかん	往復割引期間
おうふくていきれっしゃ	往復定期列車
おうふくじょうしゃけん	往復乗車券
おうじやまきゅうじょう	王子山球場
おうしゅうせんしゅけん	欧州選手権
えんまくはっせいそうち	煙幕発生装置
えんちょうきかんちゅう	延長期間中
えんだかさえきかんげん	円高差益還元
えんそけいさっきんざい	塩素系殺菌剤
えんそうじかんひょうじ	演奏時間表示
えんそうしゅうりょうご	演奏終了後
えんしゅうはまかいがん	遠州浜海岸
えんけいだつもうしょう	円形脱毛症
えんきょりつうきんしゃ	遠距離通勤者
えんきょりつうがくしゃ	遠距離通学者
えんえきてきどうしゅつ	演繹的導出
えっちゅうだいもんえき	越中大門駅
えきまえしょうてんがい	駅前商店街
えきしょうひょうじしき	液晶表示式
えきしょうでぃすぷれい	液晶ディスプレイ
えきしゅうへんかくしょ	駅周辺各所
えいもじにゅうりょくじ	英文字入力時
えいぶんしゅっぱんぶつ	英文出版物
えいぶんがくせんしゅう	英文学専修
えいぞうごらくさくひん	映像娯楽作品
えいぞうごうせいかいろ	映像合成回路
えいぞうけんきゅうしょ	映像研究所
えいぞうけんきゅうかい	映像研究会
えいぞうかいはつぶもん	映像開発部門
えいせいなまちゅうけい	衛星生中継
えいこくぶつりがっかい	英国物理学会
えいこくこっきょうかい	英国国教会
えいぎょうほうこくしょ	営業報告書
えいぎょうたんとうしゃ	営業担当者
えいぎょうしゅうりょう	営業終了
えいぎょうしゅうにゅう	営業収入
えいぎょうしゃぜんいん	営業者全員
えいがかんしょうりょう	映画鑑賞料
うんめいきょうどうたい	運命共同体
うんどうりょうしゅうし	運動量収支
うんてんめんきょしょう	運転免許証
うんてんめんきょしけん	運転免許試験
うんてんせきひだりがわ	運転席左側
うんてんしゅうりょうご	運転終了後
うりあげそうりえきりつ	売上総利益率
うちゅうぼうえんきょう	宇宙望遠鏡
うちゅうしゅうじんせん	宇宙囚人船
うたひめがっしょうだん	歌姫合唱団
うせつやじるししんごう	右折矢印信号
うじしゅういものがたり	宇治拾遺物語
うかいじょうしゃくかん	迂回乗車区間
うえさんかくぎょうれつ	上3角行列	上三角行列
いんせいけんきゅうしつ	院生研究室
いんかんせいぞうぎょう	印鑑製造業
いんかんしょうめいなど	印鑑証明等
いわなみすうがくじてん	岩波数学辞典
いわてけんみんかいかん	岩手県民会館
いわしみずはちまんぐう	石清水八幡宮
いりょうたんきだいがく	医療短期大学
いようせいみつこうがく	医用精密工学
いみひょうげんけいしき	意味表現形式
いほうちゅうしゃこうい	違法駐車行為
いぶすきまくらざきせん	指宿枕崎線
いどうつうしんぎじゅつ	移動通信技術
いとうちゅうねんりょう	伊藤忠燃料
いでんじょうほうしょり	遺伝情報処理
いっぽうつうこうきせい	一方通行規制
いっぱんりようしゃむき	一般利用者向
いっぱんぶんれつそしき	一般分裂組織
いっぱんてきじょうしき	一般的常識
いっぱんてきかいしゃく	一般的解釈
いっぱんじょうようしゃ	一般乗用車
いっぱんしゅうゆうけん	一般周遊券
いっぱんさんかしゃよう	一般参加者用
いっぱんこうそくどうろ	一般高速道路
いっぱんきょうようよう	一般教養用
いっぱんうんどうりょう	一般運動量
いっぱつだいぎゃくてん	一発大逆転
いっていじかんかんかく	一定時間間隔
いっていじかんいじょう	一定時間以上
いっていきかんちょうさ	一定期間調査
いっていおんどいじょう	一定温度以上
いっしゅうかんこうたい	一週間交替
いっしゅうかんいじょう	一週間以上
いっこしゅうちゅうがた	一個集中型
いっきょくしゅうちゅう	一極集中	一局集中
いっかつじかんかじゅう	一括時間荷重
いっかいじゅつごろんり	一階述語論理
いちらんせいそうせいじ	一卵性双生児
いちようへいきんりゅう	一様平均流
いちようじゅうりょくば	一様重力場
いちばんいんしょうてき	一番印象的
いちにちじょうしゃけん	一日乗車券
いちかわだんじゅうろう	市川団十郎
いぞんどひょうかひょう	依存度評価表
いしょくたんぺんしゅう	異色短篇集	異色短編集
いしょうとうろくちゅう	意匠登録中
いけぶくろせんえんせん	池袋線沿線
いくじきゅうぎょうほう	育児休業法
いくえいしょうがくきん	育英奨学金
あんていせいじょうけん	安定性条件
あんぜんほあんきじゅん	安全保安基準
あんぜんしゃかんきょり	安全車間距離
あんぜんこうしゅうかい	安全講習会
あんぜんげんかいそくど	安全限界速度
あんぜんけんきゅうしょ	安全研究所
あらしやまびじゅつかん	嵐山美術館
あらしやまはくぶつかん	嵐山博物館
あやせししょうこうかい	綾瀬市商工会
あめりかがっしゅうこく	アメリカ合衆国
あまがさきかいがんせん	尼崎海岸線
あっしゅくちゃっかしき	圧縮着火式
あしょうさんえんのうど	亜硝酸塩濃度
あしはらちゅうがっこう	芦原中学校
あさひしんぶんゆうかん	朝日新聞夕刊
あさひかわけいばじょう	旭川競馬場
あさひかせいじょうほう	旭化成情報
あさひかせいこうぎょう	旭化成工業
あさくさしんげきじょう	浅草新劇場
あさかぎじゅつかいはつ	朝霞技術開発
あこうそくうちゅうせん	亜光速宇宙船
あくたがわりゅうのすけ	芥川龍之介
あくたがわしょうこうほ	芥川賞候補
あくせいこくしょくしゅ	悪性黒色腫
あかばねいわぶちちょう	赤羽岩淵町
あおものよこちょうえき	青物横丁駅
あいてがわきょうぎしゃ	相手側競技者
あいちこうせいねんきん	愛知厚生年金
あいちきんろうかいかん	愛知勤労会館
あいちがくせんだいがく	愛知学泉大学
おんせいにんしきかんけい	音声認識関係
おんせいとくちょうりょう	音声特徴量
おんせいたじゅうほうそう	音声多重放送
おんせいじょうほうしょり	音声情報処理
おんせいきょうちょうほう	音声強調法
おんきょうせっけいがっか	音響設計学科
おんきょうしんごうしょり	音響信号処理
おんがくじょうほうしょり	音楽情報処理
おんがくじょうほうかがく	音楽情報科学
おんがくぎょうかいようご	音楽業界用語
おもてさんどうこうさてん	表参道交差点
おもしろやまこうげんえき	面白山高原駅
おびひろはくようこうこう	帯広柏葉高校
おだきゅうしんじゅくえき	小田急新宿駅
おきなわけんえいてつどう	沖縄県営鉄道
おおてぐんじゅさんぎょう	大手軍需産業
おおさかたいいくだいがく	大阪体育大学
おおさかこくさいくうこう	大阪国際空港
おおさかこうせいねんきん	大阪厚生年金
おおさかけいざいだいがく	大阪経済大学
おおさかいちりつだいがく	大阪市立大学
おおくらしょうしょうけん	大蔵省証券
おおがたはんようたんまつ	大型汎用端末
おおがたちゅうしゃじょう	大型駐車場
おおおかやまえきいりぐち	大岡山駅入口
おおいずみがくえんちょう	大泉学園町
おおあめこうずいけいほう	大雨洪水警報
おうようりょうしこうがく	応用量子光学
おうようじゅつごけいさん	応用述語計算
おうぼしょるいざいちゅう	応募書類在中
おうきゅうきゅうごしょち	応急救護処置
えんそけいひょうはくざい	塩素系漂白剤
えんせきがいせんばいせん	遠赤外線倍煎
えんしゅうはままつじょう	遠州浜松城
えんきょりつうきんきゃく	遠距離通勤客
えきばしゃていりゅうじょ	駅馬車停留所
えいようほじょしょくひん	栄養補助食品
えいようきのうしょくひん	栄養機能食品
えいぞうさくひんぜんぱん	映像作品全般
えいごきょういくばんぐみ	英語教育番組
えいこくじんぎじゅつしゃ	英国人技術者
えいぎょうていししょぶん	営業停止処分
えいぎょうしゅうりょうご	営業終了後
えいぎょうがいしゅうえき	営業外収益
えいがおんがくとくしゅう	映画音楽特集
うんどうりょうほぞんそく	運動量保存則
うらがすみだいぎんじょう	浦霞大吟醸
うちゅうたんさきょうかい	宇宙探査協会
うちゅうせんかんそくじょ	宇宙線観測所
うちゅうかいはつけいかく	宇宙開発計画
うえほんまちろくちょうめ	上本町六丁目
いんりょくけんだっしゅつ	引力圏脱出
いわたしえいきゅうじょう	磐田市営球場
いりょくぎょうむぼうがい	威力業務妨害
いりょうたんきだいがくぶ	医療短期大学部
いりょうそうだんまどぐち	医療相談窓口
いでんせいたいけんきゅう	遺伝生態研究
いでんじょうほうぎんこう	遺伝情報銀行
いっぱんゆうりょうどうろ	一般有料道路
いっぱんむけけいもうしょ	一般向啓蒙書
いっぱんにゅうじょうしゃ	一般入場者
いっぱんにゅうじょうけん	一般入場券
いっぱんざひょうへんかん	一般座標変換
いっぱんけいじじょうがく	一般形而上学
いっきょしゅいっとうそく	一挙手一投足
いけんりっぽうしんさけん	違憲立法審査権
いけぶくろえきひがしぐち	池袋駅東口
いくじきゅうしょくせいど	育児休職制度
いがくしょいんしゅっぱん	医学書院出版
あんていきょうきゅうさき	安定供給先
あんぜんほしょうりじかい	安全保障理事会
あんぜんたいさくきじゅん	安全対策基準
あんぜんかんりきょうかい	安全管理協会
あらしやましぜんこうえん	嵐山自然公園
あっしゅくちゃっかきかん	圧縮着火機関
あさひしんぶんちょうかん	朝日新聞朝刊
あかしかいきょうおおはし	明石海峡大橋
あおやまがくいんだいがく	青山学院大学
あいちこうぎょうだいがく	愛知工業大学
あいちきょういくだいがく	愛知教育大学
あいちかんじょうてつどう	愛知環状鉄道
おんせいにゅうりょくたんし	音声入力端子
おんせいきょうちょうしょり	音声強調処理
おんせいきょうちょうこうか	音声強調効果
おんせいきょうちょうけっか	音声強調結果
おんせいきょうちょうきこう	音声強調機構
おんきょうじょうほうかがく	音響情報科学
おんがくじょうほうけんさく	音楽情報検索
おおみやにっせきびょういん	大宮日赤病院
おおはばさいしゅつさくげん	大幅歳出削減
おおしましょうせんこうせん	大島商船高専
おおさかさんぎょうだいがく	大阪産業大学
おおさかこくさいこうりゅう	大阪国際交流
おおさかこうぎょうだいがく	大阪工業大学
おおさかきょういくだいがく	大阪教育大学
おおがたじゃぐちちょっけつ	大型蛇口直結
おおがたけいさんきせんたー	大型計算機センター
おおいしゃりょうこうじょう	大井車両工場
えんかくしゅうちゅうかんり	遠隔集中管理
えんえきてきどうしゅつほう	演繹的導出法
えいようほきゅうしょくひん	栄養補給食品
えいでんいでまちやなぎえき	叡電出町柳駅
えいだんゆうらくちょうせん	営団有楽町線
えいこくしんれいきょうかい	英国心霊協会
うんそうけいやくじょうけん	運送契約条件
いわたしみんぶんかかいかん	磐田市民文化会館
いほうちゅうしゃしゃりょう	違法駐車車両
いっぱんそうたいせいりろん	一般相対性理論
いっぱんじょうほうばんぐみ	一般情報番組
いっぱんこうしゅうかいせん	一般公衆回線
いっさんかたんそちゅうどく	一酸化炭素中毒
いくじきゅうぎょうきゅうふ	育児休業給付
あんていじょうたいべくとる	安定状態ベクトル
あんぜんほしょうじょうやく	安全保障条約
あしかがこうぎょうだいがく	足利工業大学
あかまるじょうしょうちゅう	赤丸上昇中
あかまるきゅうじょうしょう	赤丸急上昇
あおやまえんけいげきじょう	青山円形劇場
おんせいきょうちょうしょりご	音声強調処理後
おんせいきょうちょうしゅほう	音声強調手法
おおさかしょうぎょうだいがく	大阪商業大学
えんかいしゅうりょうちょくご	宴会終了直後
えっとういちねんせいそうほん	越冬一年生草本
うりあげさいけんかいてんりつ	売上債権回転率
うりあげえいぎょうりえきりつ	売上営業利益率
うちゅうかがくけんきゅうじょ	宇宙科学研究所
うちゅうかいはつじぎょうだん	宇宙開発事業団
いっぱんけんきゅうはっぴょう	一般研究発表
いくじかいごきゅうぎょうほう	育児介護休業法
いいんかいとうせっちがいしゃ	委員会等設置会社
おんせいじょうほうけんきゅうぶ	音声情報研究部
えんちょくこうぞうほうていしき	鉛直構造方程式
あのくたらさんみゃくさんぼだい	阿耨多羅三藐三菩提
おおつまじょしだいなかのこうこう	大妻女子大中野高校
うんようけんとうしょういいんかい	運用検討小委員会