ご	沍	語	午	瑚	兒	護	壺	炬	子	越	御	晤	五	互	5	齬	胡	期	呉	忤	悟	娯	庫	篌	唔	蜈	牾	檎	碁	醐	極	５	誤	伍	児	茣	壷	珸	宕	寤	吾	後	冴	后	梧
げ	夏	拐	下	実	解	觧	睨	牙	毛	偈	蹴	外	気
ぐ	狗	組	壺	惧	具	禺	麌	倶	虞	弘	愚	暮	壷	颶	食
ぎ	戯	祇	魏	戲	欺	犧	曦	木	着	艤	嶬	儀	議	沂	擬	決	斬	蟻	城	僞	羲	礒	萓	疑	祁	伎	宜	誼	犠	巍	妓	切	技	偽	義	気
が	鵝	餓	勝	賀	伽	ヵ	画	衙	芽	書	莪	峨	河	瓦	換	訛	蛾	買	雅	臥	果	呀	哦	俄	ケ	駆	畫	替	娥	牙	掛	刈	訝	駕	鵞	ヶ	我	峩	代
ごん	權	金	厳	艮	権	魂	嚴	言	勤	諢
ごろ	語呂	頃
ごり	鮴
ごゆ	御油
ごや	小屋
ごめ	込
ごむ	護謨
ごみ	護美	五味	塵	込	塵芥	埖
ごま	胡麻	護摩
ごぶ	五分	五部
ごふ	後夫	護符
ごび	語尾
ごば	後場
ごは	語派
ごの	好
ごど	五度
ごと	事	亊	五斗	如	言	毎	若
ごて	後手
ごち	五智
ごぜ	瞽女
ごせ	御所
ごず	牛頭
ごじ	５時	護持	五時	5時	五次	誤字
ごし	語誌	呉子	腰	語史	越し	五指	語詞
ござ	御座	茣蓙	後座	蓙
ごさ	誤差
ごご	午后	午後
ごこ	5個	五胡
ごけ	碁笥	後家
ごく	語句	獄	極
ごぎ	語義
ごき	御忌	語気	語基	御器	誤記
ごか	五箇	五加	五霞
ごえ	声	聲	越え
ごう	剛	郷	豪	刧	熬	合	囂	毫	壕	遨	拷	哈	軣	号	敖	劫	轟	嗷	號	鼇	噛	傲	強	盒	業	濠
ごい	伍井	戀	恋	五井	語意	語彙	五位
げん	顏	元	減	儼	絃	偐	幻	軒	彦	玄	厳	源	广	諺	舷	弦	嫌	痃	現	眼	芫	眩	限	原	験	嚴	訝	言	監	衒	愿	呟
げろ	下呂
げり	下痢
げや	下屋	下野
げび	下卑
げひ	下卑
げば	下馬
げに	実に
げて	下手
げつ	月	蘖	囓	齧
げち	下知
げた	〓	下駄
げす	下司	下衆	下種
げじ	下知
げし	夏至
げざ	下座
げこ	下戸
げげ	:-<
げぎ	外儀
げき	隙	鷁	屐	戟	激	逆	外記	檄	鬩	劇	撃	郤	闃
げか	外科
げい	倪	鯨	芸	囈	猊	藝	麑	霓	睨	迎	貎	黥	皃
ぐん	軍	羣	麕	郡	群
ぐろ	グロ	黒
ぐれ	昏
ぐる	苦
ぐり	栗
ぐら	暮
ぐみ	萸	組	茱
ぐぼ	愚母
ぐぶ	供奉
ぐふ	愚夫	愚父
ぐび	具備
ぐち	愚痴	口
ぐせ	癖
ぐず	愚図
ぐし	愚姉
ぐさ	種	腐
ぐう	遇	藕	宮	偶	嵎	寓	隅
ぐあ	具合
ぎん	岑	Silver	吟	銀	垠	憖	Ag	崟
ぎわ	羲和	際
ぎり	義理	斬り	切
ぎら	嫌
ぎょ	圉	魚	馭	御	禦	圄	漁
ぎゃ	伽
ぎむ	義務
ぎみ	気味
ぎぼ	義母
ぎふ	岐阜	義父
ぎひ	犠飛
ぎだ	犠打
ぎじ	議事	疑似	擬餌	擬似
ぎし	擬死	偽史	技師	義士	魏史	義歯	岸	技士	義肢	義子	義姉
ぎこ	擬古
ぎげ	義解
ぎく	疑懼
ぎぎ	魏魏	擬議	疑義
ぎき	義気
ぎが	giga	偽画	巍峨	儀我	戯画
ぎか	技家	技科	偽果
がん	顏	岩	頑	元	巖	偐	嵒	巌	厳	鳫	顔	贋	雁	玩	龕	丸	岸	眼	阮	翫	鴈	嚴	願	頷	癌	含
がわ	河	側	巛	川
がり	我利
がら	柄	辛
がも	賀茂
がみ	髪	雅味	髮	上
がま	蝦蟆	釜	蝦蟇	蟇	窯	蒲
がほ	牙保
がふ	画譜	画布
がび	蛾眉
がね	金	鐘
がに	蟹
がな	仮名
がと	難	賀戸
がつ	月	歹
がっ	合
がち	勝ち	雅致
がた	方	難	潟	形	型
がそ	画素
がす	瓦斯
がし	餓死	賀詞	樫
がさ	重	傘
がご	雅語
がけ	掛け	崖	垳
がく	齶	額	學	斈	鄂	楽	鰐	嶽	壑	咢	愕	鍔	萼	岳	樂	諤	顎	学
がき	餓鬼	垣
がが	峨峨	峨々
がか	係	雅歌	画架	画家
がお	顏	顔
がえ	帰	返	皈	換	肯	歸
がう	號
がい	咳	啀	崖	亥	崕	漑	駭	買い	艾	骸	階	睚	孩	磑	愾	碍	該	概	盖	劾	甲斐	害	葢	慨	鎧	垓	乂	賀意	剴	涯	礙	蓋	皚	凱	既	外	街	我意
ごんだ	権田
ごんご	言語
ごんげ	権化
ごんぐ	欣求
ごんか	言下
ごろね	ごろ寝
ごろく	語録
ごろう	御覧	悟郎	伍朗	悟朗	ＧＯＲＯ	五郎
ごろー	ＧＯＲＯ
ごれい	語例	誤例
ごりん	五輪	五倫	五厘
ごりお	ゴリ押
ごらん	御覧	ご覧
ごらく	娯楽
ごよく	五欲
ごよう	御用	五葉	誤用	ご用
ごやく	誤訳	語訳
ごもん	御門	五門	御紋
ごもつ	御物
ごもく	五目
ごめん	御免
ごめい	五明	五名
ごみや	五味屋
ごまん	五万
ごまつ	語末
ごまか	胡麻化	誤魔化
ごぼう	牛蒡	御坊
ごほん	御本
ごほく	吾北
ごほう	語法	御報	誤報	午砲	護法
ごべん	五弁
ごへい	御幣	語弊
ごぶん	五分	誤聞
ごぶじ	御無事
ごぶが	五分刈
ごふん	五分	胡粉
ごふく	五福	呉服
ごふう	碁風
ごひつ	五筆
ごひき	五匹
ごばん	五番	碁盤
ごばら	後払
ごばく	誤爆
ごはん	御飯	誤判	ご飯
ごはい	誤配
ごのみ	好み
ごのへ	五戸
ごのう	御悩
ごねん	五年	御念
ごにん	誤認	五人	5人
ごなん	御難
ごどく	誤読
ごどう	悟道
ごとに	毎に
ごとし	如し
ごとく	五徳
ごとう	呉島	五頭	後藤	五島	誤答	語頭	五嶋
ごでん	誤伝
ごてん	御殿
ごてい	五帝
ごつぼ	五坪
ごって	毎
ごだん	誤断	五段
ごだつ	誤脱
ごだい	伍代	五代
ごたん	五反
ごたま	五玉
ごたく	五択	御託
ごたい	五体
ごぞん	御存
ごぞく	語族	五族
ごぞう	五臓
ごそう	護送	五艘	誤想
ごぜん	御前	御膳	午前
ごせん	互選	五千	五線	五泉
ごせい	悟性	互生	碁聖	語勢
ごずみ	後炭
ごすけ	吾助
ごすう	語数
ごすい	午睡
ごじん	吾人	御仁
ごじょ	互除	互助
ごじひ	ご慈悲	御慈悲
ごじつ	後日
ごしん	護身	誤審	誤信	誤診
ごしら	拵
ごしょ	御所	五所
ごしゅ	五種	御酒
ごしゃ	誤写	誤射
ごしま	五島
ごしじ	御指示
ごしき	五色
ごさん	午餐	誤算
ごさつ	誤殺
ごさく	吾作
ごさい	五歳	五彩	後妻
ごごん	五言
ごごち	心地
ごごう	五合
ごこん	語根
ごころ	心
ごこち	心地
ごこく	護国	後刻	五穀
ごこう	五更	五光	五香	五劫	後光
ごげん	語源
ごけん	護憲
ごけつ	五傑
ごけた	五桁
ごけい	五刑	互恵	語形
ごぐん	語群
ごくり	獄吏
ごくや	獄屋
ごくび	極微
ごくひ	極秘
ごくし	獄死
ごくう	御供	悟空
ごくい	極意	獄衣
ごきそ	御器所
ごがん	護岸
ごがつ	５月	皐月	5月	五月
ごがく	語学
ごかん	互換	後漢	語間	語幹	五感	語感	五官
ごかせ	五ヶ瀬
ごかご	御加護
ごかく	互角	五角	互格
ごかい	誤解	5階	五階	五戒	五回	碁界	碁会
ごおん	語音	呉音	御恩
ごおう	五黄	牛王	牛黄
ごえん	誤嚥	御縁
ごえふ	五衛府
ごえつ	呉越
ごえい	護衛
ごうん	五蘊
ごうり	合理
ごうも	毫も
ごうめ	合目	号目
ごうま	格間	降魔
ごうふ	豪富
ごうひ	合肥	合否
ごうの	郷野
ごうど	神戸
ごうづ	江津
ごうつ	江津
ごうち	郷地
ごうだ	合田	郷田	剛田
ごうた	剛太
ごうそ	強訴
ごうじ	剛司	合字
ごうし	郷司	合志	合祀	郷士	合資
ごうご	傲語	豪語
ごうこ	江湖
ごうけ	郷家
ごうく	業苦	合区
ごうぎ	合議	豪儀
ごうき	剛己	豪気	剛気	号機	剛毅	豪鬼	豪毅
ごうか	劫火	業火	豪華
ごうう	豪雨
ごうい	合意
ごいち	吾一
ごいそ	語彙素
ごいし	碁石
ごあく	五悪
げんわ	元和
げんり	原理
げんゆ	原油
げんや	原野	幻夜
げんめ	限目
げんむ	幻梦	幻夢
げんま	減摩	玄馬	幻魔
げんぼ	原簿
げんぷ	原譜	厳父
げんぶ	玄武
げんぴ	厳秘
げんば	玄蕃	現場
げんに	現に
げんな	元和
げんど	限度
げんつ	原付
げんち	玄地	言質	現地
げんだ	源田
げんた	元太	源太	玄太
げんそ	原素	元素
げんせ	現世
げんず	原図
げんじ	言辞	玄二	源治	現時	現示	源氏
げんし	原紙	原詩	幻視	原子	原資	原始	元祀	減資	元史	元始
げんご	原語	幻語	源吾	言語	源後
げんこ	拳固
げんぎ	原義	玄義
げんき	元気	原器	原基
げんが	原画
げんか	現下	厳科	喧嘩	原価	現価	減価	言下
げんい	原意
げろう	下郎	外郎
げれつ	下劣
げらく	下落
げめん	外面
げぼく	下僕
げほう	外法
げひん	下品
げはん	下阪
げねつ	解熱
げにん	下人	解任
げなん	下男
げどく	解毒
げどう	下道	外道
げとう	夏油
げてん	外典	下天
げつり	月利
げつよ	月余
げつど	月度
げつじ	月次
げつご	月後
げつか	月火
げっぽ	月歩
げっぷ	月賦
げっし	齧齒	齧歯
げっか	月下	激化
げだん	下段
げだつ	解脱
げだい	外題
げたん	下端
げそく	下足
げせん	下船	下賤	牙籤	下賎
げせわ	下世話
げすい	下水
げじん	外陣
げじょ	下女
げじく	牙軸
げしゃ	下車
げざん	下山
げざい	下剤
げさく	下策	下作	戯作
げごく	下獄
げこん	下根
げこく	下刻
げこう	下校	下向
げけつ	下血
げぐう	外宮
げくう	外宮
げぎら	毛嫌
げぎょ	懸魚
げきむ	劇務	激務
げきは	撃破
げきど	激怒
げきし	劇詩
げきご	激語
げきが	劇画
げきか	劇化	激化
げかん	外官	下巻	下疳
げかい	下界	下回	外科医	外界
げいゆ	鯨油
げいび	芸備
げいは	鯨波
げいこ	芸子	藝子
げいぎ	芸妓
げいか	猊下
ぐんむ	軍務
ぐんま	群馬
ぐんぶ	軍部	郡部	群舞
ぐんぴ	軍費
ぐんび	軍備
ぐんば	軍馬
ぐんて	軍手
ぐんじ	軍事	軍二	郡司	群司
ぐんし	軍使	軍師	軍史	軍士
ぐんけ	郡家
ぐんぎ	群議
ぐんき	軍機	軍記	軍旗	軍規	軍紀
ぐんか	軍靴	群化	軍歌
ぐんい	軍医
ぐわい	具合
ぐろん	愚論
ぐろう	愚弄	愚老
ぐれん	紅蓮
ぐれつ	愚劣
ぐるり	周
ぐるめ	包
ぐらい	位
ぐゆう	具有
ぐもん	愚問
ぐみん	愚民
ぐまい	愚妹	愚昧
ぐほう	求法
ぐぶつ	愚物
ぐふう	颶風
ぐはん	虞犯
ぐのう	愚能
ぐどん	愚鈍
ぐどう	求道
ぐとう	愚答
ぐてい	愚弟
ぐちん	具陳
ぐたい	具体
ぐそく	愚息	具足
ぐそう	愚僧
ぐせつ	愚説
ぐせい	愚生
ぐじん	愚人
ぐじょ	愚女
ぐしん	具申	供進
ぐしょ	愚書
ぐしゃ	愚者
ぐざい	ξ	Ξ	具材
ぐさく	愚作	愚策
ぐさい	愚妻
ぐこう	愚考	愚公	愚行
ぐげん	具現
ぐけん	愚見
ぐけい	愚兄	愚計	愚形
ぐきょ	愚挙
ぐがん	具眼
ぐうわ	寓話
ぐうゆ	寓喩
ぐうじ	宮司
ぐうき	偶奇
ぐうい	寓意
ぐあん	愚案	具案
ぐあい	具合い	工合	具合
ぎんみ	吟味
ぎんぽ	銀宝
ぎんぱ	銀波
ぎんば	銀歯
ぎんす	銀子
ぎんじ	銀字	銀次	銀二
ぎんし	銀糸
ぎんざ	銀座
ぎんが	銀河
ぎんか	銀貨	銀貸	銀花
ぎわく	疑惑
ぎろん	議論
ぎれん	技連
ぎれつ	義烈
ぎれい	儀礼
ぎりだ	義理立
ぎよう	儀容
ぎょゆ	魚油
ぎょふ	漁夫	御府
ぎょび	魚尾
ぎょひ	魚肥
ぎょば	漁場
ぎょじ	御璽
ぎょし	御史	御寝	漁史	御旨
ぎょざ	御座
ぎょぐ	漁具
ぎょく	閠	玉	漁区	嶷
ぎょき	漁期
ぎょう	痙	翹	驍	凝	僥	行	暁	澆	嶢	曉	尭	堯	繞	蟯	形	業	仰
ぎょい	御衣	御意
ぎゆう	義勇
ぎゅう	牛
ぎやく	偽薬
ぎゃく	虐	逆	瘧	謔
ぎもん	疑問
ぎもう	欺罔
ぎめい	偽名
ぎむづ	義務付
ぎむか	義務化
ぎみん	義民
ぎまん	欺瞞	欺慢
ぎまい	義妹
ぎぼし	擬宝珠
ぎほう	技報	技法
ぎへい	義兵
ぎぶん	戯文
ぎぶつ	偽物
ぎふん	義憤
ぎふぼ	義父母
ぎふし	岐阜市
ぎひつ	偽筆
ぎはん	偽版
ぎのざ	宜野座
ぎのう	技能
ぎねん	疑念
ぎなん	岐南
ぎとう	蟻塔
ぎてん	疑点	儀典	偽典
ぎてい	議定	義弟
ぎつう	技通
ぎだい	議題	技大
ぎたん	技短	義丹
ぎたい	擬態
ぎぞく	義賊
ぎぞう	偽造
ぎそく	義足
ぎそう	偽装	艤装	擬装
ぎぜん	偽善	巍然
ぎぜつ	義絶
ぎせん	義戰	岐セン	義戦
ぎせき	妓籍	議席
ぎせい	犠牲	擬製	擬声	擬制	義勢
ぎじん	義人	擬人
ぎじょ	妓女
ぎじご	疑似語
ぎじえ	疑似餌
ぎしん	義心	疑心
ぎしょ	戯書	偽書	魏書
ぎしゅ	義手	技手
ぎしほ	技師補
ぎしき	儀式
ぎさん	蟻酸
ぎさく	偽作	戯作
ぎごく	疑獄
ぎこう	技巧	技工	技功
ぎげい	技芸	伎芸
ぎけん	技研
ぎけつ	議決
ぎけい	偽計	義兄
ぎぐん	義軍
ぎくん	義訓
ぎきん	義金
ぎきょ	義挙
ぎがん	義眼
ぎがか	戯画化
ぎかん	技官	技管
ぎかく	擬革
ぎかい	議会
ぎおん	擬音	祇園
ぎえん	義援	義捐
ぎいん	偽印	議院	議員
ぎいち	義一
ぎあん	議案
ぎあひ	ギア比
ぎあく	偽悪
がんり	元利
がんゆ	含油
がんみ	玩味	含味
がんま	γ	Γ
がんぴ	雁皮
がんば	頑張
がんつ	ガン付
がんそ	元祖
がんぜ	頑是
がんじ	雁字	元治
がんし	眼視
がんさ	眼差
がんこ	頑固
がんぐ	玩具	頑愚
がんぎ	雁木
がんか	眼下	眼科	眼窩	癌化
がんい	願意	含意	⊃
がろん	画論
がろう	画廊	餓狼
がれき	瓦礫
がりん	芽鱗
がらん	伽藍
がらす	硝子
がらく	雅楽
がよく	我欲
がもう	蒲生
がめん	画面
がめい	雅名
がまん	我慢
がほう	画報	画法	芽胞
がべい	画餅
がへい	画餅
がぶん	雅文
がふく	画幅
がふう	画風
がひん	訝賓
がひつ	画筆
がばん	画板
がはく	画伯
がとう	餓島
がてん	合点
がつど	月度
がつお	鰹
がっぴ	月日
がって	勝手
がっち	合致
がっく	学区	楽句
がっき	楽器	学期
がっか	学科	学課
がだん	画壇
がだい	画題
がたな	刀
がたさ	難さ
がぞく	雅俗
がぞう	画像
がそち	画素値
がそう	芽層	画層
がぜん	瓦全	俄然
がせつ	我説
がせき	瓦石
がせい	画聖
がすろ	ガス炉
がじん	雅人	画人
がしら	頭
がしゅ	画趣	雅趣
がしつ	画室	画質
がざい	画材
がさん	臥蚕
がさい	画才
がごう	雅号
がこう	画工	画稿
がげん	雅言
がげき	画劇
がけん	我見
がけい	雅兄	芽型
がくり	学理	楽理
がくや	楽屋	嶽野
がくむ	学務
がくぶ	学部
がくふ	学府	岳父	楽譜
がくひ	岳飛	学費
がくは	学派
がくの	嶽野
がくと	学徒	学都
がくじ	学事
がくし	学資	学士	楽師
がくい	学位
がぎょ	駕御
ががく	画学	雅楽
がかり	係	掛
がかざ	画架座
がかく	畫角	画角
がかい	瓦解	画会	雅懐
がおか	ヶ丘
がおう	画王
がえん	肯
がえし	返し
がいん	画因
がいろ	街路
がいや	外野
がいむ	外務
がいぶ	外侮	外部
がいひ	外被	外皮
がいち	外地
がいだ	咳唾
がいず	概図
がいじ	外字	外事	外耳
がいし	外資	碍子	外紙	外史
がいご	外語
がいく	街区
がいき	外気
がいか	外化	蓋果	凱歌	外貨
がいい	害意	外衣
ごんべん	言偏
ごんべえ	権兵衛
ごんどう	権藤
ごんぞう	権造
ごんずい	権瑞
ごんじゃ	権者
ごんげん	権現
ごろべえ	五郎兵衛
ごろはち	五郎八
ごりよう	ご利用	御利用
ごりょう	御寮	御陵	御料	御領
ごりゅう	五竜
ごりやく	ご利益	御利益
ごりっぱ	ご立派	御立派
ごりかい	ご理解	御理解
ごりおし	ゴリ押し	ごり押し
ごよやく	御予約
ごよてい	御予定
ごようす	御様子
ごようい	御用意
ごゆうよ	御猶予
ごむよう	御無用
ごむのき	ゴムの木
ごむたい	御無体
ごむせい	ゴム製
ごみょう	五明
ごみゃく	語脈
ごみむし	歩行虫
ごみぶん	御身分
ごみばこ	ゴミ箱
ごみだし	ゴミ出し
ごみすて	ゴミ捨て
ごみおか	五味岡
ごまみそ	胡麻味噌
ごまどう	護摩堂
ごまだれ	胡麻垂れ
ごましお	胡麻塩
ごまがら	胡麻殻
ごまあえ	胡麻和え
ごぼいん	五母音
ごほんけ	御本家
ごほんぎ	五本木
ごほうび	御褒美	ご褒美
ごほうじ	御法事
ごほうし	ご奉仕	御芳志	御奉仕	ご芳志
ごへんじ	ご返事	御返事
ごぶれい	御無礼
ごぶさた	ご無沙汰	御無沙汰
ごぶごぶ	五分五分
ごぶがり	五分刈り
ごぶがゆ	五分粥
ごふめい	御不明
ごふまん	御不満
ごふべん	御不便
ごふたん	御負担
ごふじん	御夫人	御婦人
ごふざい	御不在
ごふさい	御夫妻
ごふこう	御不幸
ごふくや	呉服屋
ごふうふ	御夫婦
ごびょう	御廟
ごびゅう	誤謬
ごひゃく	五百
ごひはん	御批判
ごばんめ	五番目
ごばらい	後払い
ごはっと	ご法度	御法度
ごはさん	御破算	ご破算
ごねんめ	五年目
ごねどく	ごね得
ごにゅう	悟入	五入
ごどうさ	誤動作
ごとおび	五十日
ごとうち	御当地
ごとうじ	後藤寺
ごてんば	御殿場
ごてばん	後手番
ごてがち	後手勝
ごていじ	御提示
ごづめづ	牛頭馬頭
ごつごう	ご都合	御都合
ごつうち	御通知	ご通知
ごつうか	誤通過
ごったに	ごった煮
ごっかん	極寒
ごちょう	語長	語調	伍長
ごちゅう	語中
ごちゃく	御着	五着
ごちそう	御馳走	ご馳走
ごだいご	後醍醐
ごだいこ	五大湖
ごたんだ	五反田
ごたんい	語単位
ごたろう	五太郎
ごたぼう	ご多忙	御多忙
ごたぶん	御多分	ご多分
ごぞんち	御存知
ごぞんじ	ご存知	ご存じ	御存じ	御存知
ごそんぷ	御尊父
ごそんじ	御存じ
ごそうふ	御送付	ご送付
ごそうさ	誤操作
ごぜんぶ	午前部
ごせんふ	五線譜
ごせんぞ	御先祖	ご先祖
ごせんし	五線紙
ごせっけ	五摂家
ごずめず	牛頭馬頭
ごずいい	御随意
ごじんか	御神火
ごじょう	五常	互譲	五条	誤乗	五條
ごじゆう	御自由
ごじゅん	語順
ごじゅつ	後述
ごじゅう	五重	五十
ごじまん	御自慢
ごじぶん	御自分
ごじてん	語辞典
ごじっぽ	五十歩
ごじたく	御自宅
ごじせい	ご時世	御時世
ごじしん	御自身
ごじさん	ご持参
ごじあい	御自愛	ご自愛
ごしよう	誤使用	御使用	ご使用
ごしょの	御所野
ごしょく	五色	誤植
ごしょう	五章	五障	後生
ごしゅん	呉春
ごしゅみ	御趣味
ごしゅし	御主旨
ごしゅう	互酬
ごしゃく	語釈
ごしめい	御指名
ごしなん	御指南
ごしどう	御指導	ご指導
ごしてき	御指摘	ご指摘
ごしてい	御指定
ごしつぎ	御質疑
ごしちご	五七五
ごしえん	御支援	ご支援
ごしあい	五試合
ごさんけ	御三家
ごさんか	ご参加	御参加
ごさぼう	誤差棒
ごさどう	誤作動
ごさこう	誤差項
ごごびん	午後便
ごごうめ	五合目
ごこくじ	護国寺
ごこうし	ご厚志	御厚志
ごこうぎ	ご厚誼	ご高誼	御高誼	御厚誼
ごこうい	ご好意	御好意	御厚意	ご厚意
ごけんは	護憲派
ごけにん	御家人
ごくろう	御苦労	ご苦労
ごくらく	極楽
ごくやす	極安
ごくもん	獄門
ごくぼそ	極細
ごくぶと	極太
ごくひん	極貧
ごくひり	極秘裏	極秘裡
ごくない	獄内
ごくどう	極道
ごくつぶ	穀潰
ごくそつ	獄卒
ごくそく	極促	獄則
ごくそう	獄窓
ごくしん	極信
ごくしょ	極暑
ごくしゃ	獄舎
ごくさむ	極寒
ごくさい	極彩
ごくごく	極々
ごくげつ	極月
ごくけい	極刑
ごくかん	極寒
ごくいん	極印
ごくあく	極悪
ごぎろん	御議論
ごぎょう	五行	御形
ごぎゅう	呉牛
ごぎゃく	五逆
ごぎてき	語義的
ごきょか	御許可
ごきょう	五経	五橋
ごきゅう	誤球	御給
ごきゃく	五脚
ごきぼう	ご希望	御希望
ごきたい	御期待	ご期待
ごきげん	御機嫌	ご機嫌
ごきおく	御記憶
ごかんど	互換度
ごかんき	互換機
ごかぼう	五家宝
ごかてい	ご家庭	御家庭
ごかって	御勝手
ごかぞく	御家族	ご家族
ごおんこ	ご恩顧	御恩顧
ごおうぼ	御応募	ご応募
ごえもん	五衛門	五右衛門
ごえいか	御詠歌
ごうわん	剛腕
ごうれい	号令
ごうりき	強力	合力	剛力
ごうりか	合理化
ごうよく	強欲	強慾
ごうゆう	豪遊	傲遊	遨遊
ごうもん	拷問
ごうもう	剛毛
ごうめい	合名
ごうまん	傲慢
ごうまつ	毫末	劫末
ごうぼう	号棒
ごうほう	業報	号俸	合法	号砲	豪放
ごうべん	合弁
ごうへん	合片
ごうへき	剛壁
ごうぶち	格縁
ごうふく	剛愎	剛腹
ごうびん	合瓶
ごうひつ	合筆
ごうばん	合板
ごうばつ	劫罰
ごうはん	合板
ごうはら	郷原	業腹
ごうのう	豪農
ごうどう	合同
ごうとう	号棟	鼇頭	強盗
ごうてい	豪邸
ごうちん	轟沈
ごうだん	強談
ごうだつ	強奪
ごうたん	豪胆	剛胆
ごうたい	剛体
ごうぞく	豪族
ごうそう	合装	豪壮
ごうぜん	傲然	轟然
ごうせん	号線	合繊	合線
ごうせつ	豪雪
ごうせい	豪勢	合生	合性	強請	合成	剛性
ごうすう	号数
ごうしょ	劫初
ごうしゅ	強酒
ごうしゃ	豪奢	号車
ごうしつ	号室
ごうごう	囂々	囂囂	轟々
ごうこん	合コン
ごうこく	合刻
ごうげい	傲睨
ごうけん	剛健	剛堅	合憲
ごうけつ	豪傑
ごうけい	豪渓	合計
ごうぐら	郷倉
ごうきん	合金
ごうがん	傲岸
ごうがい	號外	号外
ごうかん	号館	合巻	強姦
ごうかく	合格
ごうかい	豪快
ごうおん	轟音	号音
ごういん	強引	業因
ごういど	合意度
ごういつ	合一
ごういご	合意後
ごいらい	御依頼	ご依頼
ごいてき	語彙的
ごいたい	御遺体
ごいぞく	御遺族
ごいすう	語彙数
ごいさぎ	五位鷺
ごいこう	御意向
ごいけん	御意見	ご意見
ごあいこ	ご愛顧	御愛顧
げんわく	幻惑	眩惑
げんろん	原論	言論
げんろく	元禄
げんろう	元老
げんりず	原理図
げんよう	幻幼	現用	原葉	幻妖
げんゆう	現有
げんもん	厳門
げんもく	眩目
げんもう	原毛	減耗
げんめん	原綿	減免
げんめつ	幻滅	減滅
げんめい	言明	厳命
げんみつ	厳密
げんまん	拳万
げんまき	弦巻
げんまい	玄米
げんぽん	原本
げんぽう	現法	減俸	減法
げんぼん	原本
げんぼく	原木
げんぺい	源平
げんぷく	元服
げんぷう	厳封
げんぶん	言文	原文	元文
げんぶつ	現物	原物
げんぴん	現品	原品
げんびん	減便
げんぱん	原版
げんぱつ	原発
げんぱく	玄白
げんぱい	減配
げんばん	原版	原盤
げんばつ	厳罰
げんばく	原爆
げんのう	玄翁	源翁	玄能	言翁	玄応
げんにん	現認	現任
げんなま	現ナマ	現生
げんなお	験直
げんない	源内
げんどう	言動	原動
げんとく	元徳	玄徳
げんとう	幻燈	幻灯	厳冬	舷灯
げんてん	原点	原典	減点
げんてい	舷梯	限定
げんつき	原付
げんちょ	原著
げんちご	現地語
げんだか	現高
げんだい	原題	現代
げんたん	減反
げんたつ	厳達
げんたい	原隊	減退	原態
げんぞん	現存
げんぞく	還俗
げんぞう	原像	現像	幻像
げんそん	玄孫	減損	現存	厳存
げんそく	減速	舷側	原則
げんそう	幻想	現送	舷窓
げんぜん	儼然	現前	厳然
げんぜい	減税
げんせん	厳選	原潜	源泉	言泉
げんせつ	言説
げんせき	原籍	言責	原石
げんせい	現勢	厳正	現姓	現生	原生	現世
げんすん	原寸
げんすう	元数	現数	減数
げんすい	元帥	減水	減衰
げんじん	原人
げんじな	源氏名
げんじつ	現実
げんじえ	源氏絵
げんしん	原信	原審
げんしろ	原子炉
げんしょ	原書	原初	厳暑
げんしゅ	原酒	厳守	原種	元首
げんしゃ	減車
げんしつ	玄室	原質	言質
げんしち	源七
げんしじ	原子時
げんざん	減算
げんざい	現在	原罪
げんさん	原産	減産	減算
げんさく	減作	原作
げんさい	減殺	幻妻	減債	衒妻
げんごや	言語野	言語屋
げんごか	言語化
げんごう	元号	減号
げんこん	眼根	現今
げんこつ	拳骨
げんこく	原告	現国
げんこう	元寇	原稿	減光	言行	弦高	原鉱	現行	元弘
げんげつ	弦月	限月
げんけん	原研	原券
げんけい	現形	減刑	元型	原形	減軽	原型	厳刑
げんくん	元勲	厳君
げんくう	源空
げんぎょ	言語
げんきん	厳禁	現金
げんきょ	原拠
げんきづ	元気付
げんがく	弦楽	減額	衒学	絃楽
げんがい	限外	言外
げんかん	玄関	厳寒
げんかし	原歌詞
げんかく	幻覚	厳格
げんかい	幻界	幻怪	厳戒	言海	諺解	顕界	限界	幻海	玄海
げんおん	原音	現音
げんおう	元応	玄奥
げんえん	減塩
げんえき	減益	原液	現役
げんえい	幻影
げんうん	眩暈
げんいん	原因	減員	現員
げんいち	源一	元一	現位置
げんあん	現案	原案
げんあつ	減圧
げろかん	下呂間
げるちん	ゲル沈
げりゃく	下略
げりべん	下痢便
げりどめ	下痢止め
げばぼう	ゲバ棒
げてもの	下手物
げつれい	月例	月齢
げつりん	月輪
げつらい	月来
げつよう	月曜
げつもく	月木
げつめん	月面
げつめい	月明
げつまつ	月末
げつまえ	月前
げつぶん	月分
げつがく	月額
げつかん	月間
げつえい	月影
げっぽう	月報	月俸
げっぺい	月餅
げっとう	月桃
げったん	月旦
げっそう	月相
げっせき	月夕
げっしょ	月初
げっしゃ	月謝
げっさん	月産
げっこう	激高	月光	激昂
げっけい	月経	月計
げっかん	月間	月刊
げたばこ	下駄箱
げじょう	下城	下乗
げじゅん	下旬
げじげじ	蚰蜒
げしゅく	下宿
げしゃじ	下車時
げしゃく	外戚
げこうじ	下校時
げこうご	下校後
げきろん	激論
げきろう	激浪
げきれつ	劇烈	激烈
げきれい	激励
げきりん	逆鱗
げきやす	激安
げきやく	劇薬
げきめつ	撃滅
げきへん	激変
げきぶん	檄文
げきぶつ	劇物
げきはつ	激発
げきはく	激白
げきどく	劇毒
げきどう	激動
げきとつ	激突
げきとう	激闘
げきてつ	撃鉄
げきてき	劇的
げきつう	劇通	劇痛	激痛
げきつい	撃墜
げきちん	撃沈
げきだん	劇談	劇団	劇壇
げきたく	撃柝
げきたい	撃退
げきぞう	激増
げきそう	激走
げきぜん	闃然
げきせん	激戦
げきしん	激震	撃針
げきしょ	激暑
げきしゃ	激写
げきざる	外記猿
げきさん	激賛
げきさく	劇作
げきさい	撃砕
げきこみ	激混
げきこう	激昂
げきげん	激減
げきけん	撃剣
げきがし	劇画誌
げきから	激辛
げきかい	劇界
げきえつ	激越
げきあま	激甘
げきあせ	激汗
げかてき	外科的
げかしつ	外科室
げいれき	芸歴
げいめい	芸名
げいほく	芸北
げいぶん	芸文
げいふう	芸風
げいひん	迎賓
げいのう	芸濃	芸能
げいにん	芸人
げいにく	鯨肉
げいどう	芸道
げいとう	藝當	芸当
げいだん	芸談
げいだい	芸大
げいたん	芸短
げいせつ	迎接
げいせい	芸西
げいしゃ	迎車	芸者
げいごと	芸事
げいごう	迎合
げいげき	迎撃
げいかい	芸界
げいいん	鯨飲
げいいき	芸域
げーむさ	ゲーム差
げーむき	ゲーム機
ぐんろん	群論
ぐんれい	軍令
ぐんりょ	軍旅
ぐんりつ	軍律
ぐんらく	群落
ぐんよう	軍用
ぐんゆう	群雄
ぐんやく	軍役
ぐんもん	軍門
ぐんもう	群盲
ぐんみん	軍民
ぐんぽう	群峰	軍法
ぐんぼう	軍帽
ぐんぷく	軍服
ぐんぱつ	群発
ぐんばつ	軍閥
ぐんばい	軍配
ぐんない	郡内
ぐんとう	群盗	群島	軍刀
ぐんてい	軍偵
ぐんだん	軍談	群団	軍団
ぐんだり	軍荼利
ぐんだい	群大
ぐんたい	軍隊	群体
ぐんぞく	軍属
ぐんぞう	群像
ぐんそつ	軍卒
ぐんそく	軍足
ぐんそう	軍装	軍曹
ぐんぜい	軍勢
ぐんせん	軍船
ぐんせき	軍籍
ぐんせい	群生	軍制	軍政
ぐんすう	群数
ぐんじん	軍陣	軍人
ぐんじゅ	軍需
ぐんじひ	軍事費
ぐんしん	群臣	軍神
ぐんしょ	軍書	群書
ぐんざん	群山
ぐんさい	軍才
ぐんこく	軍国
ぐんこう	軍港	軍功
ぐんけん	軍犬
ぐんきょ	群居
ぐんがく	軍楽	軍学
ぐんかん	軍艦	軍鑑
ぐんかく	軍拡
ぐんえき	軍役
ぐんえい	軍営	群栄
ぐんいち	軍一
ぐれんな	紅蓮奈
ぐらふか	グラフ化
ぐびじん	虞美人
ぐちょく	愚直
ぐたいか	具体化
ぐずぐず	愚図愚図
ぐすくべ	城辺
ぐじょう	郡上
ぐしょう	具象
ぐしけん	具志堅
ぐしかわ	具志川
ぐしかみ	具志頭
ぐげんか	具現化
ぐうゆう	偶有
ぐうもく	寓目
ぐうはつ	偶発
ぐうぞう	偶像
ぐうぜん	偶然
ぐうせい	偶成
ぐうすう	偶数
ぐうじん	偶人
ぐうさく	偶作
ぐうげん	寓言
ぐうきょ	寓居
ぐうかん	偶感
ぐうかく	隅角
ぐうえん	宮宛
ぐうえい	偶詠
ぐういん	偶因
ぎんれい	銀鈴	銀嶺
ぎんりん	銀鈴	銀輪	銀鱗
ぎんらん	銀蘭
ぎんよく	銀翼
ぎんゆう	吟遊
ぎんめん	銀面
ぎんむく	銀無垢
ぎんまく	銀幕
ぎんべえ	銀兵衛
ぎんぷん	銀粉
ぎんぱつ	銀髪
ぎんぱく	銀箔
ぎんぱい	銀杯	銀盃
ぎんばん	銀盤
ぎんねず	銀鼠
ぎんねこ	銀猫
ぎんなん	銀杏
ぎんでい	銀泥
ぎんだら	銀鱈
ぎんだま	銀玉
ぎんぞう	銀蔵
ぎんせん	銀川	銀線	銀泉
ぎんせつ	銀雪
ぎんせい	銀星	吟声	銀製
ぎんすじ	銀筋
ぎんしゅ	銀朱
ぎんしゃ	銀砂
ぎんざん	銀山
ぎんこう	銀行	吟行	銀鉱	銀坑	銀鉤
ぎんがみ	銀紙
ぎんかく	銀閣
ぎんかい	銀塊
ぎんえん	銀塩
ぎんえい	吟詠
ぎんうち	銀打
ぎんいろ	銀色
ぎんいち	銀一
ぎろんず	議論好
ぎろんじ	議論時
ぎりょう	技量	技倆	議了
ぎりだて	義理立て
ぎりしあ	希臘
ぎりがた	義理堅
ぎょろう	漁撈
ぎょれん	魚連
ぎょるい	魚類
ぎょりん	魚鱗
ぎょらん	魚卵
ぎょらい	魚雷
ぎょもう	漁網	魚網
ぎょめい	御名
ぎょみん	漁民
ぎょほう	漁法
ぎょぶつ	御物
ぎょふん	魚粉
ぎょにく	魚肉
ぎょだい	御題
ぎょたん	魚探
ぎょたく	魚拓
ぎょたい	魚体
ぎょぞく	魚族
ぎょそん	漁村
ぎょせん	漁船	御撰
ぎょせい	御製
ぎょしん	御寝	魚信
ぎょしゅ	魚種
ぎょしゃ	馭者	御者
ぎょこう	漁港
ぎょけい	魚形	御慶
ぎょぐん	魚群
ぎょくろ	玉露
ぎょくざ	玉座
ぎょがん	魚眼
ぎょかく	漁獲
ぎょかい	魚貝	魚会	魚介
ぎょえん	御苑
ぎょえい	御影	魚影
ぎょうめ	行目
ぎょうむ	業務
ぎょうぶ	刑部	行歩
ぎょうだ	行田
ぎょうじ	行司	行事
ぎょうし	仰視	凝脂	凝視
ぎょうざ	餃子
ぎょうこ	凝固
ぎょうぎ	行儀	行義	凝議
ぎょうき	行基
ぎょうが	仰臥
ぎょーざ	餃子
ぎゅうほ	牛歩
ぎゅうひ	牛皮	求肥
ぎゅうば	牛馬
ぎゅうじ	牛耳
ぎゅうし	牛脂
ぎゅうご	牛後
ぎゃくり	逆理
ぎゃくむ	逆向
ぎゃくび	逆引
ぎゃくひ	逆比
ぎゃくば	逆張
ぎゃくと	逆徒
ぎゃくて	逆手
ぎゃくし	虐使
ぎもんふ	疑問符
ぎもんし	疑問視	疑問詞
ぎむてき	義務的
ぎむづけ	義務付け	義務づけ
ぎむしゃ	義務者
ぎむかん	義務感
ぎふべん	岐阜弁
ぎふだい	岐阜大
ぎふけん	岐阜県
ぎふえき	岐阜駅
ぎひょう	技評	儀表	戯評
ぎのわん	宜野湾
ぎっしゃ	牛車
ぎちょう	議長
ぎだゆう	義太夫
ぎたいご	擬態語
ぎせいだ	犠牲打
ぎせいご	擬声語
ぎじんか	擬人化
ぎじろく	議事録
ぎじょう	儀杖	議定	技情	儀仗	議場	戯場
ぎじゅつ	技術
ぎじゅく	羲塾	義塾
ぎじばり	疑似針	擬餌鉤
ぎじはん	疑似半
ぎじどう	議事堂
ぎじとう	擬似頭
ぎじてき	疑似的	擬似的
ぎじしき	擬似式
ぎじえさ	擬似餌
ぎしょう	擬傷	偽証	宜昌	偽称
ぎしゅう	蟻集
ぎこぶん	擬古文
ぎこうは	技巧派
ぎけいき	義経記
ぎきょく	戯曲
ぎきょう	義侠	偽経
ぎがてき	戯画的
ぎかだい	技科大
ぎおんご	擬音語
がんろう	玩弄
がんりき	願力	眼力
がんらい	元来
がんゆう	含有
がんやく	丸薬
がんもん	願文	雁門
がんもく	眼目
がんもう	願望
がんめん	顔面
がんめい	頑迷
がんぽん	元本
がんぼう	顔貌	眼房	願望
がんぺき	岩壁	岸壁
がんぺい	贋幣
がんぷく	眼福
がんぶつ	贋物
がんぴし	雁皮紙
がんぱく	雁帛
がんばん	岩盤
がんばり	頑張り
がんねん	元年
がんてい	眼底
がんつう	眼痛
がんちく	含蓄
がんだれ	厂
がんだて	願立て
がんだい	岩大
がんたん	元旦
がんたい	眼帯
がんぞう	贋造
がんそう	含嗽
がんぜん	眼前
がんぜな	頑是無
がんせん	頑癬
がんせき	岩石
がんせい	眼睛
がんすい	含水
がんじん	鑑真
がんじつ	元日
がんしん	眼振
がんしょ	雁書	願書
がんしゅ	願主	癌腫
がんしゃ	顔射
がんしつ	眼疾
がんしき	眼識
がんざい	丸剤
がんさつ	贋札
がんさく	贋作
がんさい	岩滓
がんこう	眼光	雁行	眼孔
がんけん	頑健	眼瞼	癌研
がんけい	眼径	眼形
がんぐや	玩具屋
がんくび	雁首
がんくつ	岩窟
がんきん	元金	眼筋
がんかけ	願掛け
がんかい	眼界	眼科医	岩塊
がんえん	岩塩
がんあつ	眼圧
がわいた	側板
がりょく	画力
がりょう	雅量	画料
がりゅう	我流
がりべん	ガリ勉
がりばん	がり版	ガリ版
がりうむ	Gallium	Ga
がらもの	柄物
がらっと	ガラっと
がらあき	ガラ空き	がら空き
がようし	画用紙
がまもく	Typales	ガマ目
がまぐち	蝦蟇口	がま口
がぶのみ	がぶ飲み
がびょう	画鋲
がびさん	峨眉山
がなりた	がなり立
がつまつ	月末
がつぶん	月分
がつばん	月版
がつすえ	月末
がつごう	月号
がつころ	月頃
がっぽん	合本
がっぽう	合邦
がっぺい	合併
がっぴつ	合筆
がってん	合点	月天	合點
がってつ	合綴
がったい	合體	合体
がっそう	合奏	合葬
がっせん	合戦
がっせい	合生
がっさん	合算	月山
がっさつ	合冊
がっさく	合作
がっさい	合財	合切
がっこう	學校	学校
がっけん	学研
がっけい	学兄	学系
がっきや	楽器屋
がっかん	学監	学館
がっかい	学会	楽界	学界
がちりん	月輪
がちょう	画帳	画調	鵝鳥	画帖	鵞鳥
がたおち	がた落ち
がぞうぶ	画像部
がぞうと	画像取
がそない	画素内
がそすう	画素数
がそごと	画素毎
がそかん	画素間
がせんし	画仙紙
がすもれ	ガス漏れ
がすぶろ	ガス風呂
がすぬき	ガス抜き
がすとう	ガス灯
がすでん	ガス田
がすだい	ガス代
がすしつ	ガス室
がすしき	ガス式
がすけつ	ガス欠
がすがま	ガス釜
がじょう	芽条	画帖	賀状	牙城
がじゅん	雅馴
がしょう	画商	賀正	臥床	雅称
がしゅん	賀春
がしゅう	我執	画集
がししゃ	餓死者
がざいや	画材屋
がさんび	臥蚕眉
がさいれ	ガサ入れ
がけした	崖下
がけくず	崖崩
がくわり	学割
がくろく	岳麓
がくれん	学連
がくれき	学歴
がくれい	学齢
がくるい	学類
がくらん	学らん	学ラン
がくよう	岳陽
がくゆう	学友
がくもん	学問
がくめん	額面
がくめい	学名
がくぼく	学僕
がくぼう	学帽
がくほう	学報
がくへん	咢片	がく片	萼片
がくぶち	額縁
がくふや	楽譜屋
がくふか	楽譜化
がくふう	学風
がくびわ	楽琵琶
がくばつ	学閥
がくばす	学バス
がくねん	学年
がくない	学内
がくどう	楽堂	学堂	学童
がくとく	学徳
がくとう	学頭	咢筒
がくでん	学田
がくてん	楽典
がくてき	学的
がくだん	楽壇	楽団
がくたい	楽隊
がくそつ	学卒
がくそく	学則
がくそう	学僧	学聡	学窓	楽箏	楽想
がくぜん	愕然
がくせつ	学説	楽節
がくせき	学籍
がくせい	学制	学生	楽聖
がくじん	楽人
がくじぶ	学事部
がくしん	学術振興会	学術審議会	学振
がくしゅ	楽手
がくしゃ	学者	学舎
がくしき	学指揮	学識
がくさい	学際	楽才	学才	学祭
がくげき	楽劇
がくげい	学芸
がくぐん	学群
がくがい	学外
がくおん	楽音
がくえん	学園
がくいん	楽員	学院
がくいり	額入り
がくいき	学位記
がぎょう	が行	ガ行	画業
がきょう	画境
がきどう	餓鬼道
ががんぼ	大蚊
がいろん	概論
がいりん	外輪
がいらん	外乱
がいらい	外来
がいよう	外洋	外用	概要
がいゆう	外遊	外憂
がいもん	外門
がいもう	外毛
がいめん	外面
がいまい	外米
がいぼう	外貌
がいほう	概包	外報
がいへき	外壁
がいぶん	外聞	外分
がいぶつ	外物
がいばん	外盤
がいはん	外販	外板
がいはく	外泊	該博
がいねん	概念	外燃
がいどく	害毒
がいどう	外道
がいとう	該当	街頭	街灯	外灯	街燈	外套
がいでん	外電	外伝
がいてん	外典	外点	外転
がいてき	外敵	外的
がいだん	街談
がいだい	外大
がいたん	慨歎	外端	慨嘆
がいため	外為
がいたい	外帯
がいそん	外孫
がいそぼ	外祖母
がいそふ	外祖父
がいそく	外足	外側
がいそう	外装	咳嗽	外層	外挿
がいぜん	慨然	蓋然
がいせん	凱旋	外線	街宣
がいせつ	概説	外接
がいせき	外戚	外積
がいせい	外声	外征	慨世	蓋世	外生
がいすう	概数
がいじん	外陣	外人
がいじゅ	外需
がいしん	害心	外信	外申	外心
がいしょ	外書
がいしゃ	会社	外車
がいして	概して
がいざい	外在	外材
がいさん	概算
がいさい	外債
がいこん	外婚
がいこつ	蓋骨	外骨	骸骨
がいこく	外国
がいこう	外向	外寇	外光	外港	外交
がいけん	外圏	外見
がいけい	外形	外傾	概形	外径
がいぎょ	害魚
がいきん	外勤
がいかん	外観	概観	外環	外患
がいかつ	概括
がいかく	外郭	外廓	外殻	外角
がいかい	外海	外界
がいえん	外苑	外縁	外薗	外延
がいいん	外因
がいあつ	外圧
がいあく	害悪
ごんりょう	艮陵
ごんじょう	言上
ごんぎょう	勤行
ごろうまる	五郎丸
ごろうじん	御老人
ごろあわせ	語呂合せ
ごれんらく	ご連絡	御連絡
ごれいぜん	御霊前
ごりょこう	御旅行
ごりょうば	御猟場
ごりょうち	御料地
ごりょうけ	御両家
ごりゅうい	御留意
ごらんくだ	御覧下
ごらくよう	娯楽用
ごらくぼん	娯楽本
ごらくてき	娯楽的
ごらくせい	娯楽性
ごらくしつ	娯楽室
ごらくさく	娯楽作
ごらくきじ	娯楽記事
ごらいりん	ご来臨	御来臨
ごらいてん	ご来店	御来店
ごらいごう	御来迎
ごらいこう	御来光	ご来光
ごようろん	語用論
ごようめい	御用命	ご用命
ごようまつ	五葉松
ごようぼう	ご要望	御要望
ごようはじ	御用始
ごようてい	御用邸
ごようだつ	御用達
ごようたつ	御用達
ごようたし	御用達
ごようじん	御用心
ごようしゃ	ご容赦	御容赦
ごようきん	御用金
ごようきき	御用聞	御用聞き
ごようおさ	御用納
ごゆうどう	誤誘導
ごゆうじん	御友人
ごもくめし	五目飯
ごめんどう	御面倒
ごめんくだ	御免下
ごめいわく	御迷惑	ご迷惑
ごめいふく	御冥福
ごめいとう	御名答
ごめいさつ	ご明察	御明察
ごみんかん	護民官
ごみぶくろ	ゴミ袋
ごみひろい	ゴミ拾い
ごみすてば	ゴミ捨て場
ごまんにん	五万人
ごまんきつ	御満喫
ごまんえつ	御満悦
ごまよごし	胡麻汚し
ごまのはい	護摩の灰
ごまどうふ	胡麻豆腐
ごまあぶら	胡麻油
ごぼうせい	五芒星
ごほんらい	語本来
ごほんにん	御本人
ごほんぞん	御本尊
ごほうめい	ご芳名	御芳名
ごほうねん	御放念	ご放念
ごほうどう	誤報道
ごほうぜん	御宝前
ごほうこく	ご報告	御報告
ごべんたつ	御鞭撻
ごへんとう	御返答
ごへんそう	御返送	ご返送
ごへんこう	御変更
ごへんかん	誤変換
ごふんかん	五分間
ごふじょう	御不浄
ごびへんか	語尾変化
ごひょうじ	誤表示
ごひょうき	誤表記
ごひひょう	御批評
ごばんわり	碁盤割り
ごばんがい	五番街
ごはんてい	誤判定
ごはんだん	誤判断	御判断
ごはんえい	ご繁栄	御繁栄
ごはつげん	御発言
ごはってん	ご発展	御発展
ごはっこう	誤発行
ごはいりょ	御配慮	ご配慮
ごはいさつ	御拝察
ごのうせん	五能線
ごねんかん	五年間
ごにんしき	誤認識
ごどうやく	御同役
ごどうはん	御同伴
ごどうはい	御同輩
ごとうろん	御討論
ごとうてん	後藤点
ごとうすう	誤答数
ごとうしょ	御当所
ごとうごう	誤統合
ごとうくん	後藤君
ごでんじゅ	御伝授
ごてんやま	御殿山
ごてんした	御殿下
ごてゆうり	後手有利
ごていねい	ご丁寧	御丁寧
ごていせい	御訂正
ごていしゅ	御亭主
ごていあん	御提案
ごちゅうい	御注意	ご注意
ごだんかい	五段階
ごだいどう	五大堂
ごだいさん	五台山
ごたんとう	御担当
ごたしょう	御多祥	ご多祥
ごたくせん	ご託宣	御託宣
ごたいりく	五大陸
ごたいめん	御対面
ごたいそう	ご大層	御大層
ごたいおう	御対応
ごそんがん	御尊顔
ごそくろう	ご足労	御足労
ごそうだん	ご相談	御相談
ごそうぞう	御想像
ごそうしゃ	護送車
ごぜんやま	御前山
ごぜんびん	午前便
ごぜんはつ	午前発
ごぜんさま	午前様
ごせんもん	御専門
ごせんえん	五千円
ごせつめい	御説明
ごせつぞく	誤接続
ごせいらん	御清覧
ごせいたん	御生誕
ごせいこん	御成婚
ごせいこう	御成功
ごせいえん	御声援
ごせいえい	御清栄	御盛栄	ご清栄
ごせいうん	ご盛運	御盛運
ごすんくぎ	五寸釘
ごすいせん	御推薦
ごすいさつ	御推察
ごじんたい	御神体
ごじょほう	互除法
ごじょげん	御助言
ごじょかい	互助会
ごじょうめ	五城目
ごじゅんび	御準備
ごじゅっぽ	五十歩
ごじみゃく	五次脈
ごじつだん	後日談
ごじつたん	後日譚
ごじだつじ	誤字脱字
ごしんぼく	御神木
ごしんぱい	ご心配	御心配
ごしんとう	御神灯
ごしんたく	御神託	ご神託
ごしんたい	御神体
ごしんせん	五新線
ごしんせつ	御親切
ごしんえい	御真影
ごしょもう	御所望
ごしょめい	御署名
ごしょぞく	御所属
ごしょくじ	御食事
ごしょうみ	御賞味
ごしょうち	ご承知	御承知
ごしゅるい	五種類
ごしゅじん	ご主人	御主人
ごしゅこう	御趣向
ごしゅうめ	五週目
ごしゅうち	御周知
ごしゅうぎ	御祝儀
ごしつもん	ご質問	御質問
ございしょ	御在所
ごさんれつ	ご参列	御参列
ごさんどう	御賛同	ご賛同
ごさんこう	御参考
ごさんかた	御三方
ごさはんい	誤差範囲
ごさしゅう	御査収
ごさかくど	誤差角度
ごごんこし	五言古詩
ごこうりょ	御考慮
ごこうらん	ご高覧	御高覧
ごこうはい	御高配	ご高配
ごこうえん	御講演
ごげんてき	語源的
ごげんせつ	語源説
ごけんとう	御検討	ご検討	御健闘
ごけんそん	御謙遜
ごけんこう	御健康
ごけっせき	御欠席	ご欠席
ごけっこん	ご結婚	御結婚
ごけだおし	後家倒し
ごけいけん	御経験
ごけいいか	五桂以下
ごくらくじ	極楽寺
ごくふつう	極普通
ごくどうし	極道史
ごくつぶし	穀潰し
ごくちゅう	獄中
ごくじょう	極上
ごくしょき	極初期
ごくしょう	極小
ごくしゅう	獄囚	極宗
ごくいちぶ	極一部
ごきんじょ	ご近所	御近所
ごきょうみ	御興味
ごきょうじ	御教示	ご教示
ごきにゅう	ご記入	御記入
ごがつさい	五月祭
ごがくよう	語学用
ごがくてき	語学的
ごかんよう	御寛容	ご寛容
ごかんまつ	語幹末
ごかんべん	御勘弁
ごかんひん	互換品
ごかんそう	御感想	ご感想
ごかんせい	互換性
ごかんしん	御関心
ごかんしょ	後漢書
ごかんおう	五冠王
ごかつよう	御活用
ごかつやく	御活躍	ご活躍
ごかっけい	五角形
ごかじょう	五カ条
ごかしょう	五個荘
ごかくにん	御確認	ご確認
ごかくけい	五角形
ごかいどう	五街道
ごかいとう	御回答	ご回答
ごかいそう	御会葬	ご会葬
ごかいせつ	御解説
ごかいしょ	碁会所
ごえんりょ	御遠慮
ごえんだま	五円玉
ごえんじょ	ご援助	御援助
ごえいへい	護衛兵
ごえいてん	御栄転	ご栄転
ごえいかん	護衛艦
ごうりょく	合力
ごうりゅう	合流
ごうりゃく	劫掠
ごうりてき	合理的
ごうりせい	合理性
ごうほうり	合法裏
ごうほうか	合法化
ごうべんか	合弁花
ごうびょう	業病
ごうのもの	剛の者
ごうのうら	郷ノ浦
ごうどうし	合同誌
ごうとくじ	豪徳寺
ごうちょく	剛直
ごうちゃく	合着
ごうせいゆ	合成油
ごうせいす	合成酢
ごうせいご	合成語
ごうせいか	合成化
ごうじょう	剛情	強情	強盛
ごうしょう	合焦	業障	江商	豪商	号証
ごうしゅう	豪州
ごうけつじ	豪血寺
ごうけいち	合計値
ごうぎたい	合議体
ごうぎせい	合議制
ごうきょう	剛強
ごうきゅう	強弓	号泣	剛球
ごうがしゃ	恒河沙
ごうかんま	強姦魔
ごうかぼん	豪華本
ごうかばん	豪華版
ごうかせん	豪華船
ごうかくじ	合格時
ごういてん	合意点
ごういしょ	合意書
ごういあん	合意案
ごいんきょ	御隠居
ごいりよう	御入用
ごいっぽう	御一報
ごいっしん	御一新
ごいっしょ	ご一緒	御一緒
ごいっこう	御一考	御一行
ごいちどく	御一読
ごあんない	御案内	ご案内
ごあんしん	御安心
ごあいよう	ご愛用	御愛用
ごあいさつ	ご挨拶	御挨拶
げんろせん	現路線
げんりょう	限量	原料	減量
げんりゅう	原流	源流
げんりてき	原理的
げんりけん	原理研
げんゆうき	現有機
げんもけい	原模型
げんみょう	玄妙
げんぶがん	玄武岩
げんぴょう	原票
げんひそう	原皮層
げんひしつ	原皮質
げんばがわ	現場側
げんはけい	原波形
げんなおし	験直し
げんどがく	限度額
げんどうき	原動機
げんとうき	厳冬期
げんていし	限定詞	限定子
げんちよみ	現地読み
げんちょう	弦長	幻聴	現調
げんちゅう	原虫	原註
げんちゃり	原チャリ
げんちはつ	現地発
げんちてん	現地点
げんちじん	現地人
げんちがし	現地貸
げんだいし	現代詩	現代史
げんだいご	現代語
げんたんか	原単価
げんたろう	玄太郎	厳太郎
げんそくひ	減速比
げんそくど	減速度
げんそくじ	減速時
げんそくご	減速後
げんせいど	現制度
げんずけい	原図形
げんすいは	減衰波
げんすいき	減衰器
げんじろう	源二郎
げんじょう	原状	玄奘	現場	現状
げんじゅつ	幻術
げんじゅう	現住	幻獣	厳重
げんじゃく	減弱
げんじばこ	源氏箱
げんじてん	現時点
げんじつみ	現実味
げんじつは	現実派
げんじつか	現実化
げんしろん	原子論
げんしろう	源四郎
げんしりん	原始林
げんしょく	原色	減色	減食	現職
げんしょう	減少	現症	現象
げんしゅつ	現出	幻出
げんしゅく	減縮	厳粛
げんしゅう	減収	現収
げんしゃく	現尺
げんしとう	原始島
げんしてき	原始的
げんしだん	原子団
げんしすう	原子数
げんしじん	原始人
げんししき	原始式	原子式
げんしけい	原子系
げんしかく	原子核
げんざんき	減算器
げんざいち	現在値	現在地
げんさんち	原産地
げんさんき	減算器
げんごろん	言語論
げんごろう	源五郎
げんごよう	言語用
げんごめい	言語名
げんごべつ	言語別
げんごばん	言語版	原語版
げんごとう	言語島
げんごてき	言語的
げんごぞく	言語族
げんごけん	言語研
げんごけい	言語系
げんごがく	言語学
げんごかん	言語感
げんごおん	言語音
げんげんご	原言語
げんぎょう	現業
げんきんか	現金化
げんきよし	元気良
げんきょく	原局	原曲	限局	元曲
げんきょう	現況	元凶
げんきゅう	減給	言及	原級
げんきゃく	減却
げんきもの	元気者
げんきかい	現棋界
げんがてん	原画展
げんがっき	弦楽器
げんがぞう	原画像
げんかいち	限界値
げんかいじ	限界時
げんえきば	現役馬
げんえきき	現役機
げんあつき	減圧器
げりらてき	ゲリラ的
げりらせん	ゲリラ戦
げらくはば	下落幅
げばひょう	下馬評
げねつざい	解熱剤
げどくざい	解毒剤
げつようび	月曜日
げつかすい	月火水
げっぴょう	月評	月表
げっせかい	月世界
げっしるい	齧歯類	げっ歯類
げっしょく	月蝕	月食
げっしょう	月商	月照
げっしゅつ	月出
げっしゅう	月収
げっしもく	齧歯目
げっきゅう	月給
げっかんし	月刊誌
げそくばん	下足番
げすとよう	ゲスト用
げすいどう	下水道
げすいかん	下水管
げしゅにん	下手人
げしゅくや	下宿屋
げしゃとほ	下車徒歩
げしゃえき	下車駅
げしゃいん	下車印
げさくしゃ	戯作者
げきりょく	撃力
げきりゅう	激流
げきひょう	劇評
げきなみだ	激涙
げきとつし	激突死
げきちんは	撃沈破
げきちょう	外記丁
げきちゅう	劇中
げきせんく	激戦区
げきじょう	劇場	撃攘	激情
げきじゃく	激弱
げきしょく	激職
げきしょう	激賞
げきしゅう	激臭
げきさっか	劇作家
げきえいが	劇映画
げいびせん	芸備線
げいびけい	猊鼻渓
げいじゅつ	芸術	藝術
げいしゅん	迎春
げいしゅう	芸州
げいげきき	迎撃機
げーむよう	ゲーム用
げーむめい	ゲーム名
ぐんれいぶ	軍令部
ぐんりゃく	軍略
ぐんようき	軍用機
ぐんまだい	群馬大
ぐんまけん	群馬県
ぐんぴょう	群氷	軍票	軍兵
ぐんちょう	軍長
ぐんちゅう	軍中
ぐんちえん	群遅延
ぐんそしき	軍組織
ぐんそくど	群速度
ぐんじよう	軍事用
ぐんじょう	群青
ぐんじてき	軍事的
ぐんじそち	軍事措置
ぐんしょう	群小
ぐんしゅく	軍縮
ぐんしゅう	群集	群聚	群衆
ぐんしけい	軍師型
ぐんしきん	軍資金
ぐんきもの	軍記物
ぐんかんぶ	軍艦部
ぐんかんく	軍管区
ぐんかんき	軍艦旗
ぐれんたい	愚連隊
ぐるかへい	グルカ兵
ぐふとくく	求不得苦
ぐはんしゃ	虞犯者
ぐたいろん	具体論
ぐたいれい	具体例
ぐたいてき	具体的
ぐたいせい	具体性
ぐたいさく	具体策
ぐたいけい	具体形
ぐたいあん	具体案
ぐしょうか	具象化
ぐうわてき	寓話的
ぐうりょく	偶力
ぐうちかん	偶置換
ぐうぞうし	偶像視
ぐうぞうか	偶像化
ぐうすうび	偶数日
ぐうすうじ	偶数時
ぐうきせい	偶奇性
ぎんめっき	銀鍍金	銀メッキ
ぎんめだる	銀メダル
ぎんほんい	銀本位
ぎんせかい	銀世界
ぎんすなご	銀砂子
ぎんじょう	吟醸
ぎんしょく	銀燭
ぎんしょう	吟唱	銀将	吟誦	銀賞	銀章	吟嘯
ぎんしゃり	銀舎利	銀シャリ
ぎんざばし	銀座橋
ぎんざちか	銀座地下
ぎんざせん	銀座線
ぎんざがい	銀座街
ぎんざかん	銀座間
ぎんざえき	銀座駅
ぎんこうか	銀行家
ぎんぎつね	銀狐
ぎんきょう	銀鏡
ぎんがめん	銀河面
ぎんがまる	銀河丸
ぎんがちず	銀河地図
ぎんがだん	銀河団
ぎんがけい	銀河系
ぎんかくじ	銀閣寺
ぎろんてき	議論的
ぎろんがい	議論外
ぎれいてき	儀礼的
ぎりちょこ	義理チョコ
ぎりしゃご	ギリシャ語
ぎようせい	擬陽性	偽陽性	疑陽性
ぎょりょう	漁猟
ぎょりゅう	魚龍
ぎょっこう	玉稿	玉鉤
ぎょっかん	玉冠
ぎょじょう	漁場
ぎょしょく	漁色
ぎょしょう	漁礁
ぎょしゅう	漁舟
ぎょしゃざ	馭者座
ぎょくろう	玉楼
ぎょくもん	玉門
ぎょくはく	玉帛
ぎょくはい	玉杯
ぎょくとう	玉東	玉頭
ぎょくだい	玉台	玉代
ぎょくたい	玉体
ぎょくせき	玉石
ぎょくせい	玉成
ぎょくさい	玉砕
ぎょくがん	玉顔
ぎょくおん	玉音
ぎょぎょう	漁業
ぎょきょう	漁況	漁協	魚協
ぎょうれつ	行列
ぎょうりつ	凝立
ぎょうよく	楽欲
ぎょうよう	杏葉
ぎょうむぶ	業務部
ぎょうむき	業務機
ぎょうむか	業務課
ぎょうまつ	行末
ぎょうぼう	仰望
ぎょうほう	行法
ぎょうねん	行年
ぎょうない	行内
ぎょうとく	行徳
ぎょうとう	行頭
ぎょうてん	仰天	暁天
ぎょうつう	暁通
ぎょうだし	行田市
ぎょうたん	行端
ぎょうたい	凝滞	業態
ぎょうぞう	行三
ぎょうそう	形相	行草
ぎょうぜん	凝然
ぎょうせん	暁泉
ぎょうせき	凝析	業績
ぎょうせい	行政	暁星
ぎょうずい	行水
ぎょうすう	行数
ぎょうじん	行人
ぎょうじゃ	行者
ぎょうしょ	行書
ぎょうしゅ	業種
ぎょうしゃ	業者	業社
ぎょうした	行下
ぎょうざや	餃子屋
ぎょうさい	業際
ぎょうこう	僥倖	行幸	暁光
ぎょうけつ	凝血	凝結
ぎょうけい	行刑	行啓
ぎょうがい	仰臥位
ぎょうかん	行間
ぎょうかく	行革	仰角
ぎょうかい	業界	凝塊
ぎょううん	暁雲
ぎょういち	行位置
ぎょうあん	暁闇
ぎゆうへい	義勇兵
ぎゆうぐん	義勇軍
ぎゅうらく	牛酪	牛楽
ぎゅうめし	牛飯
ぎゅうふん	牛糞
ぎゅうひれ	牛ヒレ
ぎゅうにく	牛肉
ぎゅうなべ	牛鍋
ぎゅうどん	牛丼
ぎゅうとう	牛痘	牛刀
ぎゅうてつ	牛鉄
ぎゅうたん	牛タン
ぎゅうじょ	牛女
ぎゅうしゃ	牛車	牛舎
ぎゅうかわ	牛革
ぎゅうえき	牛疫
ぎゃっこう	逆光	逆行
ぎゃくよう	逆用
ぎゃくもど	逆戻
ぎゃくむき	逆向き
ぎゃくまわ	逆回
ぎゃくへん	逆辺	逆片
ぎゃくふう	逆風
ぎゃくびき	逆引	逆引き
ぎゃくひぶ	逆日歩
ぎゃくばり	逆張り
ぎゃくてん	逆転
ぎゃくたん	逆探
ぎゃくたい	虐待
ぎゃくぞく	逆賊
ぎゃくぞう	逆像
ぎゃくそこ	逆底
ぎゃくそう	逆走	逆送	逆相
ぎゃくせつ	逆説	逆接
ぎゃくせい	逆成	虐政
ぎゃくすう	逆数
ぎゃくしん	逆心	逆進	逆臣
ぎゃくざや	逆鞘
ぎゃくさん	逆算
ぎゃくさつ	虐殺
ぎゃくごさ	逆誤差
ぎゃくこう	逆光	逆向
ぎゃくげん	逆元
ぎゃくけい	逆形
ぎゃくぎれ	逆ギレ
ぎゃくがわ	逆側
ぎゃくえん	逆縁
ぎゃくうん	逆運
ぎゃくいち	逆位置
ぎもんぶん	疑問文
ぎもんてん	疑問点
ぎもんしゅ	疑問手
ぎもんけい	疑問形
ぎほうどう	技報堂
ぎぶつほう	擬物法
ぎふはしま	岐阜羽島
ぎふとけん	ギフト券
ぎのうてき	技能的
ぎのうしゃ	技能者
ぎねんりん	偽年輪
ぎにんしん	擬妊娠
ぎていしょ	議定書
ぎたいほう	擬態法
ぎそうかん	蟻走感
ぎぜんてき	偽善的
ぎぜんしゃ	偽善者
ぎせきすう	議席数
ぎせいしゃ	犠牲者
ぎじんほう	擬人法
ぎじんてき	擬人的
ぎじゅつや	技術屋
ぎじゅつぶ	技術部
ぎじゅつし	技術士	技術史	技術誌
ぎじゅつか	技術課	技術家	技術科
ぎじていい	擬似定位
ぎじせかい	擬似世界
ぎじきかん	議事機関
ぎじかがく	擬似科学	疑似科学
ぎしんごう	偽信号
ぎしちょう	技師長
ぎしきてき	儀式的
ぎごしょく	魏呉蜀
ぎこうてき	技巧的
ぎこうしゃ	技工社
ぎげいてん	伎芸天
ぎけつけん	議決権
ぎきょくか	戯曲化
ぎえんきん	義援金	義捐金
ぎいんすう	議員数
ぎあんしょ	議案書
がんりょく	眼力
がんりょう	顔料	含量
がんよぼう	癌予防
がんもどき	雁擬き
がんません	γ線
がんほけん	癌保険	ガン保険
がんびょう	眼病
がんのすけ	雁之助
がんねんど	元年度
がんちゅう	眼中
がんたろう	巌太郎
がんじろう	鴈治郎
がんじょう	頑丈
がんしょく	顔色
がんしょう	岩床	岩漿	翫賞	岩礁
がんしゅう	含羞
がんしぼう	癌死亡
がんこもの	頑固者	巌固者
がんぐばこ	玩具箱
がんきょう	頑強	眼鏡	元凶
がんきゅう	眼球
がんかよう	眼科用
がらんどう	伽藍堂
がらすよう	ガラス用
がらすまど	硝子窓	ガラス窓
がらすびん	ガラス瓶
がらすばり	ガラス張り
がらすたい	硝子体
がらすせい	ガラス製
がらすいた	ガラス板
がめんみぎ	画面右
がめんはば	画面幅
がめんはし	画面端
がめんない	画面内
がめんてき	画面的
がめんした	画面下
がめんがい	画面外
がめんかん	画面間
がまんでき	我慢出来
がまんづよ	我慢強
がまんじる	我慢汁
がまごおり	蒲郡
がまごうり	蒲郡
がまがえる	蝦蟇
がぶんたい	雅文体
がつちゅう	月中
がっぺいじ	合併時
がっぺいご	合併後
がっぴょう	合評
がっちゃく	合着
がったいご	合体後
がっしょう	合焦	合唱	合従	合掌
がっしゅく	合宿
がっしゅう	合衆
がっくない	学区内
がっくこう	学区校
がっくがい	学区外
がっきょく	楽曲
がっきゅう	学究	学級
がっきめい	楽器名
がっきまつ	学期末
がっきほう	楽器法
がっきてん	楽器店
がっきつな	楽器繋
がっきずき	楽器好き
がっきかん	楽器間
がっきおん	楽器音
がっかもく	学科目
がっかない	学科内
がっかせん	顎下腺
がっかごと	学科毎
がっかがい	学科外
がっかいし	学会誌
がちしょう	賀知章
がぞうめん	画像面
がぞうてき	画像的
がぞうかん	画像間
がそみつど	画素密度
がすじゅう	ガス銃
がしつてき	画質的
がざいてん	画材店
がけっぷち	崖っ縁
がけくずれ	崖崩れ
がくりょく	学力
がくりょう	学寮
がくやおち	楽屋落ち
がくやうら	楽屋裏
がくぶない	学部内
がくぶそつ	学部卒
がくぶせい	学部生
がくふよう	楽譜用
がくふがた	楽譜型
がくちょう	学長	楽調	楽長
がくせきぼ	学籍簿
がくせいぶ	学生部
がくせいか	学生課	学生掛
がくじょう	学情	学術情報センター
がくじゅつ	学術
がくしょく	学食	学殖
がくしょう	学匠	学生	楽章	楽匠
がくしゅう	学習	学修
がくしかい	学士会
がくしいん	学士院
がくさいか	学際化
がくぎょう	学業
がくいめい	学位名
ががくせい	画学生
がおんしつ	画音質
がいろとう	街路灯
がいろじゅ	街路樹
がいりょく	外力
がいりゃく	概略
がいらいご	外来語
がいようづ	概要図
がいようず	概要図
がいやせき	外野席
がいやじん	外野陣
がいやしゅ	外野手
がいぶもう	外部網
がいぶてき	外部的
がいぶせい	外部生
がいぶきき	外部機器
がいびぶん	外微分
がいひょう	概評
がいひがわ	外皮側
がいねんず	概念図
がいねんか	概念化
がいちょう	害鳥
がいちゅう	害虫	外注
がいそくど	外測度
がいそうち	外挿値
がいせいき	外性器
がいじよう	外字用
がいじょう	街上
がいじゅう	害獣
がいじどう	外耳道
がいじえん	外耳炎
がいしょく	外食
がいしょう	外傷	街娼	外渉	外商	外相
がいしゅつ	外出
がいしゅう	外周	鎧袖
がいしゃや	外車屋
がいしけい	外資系
がいさんち	概算値
がいこつか	骸骨化
がいこくぶ	外国部
がいこくば	外国馬
がいこくご	外国語
がいこくか	外国課
がいこうし	外交史
がいこうか	外交家
がいきょく	外局
がいきょう	概況	外筐
がいきゃく	外客
がいきけん	外気圏
がいきおん	外気温
がいかんび	外観美
がいかさい	外貨債
がいいんぶ	外陰部
ごるふじょう	ゴルフ場
ごりんよせん	五輪予選
ごりんのしょ	五輪書
ごりんさんか	五輪参加
ごりようくだ	ご利用下	御利用下
ごりょうめい	御両名
ごりょうにん	御両人	御寮人
ごりょうしん	御両親	ご両親
ごりょうしゃ	御料車
ごりょうかく	五稜郭
ごりょうかい	御了解
ごりゅうせい	ご隆盛	御隆盛
ごりむちゅう	五里霧中
ごりかいくだ	御理解下
ごらくしせつ	娯楽施設
ごらくえいが	娯楽映画
ごらいじょう	ご来場	御来場
ごようはじめ	御用始め
ごようちょう	御用帳
ごようきゅう	御要求
ごようおさめ	御用納め
ごもるてがか	ゴモルテガ科	Gomortegaceae
ごもくならべ	五目並べ
ごめんなさい	(_o_)
ごむせいひん	ゴム製品
ごまどうらん	胡麻胴乱
ごへんきゃく	御返却
ごはんじょう	御繁盛	ご繁盛
ごはっぴょう	御発表
ごはっちゅう	御発注
ごにんばやし	五人囃子
ごにゅうきん	ご入金
ごにゅうかい	御入会
ごとうちゃく	ご到着	御到着
ごとうじょう	御登場
ごとうあんし	吾当安此
ごてんばせん	御殿場線
ごていしゅつ	御提出
ごていきょう	御提供
ごちょうせい	誤調整
ごちゅうもん	御注文	ご注文
ごちゅうもく	御注目
ごちゅうこく	御忠告
ごちそうさま	御馳走さま	御馳走様	ごちそう様	ご馳走様	ご馳走さま
ごたんだえき	五反田駅
ごたいとうち	五体投地
ごぞうろっぷ	五臓六腑
ごそんぷさま	御尊父様
ごそつぎょう	御卒業
ごそうにゅう	誤挿入
ごぜんちゅう	午前中
ごぜんじあい	御前試合
ごぜんかいぎ	御前会議
ごせんしゅう	後撰集
ごせいしょう	ご清勝	ご清祥	御清祥	御清勝
ごせいこうき	五星紅旗
ごせいぎょう	ご盛業	御盛業
ごせいきゅう	ご請求	御請求
ごすいしょう	御推奨
ごじんりょく	御尽力
ごじょりょく	御助力
ごじょうだん	御冗談
ごじょうしゃ	誤乗車
ごじょうざか	五条坂
ごじょうえき	五条駅
ごじゅんせつ	五旬節
ごじゅうねん	五十年
ごじゅうそう	五重奏
ごじゅうしょ	ご住所	御住所
ごじゅうから	五十雀
ごじゅうかた	五十肩
ごじゅうおん	五十音
ごじつちゅう	後日注
ごしんじゅつ	護身術
ごしようくだ	御使用下
ごしょのうら	御所浦
ごしょがわら	五所川原
ごしょうらん	御笑覧
ごしょうのう	御笑納
ごしょうだく	御承諾
ごしょうたい	御招待	ご招待
ごしょうきょ	誤消去
ごしょうかい	御照会	御紹介	ご照会	ご紹介
ごしょいずみ	御所泉
ごしゅつえん	御出演
ごしゅっせき	御出席	ご出席
ごしゅっしん	御出身
ごしゅちょう	御主張
ごしゅうにん	御就任	ご就任
ごしゅうしん	ご執心	御執心
ごしどうねが	御指導願
ごしどうくだ	御指導下
ごしてきくだ	御指摘下
ごしっくたい	ゴシック体
ごしちちょう	五七調
ごしうんどう	五
ごさんしょう	御参照
ごさんしゅう	御参集
ごさんかくだ	御参加下
ごさよういん	誤差要因
ごさひょうか	誤差評価
ごさとくせい	誤差特性
ごさしんごう	誤差信号
ごさしひょう	誤差指標
ごさくうかん	誤差空間
ごさきじゅん	誤差基準
ごさかんすう	誤差関数
ごさかくりつ	誤差確率
ごさかいせき	誤差解析
ごごんりっし	五言律詩
ごごんぜっく	五言絶句
ごこんじょう	ご懇情	御懇情
ごこうにゅう	御購入
ごこうじょう	御厚情	ご厚情
ごこうしょう	ご高承
ごこうごみん	五公五民
ごげんどおり	語源通り
ごげんいしき	語源意識
ごけんしょう	御健勝	ご健勝
ごけんきゅう	御研究
ごくろうさま	ご苦労さま	御苦労様
ごくもんとう	獄門島
ごくもんだけ	獄門岳
ごくぼそびき	極細挽き
ごくびしょう	極微小
ごくひじこう	極秘事項
ごくていそく	極低速
ごくていおん	極低温
ごくせつめい	語句説明
ごくさいしき	極彩色
ごくかいせつ	語句解説
ごくかいせき	語句解析
ごくあくにん	極悪人
ごくあくだい	極悪台
ごぎょうせつ	五行説
ごぎゃくざい	五逆罪
ごきょうろん	護教論
ごきょうどう	後教導
ごきょうだい	御兄弟
ごきょうじゅ	御教授
ごきょうさん	御協賛
ごきゅうけい	御休憩
ごきたいくだ	御期待下
ごきげんよう	御機嫌よう
ごがんこうじ	護岸工事
ごがつびょう	五月病
ごがくりょく	語学力
ごがくこうざ	語学講座
ごがくかもく	語学科目
ごかんひょう	互換表
ごかんきよう	互換機用
ごかんきしゅ	互換機種
ごかんいがい	五感以外
ごかいちょう	御開帳
ごえもんぶろ	五右衛門風呂
ごえいくうぼ	護衛空母
ごうれいしき	号令式
ごうりゅうば	剛竜馬
ごうりゅうじ	合流時
ごうりゅうし	合流子
ごうりしゅぎ	合理主義
ごうりかがく	合理科学
ごうもくてき	合目的
ごうほうろん	合法論
ごうほうてき	合法的
ごうほうせい	合法性
ごうどうほう	合同法
ごうどうせい	合同性
ごうつくばり	業突く張り	業突張
ごうたいぼう	剛体棒
ごうせっとう	強窃盗
ごうせいほう	合成法
ごうせいひん	合成品
ごうせいすう	合成数
ごうせいしゅ	合成酒
ごうせいごむ	合成ゴム
ごうせいかん	剛性感
ごうせいかわ	合成革
ごうせいおん	合成音
ごうじょっぱ	強情っ張
ごうけいてん	合計点
ごうけいがく	合計額
ごうきんせい	合金製
ごうかんない	号館内
ごうかんざい	強姦罪
ごうかふろく	豪華付録
ごうかくりつ	合格率
ごうかくてん	合格点
ごうかくしゃ	合格者
ごうかくいん	合格印
ごうかいなべ	豪快鍋
ごういじこう	合意事項
ごういきこう	合意機構
ごいっちょう	御一聴
ごいこうもく	語彙項目
ごいけんやく	御意見役
ごいけんばん	御意見番
ごいけんなど	御意見等
ごあいきょう	御愛敬	御愛嬌	ご愛敬
げんわくてき	幻惑的
げんわかやま	現和歌山
げんろんぶん	原論文
げんろくずし	元禄寿司
げんろういん	元老院
げんりょうし	限量子
げんりょうか	減量化	限量化
げんりゅうち	限流値
げんりじょう	原理上
げんりしゅぎ	原理主義
げんりいがい	原理以外
げんようたい	原葉体
げんゆかかく	原油価格
げんゆうひん	現有品
げんやくいん	現役員
げんめつぎみ	幻滅気味
げんむせんき	幻夢戦記
げんみつせい	厳密性
げんみつかい	厳密解
げんまいちゃ	玄米茶
げんぶんそう	弦分奏
げんふうけい	原風景
げんひょうひ	原表皮
げんぱつじこ	原発事故
げんぱつきき	原発危機
げんぱつおき	原発沖
げんばふっき	現場復帰
げんばふきん	現場付近
げんばしゅぎ	現場主義
げんばしきぶ	現場指揮部
げんはんけつ	原判決
げんにほんご	源日本語	現日本語
げんとうしゅ	現当主
げんてんばん	原典版
げんてんのう	現天皇
げんてんすう	減点数
げんていひん	限定品
げんていばん	限定版	限定盤
げんていてき	限定的
げんていつき	限定付
げんていしゅ	限定酒
げんていしゃ	限定車
げんつきしゃ	原付車
げんちょしょ	原著書
げんちょしゃ	原著者
げんちてはい	現地手配
げんちつうか	現地通貨
げんちせいふ	現地政府
げんちじかん	現地時間
げんちかかく	現地価格
げんだんかい	現段階
げんだいわか	現代和歌
げんだいよみ	現代読み
げんだいもの	現代物
げんだいめい	原題名
げんだいへん	現代編
げんだいぶん	現代文
げんだいふう	現代風
げんだいばん	現代版
げんだいてき	現代的
げんだいせん	現代戦
げんだいじん	現代人
げんだいげき	現代劇
げんだいかな	現代仮名
げんたいせい	現体制
げんたいけん	原体験
げんたいいん	現隊員
げんぞうよう	現像用
げんぞうしょ	現像所
げんぞうえき	現像液
げんそくろん	原則論
げんそくまえ	減速前
げんそくてき	原則的
げんそくざい	減速剤	減速材
げんそくがわ	減速側
げんそきごう	元素記号
げんそうてき	幻想的
げんせりやく	現世利益
げんせいりん	原生林
げんせいひん	現製品
げんせいだい	原生代
げんせいしぶ	原生篩部
げんせいけん	現政権
げんすんだい	原寸大
げんすいりつ	減衰率
げんすいばく	原水爆
げんじゅうち	現住地
げんじつろん	現実論
げんじつばな	現実離
げんじつてき	現実的
げんじつせい	現実性
げんじつかん	現実感
げんじつかい	現実界
げんじつおん	現実音
げんじっかい	現実解
げんじそくど	現示速度
げんしんごう	原信号	元信号
げんしりょく	原子力
げんしりょう	原資料	原子量
げんしょばん	原書版
げんしゃほう	現写法
げんしゃかい	現社会
げんしみつど	原子密度
げんしぶんし	原子分子
げんしびょう	原子病
げんしどけい	原子時計
げんしじだい	原史時代	原始時代
げんしげんご	原始言語
げんしきごう	原子記号
げんざぶろう	源三郎
げんざいやく	現在約
げんざいまで	現在迄
げんざいほう	現在法
げんざいだか	現在高
げんざいけい	現在形
げんざいいち	現在位置
げんさくぼん	原作本
げんさくひん	原作品
げんさくどお	原作通
げんさくしゃ	原作者
げんさいぼう	原細胞
げんさいばん	原裁判
げんごりろん	言語理論
げんごりかい	言語理解
げんごへんか	言語変化
げんごぶんか	言語文化
げんごていぎ	言語定義
げんごちしき	言語知識
げんごせかい	言語世界
げんごじょう	言語上
げんごじたい	言語自体
げんごしよう	言語仕様	言語使用
げんごしょり	言語処理
げんごこうざ	言語講座
げんごげーむ	言語ゲーム
げんごきはん	言語規範
げんごきのう	言語機能
げんごきこう	言語機構
げんごかてい	言語過程
げんごいぞん	言語依存
げんこんたん	原根端
げんこくだん	原告団
げんこくがわ	原告側
げんこうろく	言行録
げんこうよう	原稿用
げんこうめい	原稿名
げんこうほう	現行法
げんこうひん	現行品
げんこうばん	現行版
げんこうはん	現行犯
げんこうしゃ	玄光社
げんこうけい	原光景
げんこうがた	現行型
げんけんぽう	現憲法
げんけいしつ	原形質
げんけいかく	現計画
げんくうこう	現空港
げんきじるし	元気印
げんがしゅう	原画集
げんがくてき	衒学的
げんかんまえ	玄関前
げんかんばん	玄関番
げんかんとく	現監督
げんかんすう	原関数
げんかんさき	玄関先
げんかんぐち	玄関口
げんかんきん	現換金
げんかくざい	幻覚剤
げんかいなだ	玄海灘	玄界灘
げんかいない	限界内
げんかいしき	原価意識
げんかいいん	現会員
げんおんせい	原音声
げんいちろう	源一郎
げろおんせん	下呂温泉
げるまにうむ	Germanium	Ge
げつれいかい	月例会
げつようよる	月曜夜
げつようごご	月曜午後
げつめんとし	月面都市
げつまつじつ	月末日
げっすいきん	月水金
げっしょくじ	月食時
げっけいじゅ	月桂樹
げっけいかん	月桂冠
げっかびじん	月下美人
げすいしょり	下水処理
げすいこうじ	下水工事
げじゅんへん	下旬編
げじゅんぶん	下旬分
げしゅくにん	下宿人
げしゅくせい	下宿生
げしゅくさき	下宿先
げこくじょう	下剋上
げこうちゅう	下校中
げきやすてん	激安店
げきついすう	撃墜数
げきついおう	撃墜王
げきちゅうか	劇中歌
げきだんしき	劇団四季
げきだんいん	劇団員
げきたいほう	撃退法
げきじょうか	激情家
げきくうかん	劇空間
げかぎじゅつ	外科技術
げいひんかん	迎賓館
げいのうめん	芸能面
げいのうじん	芸能人
げいのうかい	芸能界
げいたっしゃ	芸達者
げいたいかい	芸大会
げいじゅつし	芸術誌
げいじゅつか	芸術家
げいしゃやく	芸者役
げいこうだい	芸工大
げーむりろん	ゲーム理論
げーむちゅう	ゲーム中
ぐんようしゃ	軍用車
ぐんようけん	軍用犬
ぐんようきん	軍用金
ぐんめいれい	軍命令
ぐんまちょう	群馬町
ぐんていすう	群定数
ぐんたいしき	軍隊式
ぐんそうどの	軍曹殿
ぐんぜんたい	群全体
ぐんじりょく	軍事力
ぐんじゅひん	軍需品
ぐんじそしき	軍事組織
ぐんじしせつ	軍事施設
ぐんじこっか	軍事国家
ぐんじきみつ	軍事機密
ぐんじかがく	軍事科学
ぐんしれいぶ	軍司令部
ぐんがくたい	軍楽隊
ぐんかんまき	軍艦巻き	軍艦巻
ぐんかんけい	軍関係
ぐろーばるか	グローバル化
ぐるーぷめい	グループ名
ぐりーんしゃ	グリーン車
ぐもんぐとう	愚問愚答
ぐびじんそう	虞美人草
ぐねつむこう	グネツム綱
ぐしょうてき	具象的
ぐしょうこう	具象項
ぐうゆうせい	偶有性
ぐうはつてき	偶発的
ぐうているい	偶蹄類
ぐうていもく	偶蹄目
ぐうぜんてき	偶然的
ぐうぜんせい	偶然性
ぐうすうほん	偶数本
ぐうすうづき	偶数月
ぐうすうけた	偶数桁
ぐうすうかい	偶数回
ぐうかんすう	偶関数
ぎんもくせい	銀木犀
ぎんしょっき	銀食器
ぎんざまつや	銀座松屋
ぎんざどおり	銀座通
ぎんこんしき	銀婚式
ぎんこうめい	銀行名
ぎんこうほう	銀行法
ぎんこうけん	銀行券
ぎんこうけい	銀行系
ぎんこうがわ	銀行側
ぎんこうかん	銀交換	銀行間
ぎんこうかぶ	銀行株
ぎんこうかい	銀行界
ぎんこういん	銀行印	銀行員
ぎんがぶんぷ	銀河分布
ぎんえいでん	銀英伝
ぎんいろしゃ	銀色車
ぎんいちろう	銀一郎
ぎろんほうき	議論放棄
ぎろんぶそく	議論不足
ぎろんちゅう	議論中
ぎろんけっか	議論結果
ぎろんいぜん	議論以前
ぎりしゃもじ	ギリシャ文字
ぎょらいてい	魚雷艇
ぎょしゃだい	御者台
ぎょこうない	漁港内
ぎょくりんじ	玉林寺
ぎょくしょう	玉漿	玉将
ぎょかいるい	魚介類
ぎょうれつち	行列値
ぎょうむよう	業務用
ぎょうはんい	行範囲
ぎょうちゅう	蟯虫	行中
ぎょうちゃく	凝着
ぎょうたんい	行単位
ぎょうぜんご	行前後
ぎょうせいふ	行政府
ぎょうせいく	行政区
ぎょうじょう	行上	行状
ぎょうしょう	行商	驍将
ぎょうしゅく	凝縮
ぎょうしゅう	凝聚	凝集
ぎょうしてん	凝視点
ぎょうしてい	行指定
ぎょうこてん	凝固点
ぎょうくぎり	行区切り
ぎょうぎょう	仰仰	仰々
ぎょうきょう	業況
ぎょうかいし	業界誌	業界紙
ぎょういこう	行以降
ぎゅうにゅう	牛乳
ぎゅうどんや	牛丼屋
ぎゅうたんや	牛タン屋
ぎゃっこうじ	逆光時
ぎゃっきょう	逆境
ぎゃくりよう	逆利用
ぎゃくりゅう	逆流
ぎゃくもどり	逆戻り
ぎゃくひれい	逆比例
ぎゃくでんぱ	逆伝播
ぎゃくてまえ	逆手前
ぎゃくたんち	逆探知
ぎゃくそうだ	逆操舵
ぎゃくせがわ	逆瀬川
ぎゃくじょう	逆上
ぎゃくじゅん	逆順
ぎゃくじせい	逆磁性
ぎゃくしゅう	逆襲
ぎゃくしめい	逆指名
ぎゃくしべん	逆止弁
ぎゃくさよう	逆作用
ぎゃくさべつ	逆差別
ぎゃくこうか	逆効果
ぎゃくがわせ	逆為替
ぎゃくかのう	逆可能
ぎゃくいぞん	逆依存
ぎゃくいそう	逆位相
ぎもんていき	疑問提起
ぎふほうそう	岐阜放送
ぎふだいがく	岐阜大学
ぎふこうせん	岐阜高専
ぎふこうこう	岐阜高校
ぎのうしょく	技能職
ぎのうしょう	技能賞
ぎっくりごし	ぎっくり腰
ぎちょうやく	議長役
ぎちょうてき	議長的
ぎだゆうぼん	義太夫本
ぎだいていき	議題提起
ぎせいしほん	擬制資本
ぎじらんすう	疑似乱数
ぎじょうへい	儀杖兵
ぎじゅんじょ	擬順序
ぎじゅつろん	技術論
ぎじゅつらん	技術欄
ぎじゅつよう	技術用
ぎじゅつめん	技術面
ぎじゅつむけ	技術向け
ぎじゅつてん	技術展
ぎじゅつてき	技術的
ぎじゅつせん	技術戦	技術選
ぎじゅつじん	技術陣
ぎじゅつしょ	技術書
ぎじゅつしゃ	技術社	技術者
ぎじゅつしつ	技術室
ぎじゅつけい	技術系
ぎじゅつがく	技術学
ぎじゅつかん	技術館
ぎじゅついん	技術院
ぎじゅついじ	技術維持
ぎじめいれい	疑似命令
ぎじへんすう	疑似変数	擬似変数
ぎじぶっしつ	疑似物質
ぎじたいけん	疑似体験
ぎじせいめい	疑似生命
ぎじじんかく	疑似人格
ぎじけいけん	疑似経験
ぎじかいせつ	疑似解説
ぎじおやゆび	疑似親指
ぎじいんよう	擬似引用
ぎしんあんき	疑心暗鬼
ぎしょうだに	棋将谷
ぎしょうざい	偽証罪
ぎしぶちょう	技師部長
ぎけつきかん	議決機関
ぎきょうだい	義兄弟
ぎきょうしん	義侠心
ぎおんまつり	祇園祭
ぎおんばやし	祇園囃子
ぎおんどうふ	祇園豆腐
ぎおんちょう	祇園町
ぎいんきそく	議院規則
がんよくせい	癌抑制
がんゆうりつ	含有率
がんみつとう	含蜜糖
がんねんしき	元年式
がんとくせん	岩徳線
がんちりょう	癌治療
がんせきがく	岩石学
がんじつよう	元日用
がんしぼうゆ	含脂肪油
がんさいぼう	癌細胞
がんこくもじ	岩刻文字
がんけんせい	頑健性
がんけんしん	癌検診
がんぐうりば	玩具売場
がんくつおう	巌窟王
がんいりょう	癌医療
がろうきっさ	画廊喫茶
がめんてまえ	画面手前
がめんちゅう	画面中
がめんじょう	画面上
がめんかだん	画面下段
がにゅうどう	我入道
がどりにうむ	Gd	Gadolinium
がっぺいごう	合併号
がったいわざ	合体技
がったいよう	合体用
がったいまえ	合体前
がっそうだん	合奏団
がっしょうぶ	合唱部
がっこうれい	学校令
がっこうめい	学校名
がっこうない	学校内
がっこうじむ	学校事務
がっこうしき	学校式
がっこうさい	学校祭
がっこうぐん	学校群
がっこうがわ	学校側
がっこうがえ	学校帰
がっこうがい	学校外
がっけんとし	学研都市
がっきゅうき	学休期
がっきこゆう	楽器固有
がっきいがい	楽器以外
がっかどくじ	学科独自
がっかちょう	学科長
がっかしけん	学科試験
がっかいめい	学会名
がっかいまえ	学会前
がっかいなど	学会等
がっかいじき	学会時期
がっかいいん	学会員
がぞうりかい	画像理解
がぞうじょう	画像上
がぞうしょり	画像処理
がぞういがい	画像以外
がそりんぜい	ガソリン税
がそりんしゃ	ガソリン車
がそけいれつ	画素系列
がじんかって	我侭勝手
がしつれっか	画質劣化
がしつひかく	画質比較
がさくちゅう	画策中
がくりょうい	学寮委
がくようひん	学用品
がくゆうかい	学友会
がくもんめん	学問面
がくもんてき	学問的
がくもんじょ	学問所
がくもんかん	学問観
がくめんわれ	額面割れ
がくめんてき	額面的
がくぶちょう	学部長
がくぶじだい	学部時代
がくふじょう	楽譜上
がくふしゅう	楽譜集
がくふきごう	楽譜記号
がくふうりば	楽譜売場
がくねんまつ	学年末
がくねんてき	学年的
がくないびん	学内便
がくないせん	学内線
がくないがい	学内外
がくせいよう	学生用
がくせいむき	学生向
がくせいふく	学生服
がくせいふう	学生風
がくせいたち	学生達
がくせいすう	学生数
がくせいしつ	学生室
がくせいしき	学生指揮
がくせいけん	学生券
がくせいがわ	学生側
がくせいかん	学生間
がくせいかい	学生会
がくせいいん	学生員
がくじゅつし	学術誌
がくしゅうじ	学習時
がくしゅうご	学習後
がくしゃはだ	学者肌
がくしゃない	学者内
がくしゃたち	学者達
がくしゃけい	学者系
がくしほけん	学資保険
がくさいてき	学際的
がくげいだい	学芸大
がくげいかい	学芸会
がくげいいん	学芸員
がくがいしゃ	学外者
がくかんせつ	顎関節
がくえんもの	学園物
がくえんまえ	学園前
がくえんとし	学園都市
がくえんさい	学園祭
がくいんない	学院内
がくいんだい	学院大
がくいしんさ	学位審査
がぎじょうぶ	鉤状部
がいわくせい	外惑星
がいりんざん	外輪山
がいりゃくず	概略図
がいらいよう	外来用
がいらいてき	外来的
がいらいしゅ	外来種
がいらいぎょ	外来魚
がいようやく	外用薬
がいようしょ	概要書
がいようがわ	外洋側
がいめんてき	外面的
がいめんせい	外面性
がいむじかん	外務次官
がいむしょう	外務省
がいへきあつ	外壁厚
がいぶんぴつ	外分泌
がいぶどうき	外部同期
がいぶたんし	外部端子
がいぶそしき	外部組織
がいぶそうち	外部装置
がいぶせかい	外部世界
がいぶしよう	外部仕様
がいぶこうか	外部効果
がいぶきかん	外部機関
がいぶきおく	外部記憶
がいぶかんさ	外部監査
がいふうしゃ	凱風社
がいはんぼし	外反拇指	外反母趾	外反拇趾
がいはいよう	外胚葉
がいねんてき	概念的
がいとうすう	該当数
がいとうしゃ	該当車	該当者
がいとうきじ	該当記事
がいでんてき	外伝的
がいためほう	外為法
がいぜんてき	蓋然的
がいぜんせい	蓋然性
がいせんよう	外線用
がいせんもん	凱旋門
がいせんしゃ	街宣車
がいせつほう	外接法
がいせつしょ	概説書
がいせつえん	外接円
がいじんわく	外人枠
がいじんぼち	外人墓地
がいじんぜい	外人勢
がいじんぐみ	外人組
がいじんえら	外人選
がいじつせい	概日性
がいしょくや	外食屋
がいしょうぶ	外商部
がいしゅつじ	外出時
がいしゅつぎ	外出着
がいしゅうぶ	外周部
がいしゅうき	概周期
がいざいてき	外在的
がいざいせい	外在性
がいこっかく	外骨格
がいこくもの	外国物
がいこくぼん	外国本
がいこくほう	外国法
がいこくぶつ	外国物
がいこくぜい	外国勢
がいこくせん	外国船
がいこくせき	外国籍
がいこくせい	外国製
がいこくじん	外国人
がいこくざい	外国材
がいこくさん	外国産
がいこくさい	外国債
がいこくけい	外国系
がいこくがた	外国型
がいこくかぶ	外国株
がいこきゅう	外呼吸
がいこうるい	外肛類
がいこうてき	外交的	外向的
がいこうせん	外航船
がいこうせい	外向性
がいこうかん	外交官
がいこういん	外交員
がいげんけい	外原型
がいけんてき	外見的
がいけいてき	外形的
がいけいたい	外形態
がいくうかん	外空間
がいきんこん	外菌根
がいかんてき	概観的
がいかんざい	外患罪
がいかよきん	外貨預金
がいかつてき	概括的
がいえんまえ	外苑前
がいえんてき	外延的
がいえんせい	外延性
がいうちゅう	外宇宙
ごんどうくじら	巨頭鯨
ごんごどうだん	言語道斷	言語道断
ごんぐじょうど	欣求浄土
ごれんらくねが	御連絡願
ごりんかいさい	五輪開催
ごりょうしょう	ご了承	御了承
ごりかいいただ	御理解頂
ごらくばんぐみ	娯楽番組
ごらくたいさく	娯楽大作
ごらくしゅっし	娯楽出資
ごらくさくひん	娯楽作品
ごようしゃくだ	御容赦下
ごようけんせつ	五洋建設
ごようがくしゃ	御用学者
ごやくせいしょ	語訳聖書
ごもくぞうすい	五目雑炊
ごもくぎょうざ	五目餃子
ごめんこうむる	蒙御免
ごむしょくぶつ	ゴム植物
ごむこうぎょう	ゴム工業
ごまふあざらし	胡麻斑海豹
ごまのはぐさか	ゴマノハグサ科	Scrophulariaceae
ごましおあたま	胡麻塩頭
ごふうじゅうう	五風十雨
ごひゃくらかん	五百羅漢
ごばんしょうぶ	五番勝負
ごにゅうりょく	誤入力
ごにゅうじょう	御入場
ごならてんのう	後奈良天皇
ごとばてんのう	後鳥羽天皇
ごとうれっとう	五島列島
ごてひっしょう	後手必勝
ごつごうしゅぎ	御都合主義
ごちゅういくだ	御注意下
ごだんかつよう	五段活用
ごたようちゅう	ご多用中	御多用中
ごたぼうちゅう	御多忙中
ごたいまんぞく	五体満足
ごそうぼうえい	誤想防衛
ごそうせんだん	護送船団
ごぜんげんざい	午前現在
ごせんえんさつ	五千円札
ごせいようじょ	互生葉序
ごすうせいげん	語数制限
ごじょくあくせ	五濁悪世
ごじょうしゃこ	五条車庫
ごじゅうのとう	五重塔
ごじゅうしょう	五重唱
ごじゅうおんず	五十音図
ごじぶんりゅう	御自分流
ごじだつじなど	誤字脱字等
ごじだつじとう	誤字脱字等
ごしょらくがん	御所落雁
ごしょうだいじ	後生大事
ごしゅきょうぎ	五種競技
ごしゅいんせん	御朱印船
ごしつもんなど	御質問等
ごさひょうめん	誤差表面
ごさでんぱがた	誤差伝播型
ごさじょうほう	誤差情報
ごさがてんのう	後嵯峨天皇
ごさかいせきや	誤差解析屋
ごさいてんのう	後西天皇
ごごはんきゅう	午後半休
ごごうめひろば	五合目広場
ごこくかいかん	護国会館
ごけんれんごう	護憲連合
ごけいかんぜい	互恵関税
ごくらくとんぼ	極楽蜻蛉
ごくらくちょう	極楽鳥
ごくひじっけん	極秘実験
ごくていそくじ	極低速時
ごくじょうひん	極上品
ごくしょうすう	極小数	極少数
ごくあくひどう	極悪非道
ごきょうりょく	御協力	ご協力
ごきょうじねが	御教示願
ごきょうじくだ	御教示下
ごきげんななめ	ご機嫌斜め	御機嫌斜め
ごがくくんれん	語学訓練
ごがくがっこう	語学学校
ごかんきじょう	互換機上
ごかつようくだ	御活用下
ごかくにんくだ	御確認下
ごかくいじょう	互格以上
ごおんじょうく	五陰盛苦
ごえんりょくだ	御遠慮下
ごえいこうどう	護衛行動
ごうれいいっか	号令一下
ごうりゅうへん	合流編
ごうりゅうてん	合流点
ごうりゅうせい	合流性
ごうりてきいみ	合理的意味
ごうべんかるい	Sympetalae	Gamopetalae	合弁花類
ごうひはんてい	合否判定
ごうどうかいぎ	合同会議
ごうだてんのう	後宇多天皇
ごうそっきゅう	剛速球
ごうせつちたい	豪雪地帯
ごうせつちいき	豪雪地域
ごうせいりょく	合成力
ごうせいぶそく	剛性不足
ごうせいそうち	合成装置
ごうせいせんい	合成繊維
ごうせいじゅし	合成樹脂
ごうせいかがく	合成化学
ごうじょっぱり	強情っ張り
ごうしゅうさん	豪州産
ごうしがいしゃ	合資会社
ごうけいじかん	合計時間
ごうがんふそん	傲岸不遜
ごうかんじけん	強姦事件
ごうかれっしゃ	豪華列車
ごうかけんらん	豪華絢爛
ごうかくりょく	合格力
ごうかくつうち	合格通知
ごうかくしょう	合格証
ごういほうほう	合意方法
ごういほうしき	合意方式
ごういぶんしょ	合意文書
ごういないよう	合意内容
ごういてつづき	合意手続	合意手続き
ごういしゅだん	合意手段
ごういけいせい	合意形成
ごいのくろうど	五位の蔵人
ごいっぽうねが	御一報願
ごいっぽうくだ	御一報下
ごいっとうさま	御一統様
ごいっこうさま	御一行様
ごいちどくくだ	御一読下
ごいちどうさま	御一同様
ごいちごじけん	五
ごいけんむよう	御意見無用
ごあんないもう	御案内申
ごあんしんくだ	御安心下
げんろんじゆう	言論自由
げんりゅうすい	源流水
げんりすいさつ	原理推察
げんりげんそく	原理原則
げんようへいき	現用兵器
げんゆうせつび	現有設備
げんめいがっき	弦鳴楽器
げんみつかがく	厳密科学
げんまたいせん	幻魔大戦
げんまいしょく	玄米食
げんぶんいっち	言文一致
げんぴんかこう	現品加工
げんばくどーむ	原爆ドーム
げんばくとうか	原爆投下
げんばくしょう	原爆症
げんばかんとく	現場監督
げんどうりょく	源動力	原動力
げんどうきつき	原動機付
げんとうきよう	厳冬期用
げんてんしゅぎ	原典主義
げんていてんぽ	限定店舗
げんていしょく	限定色
げんつきにしゅ	原付二種
げんちろくおん	現地録音
げんちほうじん	現地法人
げんちちょうさ	現地調査
げんちせいさん	現地生産
げんちしゅざい	現地取材
げんちしゅさい	現地主催
げんちしじょう	現地試乗
げんだいようご	現代用語
げんだいぶつり	現代物理
げんだいびょう	現代病
げんだいひょう	現代表
げんだいしそう	現代思想
げんだいごやく	現代誤訳	現代語訳
げんだいこくご	現代国語
げんだいきょく	現代曲
げんだいがっき	現代楽器
げんだいかがく	現代科学	現代化学
げんだいえいご	現代英語
げんぞんぶぶん	現存部分
げんぞうじかん	現像時間
げんぞうしょり	現像処理
げんぞうおんど	現像温度
げんそくりょく	減速力
げんそくちゅう	減速中
げんそうきょく	幻想曲
げんぜいこうか	減税効果
げんせんぶんり	源泉分離
げんせんかぜい	源泉課税
げんせいもくぶ	原生木部
げんせいかえん	原生花園
げんすいりょく	減衰力
げんすいりょう	減衰量
げんすいじかん	減衰時間
げんすいじかい	減衰磁界
げんすいけいど	減衰傾度
げんじょうたい	現状態
げんじょういじ	現状維持
げんじゅうろう	幻十郎
げんじゅうみん	原住民
げんじゅうしょ	現住所
げんじゅうきょ	現住居
げんじゅうかい	幻獣界
げんじぼうけい	源氏傍系
げんじつろせん	現実路線
げんじつとうひ	現実逃避
げんじつせかい	現実世界
げんじつしゅぎ	現実主義
げんしょくばん	原色版
げんしょうろん	現象論
げんしょうりつ	減少率
げんしょうめん	現象面
げんしょうぶん	減少分
げんしょうてき	現象的
げんしょうがく	現象学
げんしゅしょう	現首相
げんしゃちょう	現社長
げんしほうかい	原子崩壊
げんしぶやえき	現渋谷駅
げんしばんごう	原子番号
げんしばくだん	原子爆弾
げんしはんけい	原子半径
げんしていこう	原子定項
げんしかんすう	原始関数
げんしかくがく	原子核学
げんざんそうさ	減算操作
げんざんけっか	減算結果
げんざんかいろ	減算回路
げんざいりょう	原材料
げんざいぶんし	現在分詞
げんざいふつう	現在不通
げんざいてもと	現在手元
げんざいせこう	現在施行
げんざいじこく	現在時刻
げんざいしよう	現在使用
げんざいしこう	現在施行
げんざいぎろん	現在議論
げんざいぎょう	現在行
げんさくまんが	原作漫画
げんさくちゅう	原作中
げんさいききん	減債基金
げんごろうまる	源五郎丸
げんごもんだい	言語問題
げんごぶんせき	言語分析
げんごはったつ	言語発達
げんごてつがく	言語哲学
げんごたいけい	言語体系
げんごぜんぱん	言語全般
げんごぜんたい	言語全体
げんごせんよう	言語専用
げんごせっけい	言語設計
げんごせいせい	言語生成
げんごせいかつ	言語生活
げんごじっけん	言語実験
げんごこうどう	言語行動
げんごこうぞう	言語構造
げんごけいせい	言語形成
げんごくうかん	言語空間
げんごきじゅつ	言語記述
げんごがくてき	言語学的
げんごがくしゃ	言語学者
げんごがいねん	言語概念
げんごかんかく	言語感覚
げんごかつどう	言語活動
げんごかくとく	言語獲得
げんごかかのう	言語化可能
げんごかいせき	言語解析
げんごうんよう	言語運用
げんこうりょう	原稿料
げんこうようし	原稿用紙
げんこうほうき	現行法規
げんこうほうか	現行法下
げんこうきしゅ	現行機種
げんこういらい	原稿依頼
げんこういっち	言行一致
げんきんよきん	現金預金
げんきんばらい	現金払
げんきんとうし	現金投資
げんきんいがい	現金以外
げんきょくせい	限局性
げんきいっぱい	元気一杯
げんがっきょく	弦楽曲
げんがっきぐん	弦楽器群
げんかんりにん	現管理人
げんかんばらい	玄関払い
げんかけいさん	原価計算
げんかくしゅぎ	厳格主義
げんかいひよう	限界費用
げんかいちいか	限界値以下
げんかいそくど	限界速度
げんかいこうど	限界高度
げんかいかかく	限界価格
げんおんじょう	原音場
げんおんしゅぎ	原音主義
げんえんしょく	減塩食
げんえきふっき	現役復帰
げんえきじだい	現役時代
げんえきさいた	現役最多
げんえきさいご	現役最後
げんえいきゃく	幻影脚
げんいんふめい	原因不明
げんいんしだい	原因次第
げんあんどおり	原案通り
げんあつていし	減圧停止
げんあつしょう	減圧症
げつようびごろ	月曜日頃
げつよういこう	月曜以降
げつめんじょう	月面上
げつまつしょり	月末処理
げっちょうせき	月長石
げっしゅつたい	月出帯
げっこうちゅう	月光蟲
げっこうかめん	月光仮面
げっきゅうせい	月給制
げっかんげんご	月刊言語
げっかんあさひ	月刊朝日
げだんこうげき	下段攻撃
げきひょうらん	劇評欄
げきてきこうか	劇的効果
げきちゅうげき	劇中劇
げきじょうよう	劇場用
げきじょうばん	劇場版
げきじょうない	劇場内
げきじょうがい	劇場街
げかびょうとう	外科病棟
げいのうきょく	芸能局
げいじゅつろん	芸術論
げいじゅつひん	芸術品
げいじゅつてき	芸術的
げいじゅつせい	芸術性
げいじゅつさい	芸術祭
げいじゅついん	芸術院
げいげききのう	迎撃機能
ぐんりゅうせい	群流星
ぐんまだいがく	群馬大学
ぐんまけんじん	群馬県人
ぐんぽうかいぎ	軍法会議
ぐんびかくだい	軍備拡大
ぐんぱつじしん	群発地震
ぐんちゅうおう	軍中央
ぐんだんちょう	軍団長
ぐんたいはけん	軍隊派遣
ぐんじょういろ	群青色
ぐんじもんだい	軍事問題
ぐんじもくてき	軍事目的
ぐんじほうてい	軍事法廷
ぐんじどうめい	軍事同盟
ぐんじたいこく	軍事大国
ぐんじせいけん	軍事政権
ぐんじこうどう	軍事行動
ぐんじかんけい	軍事関係
ぐんじえんじょ	軍事援助
ぐんしれいかん	軍司令官
ぐんこくしゅぎ	軍国主義
ぐらみーしょう	グラミー賞
ぐみんせいさく	愚民政策
ぐのこっちょう	愚の骨頂
ぐたいてきれい	具体的例
ぐたいこうどう	具体行動
ぐうはつさいむ	偶発債務
ぐうすうぺーじ	偶数頁
ぐうすうびょう	偶数秒
ぎんゆうしじん	吟遊詩人
ぎんぷんちょう	銀粉蝶
ぎんはくしょく	銀白色
ぎんずいしょう	銀水晶
ぎんすいしょう	銀水晶
ぎんじょうしゅ	吟醸酒
ぎんざみつこし	銀座三越
ぎんざほうめん	銀座方面
ぎんこうよきん	銀行預金
ぎんこうこうざ	銀行口座
ぎんがてつどう	銀河鉄道
ぎんがていこく	銀河帝国
ぎんがつうしん	銀河通信
ぎんがざひょう	銀河座標
ぎんがけいない	銀河系内
ぎんがえんばん	銀河円盤
ぎんがうちゅう	銀河宇宙
ぎんかくじみち	銀閣寺道
ぎんかいしょく	銀灰色
ぎろんとうけつ	議論凍結
ぎろんぜんたい	議論全体
ぎりょうぶそく	技量不足
ぎりにんじょう	義理人情
ぎりしゃしんわ	ギリシャ神話
ぎよこぶんれつ	偽横分裂
ぎょめいぎょじ	御名御璽
ぎょくもんかん	玉門関
ぎょくせんどう	玉泉洞
ぎょぎょうほう	漁業法
ぎょぎょうけん	漁業権
ぎょかくりょう	漁獲量
ぎょうれつせき	行列積
ぎょうれつしき	行列式
ぎょうれつがた	行列型
ぎょうむはんい	業務範囲
ぎょうむていし	業務停止
ぎょうむちゅう	業務中
ぎょうむじょう	業務上
ぎょうむじかん	業務時間
ぎょうむさべつ	業務差別
ぎょうまつもじ	行末文字
ぎょうほうこう	行方向
ぎょうぶんかつ	行分割
ぎょうばんごう	行番号
ぎょうにんべん	行人偏
ぎょうとくえき	行徳駅
ぎょうせんとう	行先頭
ぎょうせきしょ	業績書
ぎょうせいめん	行政面
ぎょうせいほう	行政法
ぎょうせいばつ	行政罰
ぎょうせいちく	行政地区
ぎょうせいじむ	行政事務
ぎょうせいけん	行政権
ぎょうせいがわ	行政側
ぎょうせいがく	行政学
ぎょうせいかん	行政官
ぎょうせいいん	行政院
ぎょうじよてい	行事予定
ぎょうしょたい	行書体
ぎょうしゅくど	凝縮度
ぎょうしゃめい	業者名
ぎょうしゃかん	業者間
ぎょうさくじょ	行削除
ぎょうけつすい	凝結水
ぎょうかんかく	行間隔
ぎょうかいはつ	業界初
ぎょうかいない	業界内
ぎょうかいすじ	業界筋
ぎょうかいじん	業界人
ぎょうかいがん	凝灰岩
ぎょうかいがわ	業界側
ぎょうかいうら	業界裏
ぎゅうにゅうや	牛乳屋
ぎゅうにくせつ	牛肉説
ぎゅうしんてい	牛心亭
ぎゃくゆにゅう	逆輸入
ぎゃくもんだい	逆問題
ぎゃくほうこう	逆方向
ぎゃくへんかん	逆変換
ぎゃくへいほう	逆平方
ぎゃくふんしゃ	逆噴射
ぎゃくふぃるた	逆フィルタ
ぎゃくはんのう	逆反応
ぎゃくとくせい	逆特性
ぎゃくでんぱん	逆伝搬
ぎゃくでんあつ	逆電圧
ぎゃくてんまけ	逆転負
ぎゃくてんそう	逆転送	逆転層
ぎゃくてんげき	逆転劇
ぎゃくてんがち	逆転勝ち
ぎゃくてんおう	逆転王
ぎゃくそうかん	逆相関
ぎゃくせんでん	逆宣伝
ぎゃくせつてき	逆説的
ぎゃくせいせつ	逆正接
ぎゃくすうがく	逆数学
ぎゃくすいへい	逆水平
ぎゃくじゅうじ	逆十字
ぎゃくじきょく	逆磁極
ぎゃくしんとう	逆浸透
ぎゃくしんぜい	逆進税
ぎゃくしゃぞう	逆写像
ぎゃくしゃせん	逆車線
ぎゃくさんかく	逆三角
ぎゃくさつすう	虐殺数
ぎゃくさいせい	逆再生
ぎゃくこうせん	逆光線
ぎゃくかんすう	逆関数
ぎゃくかくさん	逆拡散
ぎゃくかいてん	逆回転
ぎゃくえんすい	逆円錐
ぎゃくえんざん	逆演算
ぎむきょういく	義務教育
ぎふはしまえき	岐阜羽島駅
ぎふながらがわ	岐阜長良川
ぎちょうせいど	議長制度
ぎちょうしめい	議長指名
ぎぞうこうさく	偽造工作
ぎそうけっこん	偽装結婚
ぎそうけいかく	偽装計画
ぎそうぎじゅつ	擬装技術
ぎせきはいぶん	議席配分
ぎじろくちゅう	議事録中
ぎじゅつりょく	技術力
ぎじゅつりょう	技術料
ぎじゅつようそ	技術要素
ぎじゅつようご	技術用語
ぎじゅつほんぶ	技術本部
ぎじゅつほぞん	技術保存
ぎじゅつぶもん	技術部門
ぎじゅつぶそく	技術不足
ぎじゅつばたけ	技術畑
ぎじゅつちょう	技術長	技術庁
ぎじゅつちしき	技術知識
ぎじゅつじょう	技術上
ぎじゅつしょく	技術職	技術色
ぎじゅつしどう	技術指導
ぎじゅつしえん	技術支援
ぎじゅつきばん	技術基盤
ぎじゅつがかり	技術係
ぎじゅつかてい	技術家庭
ぎじゅついてん	技術移転
ぎじゅついいん	技術委員
ぎじほっきにん	擬似発起人
ぎじかがくしょ	疑似科学書
ぎじかがくしゃ	疑似科学者
ぎしわじんでん	魏志倭人伝
ぎこてんしゅぎ	擬古典主義
ぎけんこうかい	技研公開
ぎいんりっぽう	議員立法
ぎいんていすう	議員定数
ぎいんかんれん	議員関連
ぎあんいちらん	議案一覧
がんりゅうじま	厳流島	巌流島
がんゆごうきん	含油合金
がんゆうりょう	含有量
がんめいふれい	頑冥不霊
がんめいころう	頑迷固陋
がんぶつそうし	玩物喪志
がんそてんさい	元祖天才
がんせいひろう	眼精疲労
がんすいたんそ	含水炭素
がんじょうせい	頑丈性
がんしょきぼう	願書希望
がんこいってつ	頑固一徹
がんきょうせい	頑強性
がんきゅうない	眼球内
がんきゅうたん	眼球譚
がろうでんせつ	餓狼伝説
がらくたぶんこ	我楽多文庫
がめんぶんかつ	画面分割
がめんびょうが	画面描画
がめんひょうじ	画面表示
がめんぜんたい	画面全体
がめんせっけい	画面設計
がめんせいぎょ	画面制御
がめんじょうぶ	画面上部
がめんしゃしん	画面写真
がめんさつえい	画面撮影
がめんこうせい	画面構成
がめんこうしん	画面更新
がめんけいしき	画面形式
がめんいっぱい	画面一杯
がでんいんすい	我田引水
がっぺいしょり	合併処理
がっぺいしょう	合併症
がっそうきょく	合奏曲
がっしょうひね	合掌捻
がっしょうづく	合掌造
がっしょうだん	合唱団
がっしゅくじょ	合宿所
がっしゅくさき	合宿先
がっしゅうこく	合衆国
がっさいぶくろ	合切袋
がっこうちょう	学校長
がっこうちゅう	顎口虫
がっこうたんい	学校単位
がっこうせいど	学校制度
がっこうしてい	学校指定
がっこうかんり	学校管理
がっこういがい	学校以外
がっきゅうはだ	学究肌
がっきゅうかい	学級会
がっきほんらい	楽器本来
がっきへんせい	楽器編成
がっきそうしゃ	楽器奏者
がっきえんそう	楽器演奏
がっかめんじょ	学科免除
がっかしょゆう	学科所有
がっかいじょう	学会上
がっかいしょう	学会賞
がっかいしかく	学会資格
がっかいかいひ	学会会費
がぞうひょうじ	画像表示
がぞうにんしき	画像認識
がぞうでんそう	画像伝送
がぞうせいせい	画像生成
がぞうこうがく	画像工学
がぞうけんさく	画像検索
がぞうけいしき	画像形式
がぞうおうよう	画像応用
がすちゅうどく	ガス中毒
がくれきじまん	学歴自慢
がくりょうせん	学寮専
がくゆうかいひ	学友会費
がくもんぶんや	学問分野
がくもんたいど	学問態度
がくもんじょう	学問上
がくめんどおり	額面通り
がくめんじょう	額面上
がくめんかかく	額面価格
がくぶだんかい	学部段階
がくぶたいかい	学部大会
がくぶじむしつ	学部事務室
がくぶがくせい	学部学生
がくふひょうき	楽譜表記
がくふにんしき	楽譜認識
がくひめんじょ	学費免除
がくどうほいく	学童保育
がくどうそかい	学童疎開
がくとどういん	学徒動員
がくちょうしつ	学長室
がくたいようご	楽隊用語
がくせつじょう	学説上
がくせいりょう	学生寮
がくせいぶかい	学生部会
がくせいひとり	学生一人
がくせいなかま	学生仲間
がくせいちゅう	学生中
がくせいずもう	学生相撲
がくせいじだい	学生時代
がくせいじしん	学生自身
がくせいしょう	学生証
がくせいさんか	学生参加
がくせいさいご	学生最後
がくせいきかい	学生棋界
がくせいがかり	学生係
がくせいかばん	学生鞄
がくじょうもう	学情網	学術情報センター網
がくじゅつよう	学術用
がくじゅつてき	学術的
がくじゅつしょ	学術書
がくじゅつけい	学術系
がくしゅうれい	学習例
がくしゅうりつ	学習率
がくしゅうよう	学習用
がくしゅうほう	学習法
がくしゅうはん	学習班
がくしゅうそく	学習則
がくしゅうせつ	学習説
がくしゅうずみ	学習済み
がくしゅうしゃ	学習者
がくしゅうけい	学習系
がくしゅうがた	学習型
がくしゅうかん	学習観
がくしゅうかい	学習会
がくしゅういん	学習院
がくしかいかん	学士会館
がくしいじょう	学士以上
がくさいぶんや	学際分野
がくげいぶんこ	学芸文庫
がくきょうかい	学協会
がくえんさいご	学園祭後
がくいろんぶん	学位論文
がきだいしょう	餓鬼大将
がいりゃくてき	概略的
がいやほうめん	外野方面
がいむだいじん	外務大臣
がいへきじょう	外壁上
がいぶへんすう	外部変数
がいぶひょうか	外部評価
がいぶでんげん	外部電源
がいぶだんたい	外部団体
がいぶぞうせつ	外部増設
がいぶけいしき	外部形式
がいぶけいざい	外部経済
がいぶかんすう	外部関数
がいぶいぶくろ	外部胃袋
がいねんりかい	概念理解
がいねんせかい	概念世界
がいねんじたい	概念自体
がいねんきてい	概念規定
がいねんきかん	外燃機関
がいとうぼきん	街頭募金
がいとうぶぶん	該当部分
がいとうくかん	該当区間
がいとうきしゅ	該当機種
がいとうきかん	該当機関
がいとうかしょ	該当個所
がいちょうどう	外聴道
がいちゅうさき	外注先
がいそうぶひん	外装部品
がいせんしょう	凱旋賞
がいせんきこく	凱旋帰国
がいせいぶんし	外生分枝
がいじんぶたい	外人部隊
がいじんかしゅ	外人歌手
がいじんおんな	外人女
がいじんあいて	外人相手
がいじとうろく	外字登録
がいしゅつよう	外出用
がいしゅつまえ	外出前
がいしゅつさき	外出先
がいしゅっけつ	外出血
がいこくばわく	外国馬枠
がいこくじんか	外国人課
がいこくしほん	外国資本
がいこくさんば	外国産馬
がいこくごやく	外国語訳
がいこくかわせ	外国為替
がいこくえいが	外国映画
がいこうじれい	外交辞令
がいこうじょう	外交上
がいけんじょう	外見上
がいきれいぼう	外気冷房
がいかんどうろ	外環道路
がいかんじょう	外観上
がいかげんきん	外貨現金
がいかくきゅう	外角球
がいえんどおり	外苑通り
ごれんらくいただ	御連絡戴	御連絡頂
ごりんだいひょう	五輪代表
ごらくじだいげき	娯楽時代劇
ごようぶんかじん	御用文化人
ごようしょうにん	御用商人
ごまのはぐさもく	ゴマノハグサ目	Personales
ごふしみてんのう	後伏見天皇
ごひゃくまんごく	五百万石
ごにんじょうほう	誤認情報
ごとうひょうくだ	御投票下
ごてんばほうめん	御殿場方面
ごだいごてんのう	後醍醐天皇
ごぜんはんきゅう	午前半休
ごせんえんぜんご	五千円前後
ごせいこんきねん	御成婚記念
ごすざくてんのう	後朱雀天皇
ごじゅうにんまち	五十人町
ごじゅうさんつぎ	五十三次
ごじゅうおんもじ	五十音文字
ごじゅうおくねん	五十億年
ごじゅうえんだま	五十円玉
ごじっぽひゃっぽ	五十歩百歩
ごしょがわらえき	五所川原駅
ごさんしょうくだ	御参照下
ごさぶんさんほう	誤差分散法
ごさかくさんほう	誤差拡散法
ごこくほうじょう	五穀豊穣
ごくらくじょうど	極楽浄土
ごくひじょうほう	極秘情報
ごくていおんいき	極低音域
ごくしょうりょう	極少量	極小量
ごくあくどうめい	極悪同盟
ごきょうじゅねが	御教授願
ごきょうじゅくだ	御教授下
ごきょうじいただ	御教示頂
ごきげんうかがい	御機嫌伺い
ごかんかのうせい	互換可能性
ごえつどうしゅう	呉越同舟
ごえいへいりょく	護衛兵力
ごえいくちくかん	護衛駆逐艦
ごうりゅうちてん	合流地点
ごうりしゅぎてき	合理主義的
ごうりかはんたい	合理化反対
ごうめいがいしゃ	合名会社
ごうほうらいらく	豪放磊落
ごうべんがいしゃ	合弁会社
ごうどうへんかん	合同変換
ごうどうたいかい	合同大会
ごうどうせいてつ	合同製鐵
ごうどうしゅせい	合同酒精
ごうどうこうえん	合同公演
ごうどうかんそく	合同観測
ごうどうかんけい	合同関係
ごうとうさつじん	強盗殺人
ごうたいうんどう	剛体運動
ごうせいほうしき	合成方式
ごうせいはんのう	合成反応
ごうせいぞくせい	合成属性
ごうせいせんざい	合成洗剤
ごうせいしゃしん	合成写真
ごうせいおんせい	合成音声
ごうしゃばんごう	号車番号
ごうけいほんすう	合計本数
ごうけいとくてん	合計得点
ごうけいてんすう	合計点数
ごうけいきんがく	合計金額
ごうかきゃくせん	豪華客船
ごういたいしょう	合意対象
ごいいかかくてい	五位以下確定
げんろんとうせい	言論統制
げんろんだんあつ	言論弾圧
げんろんせいげん	言論制限
げんりょうきごう	限量記号
げんりしゅぎしゃ	原理主義者
げんりけんきゅう	原理研究
げんやしょうほう	原野商法
げんめいてんのう	元明天皇
げんぺいとうきつ	源平藤橘
げんぶつとりひき	現物取引
げんぶつしゅっし	現物出資
げんぶつしきゅう	現物支給
げんぶつきゅうよ	現物給与
げんぱつもんだい	原発問題
げんぱつはんたい	原発反対
げんぱつけんせつ	原発建設
げんばけんしょう	現場検証
げんどうふいっち	言動不一致
げんてんちょうか	減点超過
げんていゆにゅう	限定輸入
げんていめんきょ	限定免許
げんていはんばい	限定販売
げんていはつばい	限定発売
げんていそうぞく	限定相続
げんていせいさん	限定生産
げんていくうかん	限定空間
げんていかいじょ	限定解除
げんつきめんきょ	原付免許
げんつきいっしゅ	原付一種
げんちょろんぶん	原著論文
げんちょさくぶつ	原著作物
げんちょさくしゃ	原著作者
げんちとうちゃく	現地到着
げんちちょうたつ	現地調達
げんちじょうほう	現地情報
げんちじかんたい	現地時間帯
げんちしゅくはく	現地宿泊
げんちしゅうごう	現地集合
げんちかかりいん	現地係員
げんだいぶんめい	現代文明
げんだいびじゅつ	現代美術
げんだいひょうき	現代表記
げんだいにほんご	現代日本語
げんだいせいかつ	現代生活
げんだいすうがく	現代数学
げんだいしょどう	現代書道
げんだいしょかん	現代書館
げんだいしゃかい	現代社会
げんだいかなづか	現代仮名遣
げんだいおんがく	現代音楽
げんぞうかいすう	現像回数
げんそくむりょう	原則無料
げんそくほうこう	減速方向
げんそくはんだん	減速判断
げんそくしゃせん	減速車線
げんそくきんえん	原則禁煙
げんそくうんどう	減速運動
げんそうぶんがく	幻想文学
げんせいどうぶつ	原生動物
げんせいじんるい	現生人類
げんせいしんりん	原生森林
げんすうぶんれつ	減数分裂
げんすいとくせい	減衰特性
げんすいていすう	減衰定数
げんすいしんどう	減衰振動
げんじょうほぞん	現場保存
げんじょうふっき	現状復帰
げんじょうはあく	現状把握
げんじょうきょう	現状況
げんじょういじは	現状維持派
げんじゅうじてん	幻獣辞典
げんじゅうしょち	現住所地
げんじゃくきょり	減弱距離
げんじものがたり	源氏物語
げんじつもんだい	現実問題
げんじつにんしき	現実認識
げんじつしゃかい	現実社会
げんじつげんそく	現実原則
げんしろんりしき	原始論理式	原子論理式
げんしりょくせん	原子力船
げんしょうりょう	減少量
げんしょうじたい	現象自体
げんしょうしゅぎ	減少主義
げんしょうかてい	減少過程
げんしぶつりがく	原子物理学
げんしちょうしゃ	現市庁舎
げんしきのうてき	原始帰納的
げんざいりょうひ	原材料費
げんざいもんだい	現在問題
げんざいみしよう	現在未使用
げんざいはつばい	現在発売
げんざいにっぽん	現在日本
げんざいせってい	現在設定
げんざいしょぞく	現在所属
げんざいさいしん	現在最新
げんざいげんいん	現在原因
げんさんごうせい	減算合成
げんさくどうぶつ	原索動物
げんさくだいほん	原作台本
げんさきとりひき	現先取引
げんごぶんかない	言語文化内
げんごひょうげん	言語表現
げんごはんきゅう	言語半球
げんごのうりょく	言語能力
げんごにゅうもん	言語入門
げんごてきちしき	言語的知識
げんごちゅうすう	言語中枢
げんごじょうほう	言語情報
げんごしんりがく	言語心理学
げんごしようしょ	言語仕様書
げんごしようしゃ	言語使用者
げんごしょりけい	言語処理系
げんごしょうがい	言語障害
げんごげんしょう	言語現象
げんごけいていぎ	言語系定義
げんごきょういく	言語教育
げんごかんきょう	言語環境
げんこうほうそう	現行放送
げんこうほうしき	現行方式
げんこうはんにん	現行犯人
げんこうしゃしゅ	現行車種
げんこうしめきり	原稿締切
げんこうさくせい	原稿作成
げんこうけんぽう	現行憲法
げんけいしつまく	原形質膜
げんぎょうぶもん	現業部門
げんぎょうきかん	現業機関
げんきんふうとう	現金封筒
げんきんとりひき	現金取引
げんきんかんけい	現金関係
げんきんかきとめ	現金書留
げんきんかいいん	現金会員
げんきょくどおり	原曲通り
げんがくがっそう	弦楽合奏
げんかんげんぞう	減感現像
げんかくせいぶつ	原核生物
げんかいとくせい	限界特性
げんかいそうこう	限界走行
げんかいこうよう	限界効用
げんかいいっぱい	限界一杯
げんえんしょうゆ	減塩醤油
げんえきせんしゅ	現役選手
げんえきけいかん	現役警官
げんえきいんたい	現役引退
げんいんぶんせき	原因分析
げんいんぶっしつ	原因物質
げんいんかいめい	原因解明
げんあんさくひん	原案作品
げんあおもりえき	現青森駅
げつれいほうこく	月例報告
げつれいひょうじ	月齢表示
げつまつはつばい	月末発売
げつまつそうけい	月末総計
げっかんてんもん	月刊天文
げっかんさくひん	月刊作品
げっかひょうじん	月下氷人
げすいどうせいび	下水道整備
げすいどうしせつ	下水道施設
げすいどうきょく	下水道局
げきだんしょぞく	劇団所属
げいのうせいかつ	芸能生活
げいのうしゃかい	芸能社会
げいのうかんけい	芸能関係
げいのうかつどう	芸能活動
げいのうかいいり	芸能界入
げいじゅつこうい	芸術行為
げいじゅつかたち	芸術家達
げいいんばしょく	鯨飲馬食
ぐんれいぶちょう	軍令部長
ぐんゆうかっきょ	群雄割拠
ぐんだんこうそう	軍団抗争
ぐんぜさんぎょう	グンゼ産業
ぐんじんしょうぎ	軍人将棋
ぐんじようびちく	軍事用備蓄
ぐんじょうしょく	群青色
ぐんじてきりゆう	軍事的理由
ぐんじてきやしん	軍事的野心
ぐんじせんもんか	軍事専門家
ぐんじじょうしき	軍事常識
ぐんじしんりゃく	軍事侵略
ぐんじしょうとつ	軍事衝突
ぐんじさんぎょう	軍事産業
ぐんじきょういく	軍事教育
ぐんじかいにゅう	軍事介入
ぐんしゅうしんり	群集心理
ぐんきものがたり	軍記物語
ぐんきしゅくせい	軍規粛正
ぐれーとぶりてん	大不列顛
ぐたいてきすうち	具体的数値
ぐたいてきじれい	具体的事例
ぐたいてきじじつ	具体的事実
ぐたいてきこうい	具体的行為
ぐたいてきぎろん	具体的議論
ぐたいてきいけん	具体的意見
ぐじょうはちまん	郡上八幡
ぐうぞうすうはい	偶像崇拝
ぐうぜんはっけん	偶然発見
ぐうすうばんごう	偶数番号
ぎんだまでっぽう	銀玉鉄砲
ぎんざまつざかや	銀座松坂屋
ぎんこうふりこみ	銀行振込
ぎんこうふりかえ	銀行振替
ぎんこうとりひき	銀行取引
ぎんこうちょきん	銀行貯金
ぎんこうごうとう	銀行強盗
ぎんこうぎょうむ	銀行業務
ぎんがちゅうしん	銀河中心
ぎんえんしゃしん	銀塩写真
ぎろんりょういき	議論領域
ぎろんしゅうそく	議論収束
ぎろんさんかしゃ	議論参加者
ぎょにくせいひん	魚肉製品
ぎょぐんたんちき	魚群探知機
ぎょぎょうしげん	漁業資源
ぎょうれつりろん	行列理論
ぎょうむれんらく	業務連絡
ぎょうむもくてき	業務目的
ぎょうむめいれい	業務命令
ぎょうむぼうがい	業務妨害
ぎょうむほうこく	業務報告
ぎょうむはつめい	業務発明
ぎょうむないよう	業務内容
ぎょうむていけい	業務提携
ぎょうむしりょう	業務資料
ぎょうへんしゅう	行編集
ぎょうそうにゅう	行挿入
ぎょうせきよそう	業績予想
ぎょうせきあっか	業績悪化
ぎょうせいちょう	行政庁
ぎょうせいたんい	行政単位
ぎょうせいそしき	行政組織
ぎょうせいじょう	行政上
ぎょうせいじけん	行政事件
ぎょうせいしょし	行政書士
ぎょうせいしょく	行政職
ぎょうせいしどう	行政指導
ぎょうせいこうい	行政行為
ぎょうせいくぶん	行政区分
ぎょうせいくかく	行政区画
ぎょうせいきかん	行政機関
ぎょうじゅうざが	行住座臥	行住坐臥
ぎょうしょうにん	行商人
ぎょうぎょうしく	仰々しく
ぎょうぎょうしい	仰々しい
ぎょうかいようご	業界用語
ぎょうかいびょう	業界病
ぎょうかいおおて	業界大手
ぎゅうにゅうびん	牛乳ビン	牛乳壜
ぎゃっこうほせい	逆光補正
ぎゃくてんかのう	逆転可能
ぎゃくじゅうでん	逆充電
ぎゃくさんしょう	逆参照
ぎゃくさつじけん	虐殺事件
ぎゃくさつこうい	虐殺行為
ぎゃくさつげんば	虐殺現場
ぎゃくこうりゃく	逆攻略
ぎゃくげんしょう	逆現象
ぎゃくぎょうれつ	逆行列
ぎゃくきでんあつ	逆起電圧
ぎゃくがくしゅう	逆学習
ぎもんふんしゅつ	疑問噴出
ぎもんひょうかい	疑問氷解
ぎもんけいようし	疑問形容詞
ぎのうきょういく	技能教育
ぎてきしょうめい	技適証明
ぎそうしんじゅう	偽装心中
ぎぜんてきこうい	偽善的行為
ぎじゅつろんぶん	技術論文
ぎじゅつりっこく	技術立国
ぎじゅつほさいん	技術補佐員
ぎじゅつほうこく	技術報告
ぎじゅつぶんしょ	技術文書
ぎじゅつぶんけん	技術文献
ぎじゅつぶでんき	技術部電気
ぎじゅつはってん	技術発展
ぎじゅつにんてい	技術認定
ぎじゅつどうこう	技術動向
ぎじゅつていけい	技術提携
ぎじゅつちょうさ	技術調査
ぎじゅつだいにぶ	技術第二部
ぎじゅつたんとう	技術担当
ぎじゅつたいこく	技術大国
ぎじゅつたいけい	技術体系
ぎじゅつせんもん	技術専門
ぎじゅつしりょう	技術資料
ぎじゅつしゅたい	技術主体
ぎじゅつしゃむけ	技術者向け
ぎじゅつしゃかい	技術社会
ぎじゅつきじゅん	技術基準	技術規準
ぎじゅつがっこう	技術学校
ぎじゅつかんりぶ	技術管理部
ぎじゅつかくしん	技術革新
ぎじゅつかいはつ	技術開発
ぎじゅつかいせつ	技術解説
ぎじけつごうせい	疑似結合性
ぎけんこうぎょう	技研工業
ぎおんひょうげん	擬音表現
ぎおんしょうじゃ	祇園精舎
がんめんそうはく	顔面蒼白
がんめんしんけい	顔面神経
がんていしゃしん	眼底写真
がんたんれいはい	元旦礼拝
がんこうしゅてい	眼高手低
がりれいへんかん	ガリレイ変換
がりょうてんせい	画竜点睛
がめんちゅうおう	画面中央
がめんしょうきょ	画面消去
がめんかいぞうど	画面解像度
がったいほうほう	合体方法
がっしょうひねり	合掌捻り
がっしょうしどう	合唱指導
がっしょうきょく	合唱曲
がっしゅくちゅう	合宿中
がっこうほうじん	学校法人
がっこうせいかつ	学校生活
がっこうすいせん	学校推薦
がっこうしんぶん	学校新聞
がっこうけんしん	学校検診
がっこうきょうし	学校教師
がっこううんえい	学校運営
がっけんとしせん	学研都市線
がっきゅうへいさ	学級閉鎖
がっきゅういいん	学級委員
がっきえんそうか	楽器演奏家
がっかいろんぶん	学会論文
がっかいはっこう	学会発行
がっかいけいしき	学会形式
がっかいかんけい	学会関係
がっかいかつどう	学会活動
がっかいかいいん	学会会員
がぞうじょうほう	画像情報
がぞうしょりしつ	画像処理室
がぞうしゅうふく	画像修復
がぞうこうがっか	画像工学科
がぞうあっしゅく	画像圧縮
がしんしょうたん	臥薪嘗胆
がしつちょうせい	画質調整
がしつこうじょう	画質向上
がくわりせんよう	学割専用
がくわりしんせい	学割申請
がくわりうんちん	学割運賃
がくれきじゅうし	学歴重視
がくれきしゃかい	学歴社会
がくりょくぶそく	学力不足
がくもんたいけい	学問体系
がくもんぜんぱん	学問全般
がくもんしゅほう	学問手法
がくめんはっこう	額面発行
がくぶきょういく	学部教育
がくないぼうしょ	学内某所
がくないじゅんい	学内順位
がくないかいかく	学内改革
がくせきばんごう	学籍番号
がくせいわりびき	学生割引
がくせいやきゅう	学生野球
がくせいぼしゅう	学生募集
がくせいぶちょう	学生部長
がくせいびんらん	学生便覧
がくせいばんごう	学生番号
がくせいせんばつ	学生選抜
がくせいせいかつ	学生生活
がくせいじっけん	学生実験
がくせいじちかい	学生自治会
がくせいしんぶん	学生新聞
がくせいしょくん	学生諸君
がくせいげきだん	学生劇団
がくせいけっこん	学生結婚
がくせいかいかん	学生会舘	学生会館
がくせいかいいん	学生会員
がくせいうんどう	学生運動
がくじゅつりよう	学術利用
がくじゅつようご	学術用語
がくじゅつはかせ	学術博士
がくじゅつじょう	学術上
がくじゅつざっし	学術雑誌
がくじゅつかいぎ	学術会議
がくしゅうりろん	学習理論
がくしゅうりょく	学習力
がくしゅうぶぶん	学習部分
がくしゅうふのう	学習不能
がくしゅうづくえ	学習机
がくしゅうちゅう	学習中
がくしゅうそくど	学習速度
がくしゅうせっと	学習セット
がくしゅうずかん	学習図鑑
がくしゅうじょう	学習上
がくしゅうじゅく	学習塾
がくしゅうじてん	学習辞典
がくしゅうじかん	学習時間
がくしゅうしどう	学習指導
がくしゅうこうか	学習効果
がくしゅうけっか	学習結果
がくしゅうきのう	学習機能
がくしゅうきそく	学習規則
がくしゅうきこう	学習機構
がくしゅうきかん	学習期間
がくしゅうきかい	学習機械
がくしゅうかんじ	学習漢字
がくしゅうかのう	学習可能
がくしゅうかてい	学習過程
がくしゅうかがく	学習科学
がくしにゅうがく	学士入学
がくしかいめいぼ	学士会名簿
がくさいもんだい	学際問題
がくげいだいがく	学芸大学
がくぎょうじょう	学業上
がくおんごうせい	楽音合成
がくえんふんそう	学園紛争
がくえんとしせん	学園都市線
がくいじゅよしき	学位授与式
がいらいざつおん	外来雑音
がいようせつめい	概要説明
がいやじゆうせき	外野自由席
がいぶどうきがた	外部同期型
がいぶちょうこう	外部調光
がいぶさんしょう	外部参照
がいぶかんきょう	外部環境
がいねんこうぞう	概念構造
がいねんけいせい	概念形成
がいねんくうかん	概念空間
がいとうはんばい	街頭販売
がいとうしゃしゅ	該当車種
がいとうこうもく	該当項目
がいとうえんぜつ	街頭演説
がいてきよういん	外的要因
がいちゅうくじょ	害虫駆除
がいじんせんしゅ	外人選手
がいしょこうどく	外書講読
がいしゅつちゅう	外出中
がいしゅつきんし	外出禁止
がいしゅつきょか	外出許可
がいしゅうちょう	外周長
がいしどうにゅう	外資導入
がいこくりょこう	外国旅行
がいこくめんきょ	外国免許
がいこくぼうえき	外国貿易
がいこくぶんがく	外国文学
がいこくそうきん	外国送金
がいこくせんしゅ	外国選手
がいこくせいひん	外国製品
がいこくじんわく	外国人枠
がいこくさんまい	外国産米
がいこくごがくぶ	外国語学部
がいこくこくせき	外国国籍
がいこくきぎょう	外国企業
がいこうもんだい	外交問題
がいこうぶんしょ	外交文書
がいこうどりょく	外交努力
がいこうとっけん	外交特権
がいこうかんけい	外交関係
がいかりょうがえ	外貨両替
がいかだかんけん	外貨兌換券
がいかくだんたい	外郭団体
ごれいぜいてんのう	後冷泉天皇
ごりょうぼくじょう	御料牧場
ごようぜいてんのう	後陽成天皇
ごももぞのてんのう	後桃園天皇
ごむらかみてんのう	後村上天皇
ごみずのおてんのう	後水尾天皇
ごほりかわてんのう	後堀河天皇
ごふかくさてんのう	後深草天皇
ごはんきゅうしょく	御飯給食
ごはなぞのてんのう	後花園天皇
ごにじょうてんのう	後二条天皇
ごじゅっぽひゃっぽ	五十歩百歩
ごじゅうおんじゅん	五十音順
ごしらかわてんのう	後白河天皇
ごしゅうしょうさま	御愁傷様
ごしぶんかかくめい	五
ごさんじゅうじけん	五
ごさぎゃくでんぱん	誤差逆伝搬
ごこじゅうろっこく	五胡十六国
ごくていおんそうち	極低温装置
ごきょうりょくくだ	御協力下
ごがくさんこうしょ	語学参考書
ごかめやまてんのう	後亀山天皇
ごおんりょうかいど	語音了解度
ごおんめいりょうど	語音明瞭度
ごえんゆうてんのう	後円融天皇
ごうりゅうちょくご	合流直後
ごうりゅうしゃせん	合流車線
ごうりてきせつめい	合理的説明
ごうどうれんしゅう	合同練習
ごうどうとうかせい	合同等価性
ごうどうこうぎょう	合同興業
ごうせいせんりょう	合成染料
ごうせいしょくひん	合成食品
ごうせいぎょうれつ	剛性行列
ごうかくはっぴょう	合格発表
ごうかくしょうしょ	合格証書
ごうかあいぞうばん	豪華愛蔵版
ごういけいせいほう	合意形成法
げんりげんそくてき	原理原則的
げんゆりゅうしゅつ	原油流出
げんゆうしゃりょう	現有車両
げんぺいとうまでん	源平討魔伝
げんぺいせいすいき	源平盛衰記
げんぱつすいしんは	原発推進派
げんでぃれくとりー	現ディレクトリー
げんていりようしゃ	限定利用者
げんていみかいじょ	限定未解除
げんていじょうぞう	限定醸造
げんていじょうけん	限定条件
げんていしょうひん	限定商品
げんていしょうにん	限定承認
げんつきじどうしゃ	原付自動車
げんちりょこうしゃ	現地旅行社
げんちょしゃちゅう	原著者註
げんだいぶつりがく	現代物理学
げんだいにほんじん	現代日本人
げんだいちゅうごく	現代中国
げんだいげいじゅつ	現代芸術
げんだいかなづかい	現代仮名遣	現代仮名遣い
げんだいかがくてき	現代科学的
げんだいおんがくか	現代音楽家
げんぞうじょうけん	現像条件
げんすいばくきんし	原水爆禁止
げんすいはせいぶん	減衰波成分
げんすいせいげんは	減衰正弦波
げんすいじょうすう	減衰定数
げんすいきょくせん	減衰曲線
げんじょうようにん	現状容認
げんじょうもんだい	現状問題
げんじょうほうこく	現状報告
げんじょうぶんせき	現状分析
げんじょうにんしき	現状認識
げんじょうついにん	現状追認
げんじょうちょうさ	現状調査
げんじょうしんこく	現状申告
げんじょうしゃけん	原乗車券
げんじょうさんぞう	玄奘三蔵
げんじょうさいだい	現状最大
げんじょうかくにん	現状確認
げんじょうかいふく	原状回復
げんじょうかいぜん	現状改善
げんじょうかいせつ	現状解説
げんじょういじあん	現状維持案
げんじゅうちゅうい	厳重注意
げんじつしゅぎしゃ	現実主義者
げんしろぶつりがく	原子炉物理学
げんしりょくせつび	原子力設備
げんしりょくじだい	原子力時代
げんしょくげきだん	原色劇団
げんしょくけいかん	現職警官
げんしょうろんてき	現象論的
げんしょうてんのう	元正天皇
げんしょうたいおう	現象対応
げんしょうけいこう	減少傾向
げんしかくほうかい	原子核崩壊
げんしかくこうがく	原子核工学
げんざいかんりょう	現在完了
げんさくしょうせつ	原作小説
げんごせっけいしゃ	言語設計者
げんごしようじょう	言語仕様上
げんごがくぜんたい	言語学全体
げんごかいせきほう	言語解析法
げんこうはんたいほ	現行犯逮捕
げんこうそうふさき	原稿送付先
げんこうしょうひん	現行商品
げんけんかいしゅう	原券回収
げんけいてきようそ	原形的要素
げんきんしょうひん	現金賞品
げんきんかんじょう	現金勘定
げんきょうほうこく	現況報告
げんきゅうないよう	言及内容
げんきどうしょてん	源喜堂書店
げんがっきそうしゃ	弦楽器奏者
げんかしょうきゃく	減価償却
げんかくしゅぎてき	厳格主義的
げんかいりょういき	限界領域
げんかいちいじょう	限界値以上
げんかいかいぞうど	限界解像度
げんおんついきゅう	原音追求
げんえきだいひょう	現役代表
げんえきさいきょう	現役最強
げんえきいんたいご	現役引退後
げんいんついきゅう	原因追及
げんいんきゅうめい	原因究明
げつがくりょうきん	月額料金
げっかんしゅうけい	月間集計
げすいしょりじょう	下水処理場
げすいしょりしせつ	下水処理施設
げしゃぜんとむこう	下車前途無効
げきちゅうばんぐみ	劇中番組
げきじょうこうかい	劇場公開
げきじょうこうえん	劇場公演
げかしゅじゅつてき	外科手術的
げいじゅつひひょう	芸術批評
げいじゅつてきかち	芸術的価値
げいじゅつだいがく	芸術大学
げいじゅつさくひん	芸術作品
げいじゅつがっこう	芸術学校
げいじゅつかんけい	芸術関係
げいじゅつかつどう	芸術活動
げいじゅつおんがく	芸術音楽
ぐんろんにゅうもん	群論入門
ぐんようろうむしゃ	軍用労務者
ぐんむきょくちょう	軍務局長
ぐんまだいがくいん	群馬大学院
ぐんだんらいしゅう	軍団来襲
ぐんたいむとうせい	軍隊無統制
ぐんじんしゅくしゃ	軍人宿舎
ぐんじゅさんぎょう	軍需産業
ぐんじゅこうじょう	軍需工場
ぐんこくしゅぎしゃ	軍国主義者
ぐんかくしゅぎしゃ	軍拡主義者
ぐたいてきもんだい	具体的問題
ぐたいてきほうほう	具体的方法
ぐたいてきへいがい	具体的弊害
ぐたいてきないよう	具体的内容
ぐたいてきていあん	具体的提案
ぐたいてきたいけん	具体的体験
ぐたいてきしょうこ	具体的証拠
ぐたいてきしゅほう	具体的手法
ぐたいてきしゅだん	具体的手段
ぐたいてきさぎょう	具体的作業
ぐたいてきこうどう	具体的行動
ぐたいてきがいねん	具体的概念
ぎんざいっちょうめ	銀座一丁目
ぎんきょうはんのう	銀鏡反応
ぎろんふじゅうぶん	議論不十分
ぎろんじょうきょう	議論状況
ぎろんしゅうりょう	議論終了
ぎょくせきこんこう	玉石混淆	玉石混交
ぎょぎょうくみあい	漁業組合
ぎょぎょうかんれん	漁業関連
ぎょうれつけいさん	行列計算
ぎょうれつえんざん	行列演算
ぎょうむもくひょう	業務目標
ぎょうせいぶんしょ	行政文書
ぎょうせいひょうか	行政評価
ぎょうせいてつづき	行政手続
ぎょうせいそしょう	行政訴訟
ぎょうせいしょぶん	行政処分
ぎょうせいざいさん	行政財産
ぎょうせいこくさい	暁星国際
ぎょうせいかいかく	行政改革
ぎょうすうちょうか	行数超過
ぎょうすうせいげん	行数制限
ぎょうじよていらん	行事予定欄
ぎょうしゅうりょく	凝集力
ぎょうしゃはいそう	業者配送
ぎょうこてんこうか	凝固点降下
ぎょうかいだんたい	業界団体
ぎょうかいぜんたい	業界全体
ぎょうかいせいかつ	業界生活
ぎゅうほせんじゅつ	牛歩戦術
ぎゅうにゅうぱっく	牛乳パック
ぎゅういんばしょく	牛飲馬食
ぎゃくゆにゅうひん	逆輸入品
ぎゃくゆにゅうばん	逆輸入版
ぎゃくゆにゅうしゃ	逆輸入車
ぎゃくへんかんしき	逆変換式
ぎゃくてんまんるい	逆転満塁
ぎゃくてんしょうり	逆点勝利	逆転勝利
ぎゃくちょうりゅう	逆潮流
ぎゃくせつすいみん	逆説睡眠
ぎゃくじゅうじがた	逆十字固
ぎゃくさんかっけい	逆三角形
ぎゃくさんかくけい	逆三角形
ぎゃくきでんりょく	逆起電力
ぎゃくうんどうがく	逆運動学
ぎふおうかんしょう	岐阜王冠賞
ぎどうさんしのはは	儀同三司母
ぎちょうさいりょう	議長裁量
ぎちょうこうほしゃ	議長候補者
ぎそうけんきゅうぶ	艤装研究部
ぎじゅつれきししょ	技術歴史書
ぎじゅつへんちょう	技術偏重
ぎじゅつぶんかかい	技術分科会
ぎじゅつひょうろん	技術評論
ぎじゅつはっぴょう	技術発表
ぎじゅつのうりょく	技術能力
ぎじゅつとうかつぶ	技術統括部
ぎじゅつてきりゆう	技術的理由
ぎじゅつてきちしき	技術的知識
ぎじゅつてきしんぽ	技術的進歩
ぎじゅつせっけいぶ	技術設計部
ぎじゅつすいじゅん	技術水準
ぎじゅつすいしんぶ	技術推進部
ぎじゅつすいしんか	技術推進課
ぎじゅつじょうほう	技術情報
ぎじゅつしゅっぱん	技術出版
ぎじゅつこうりゅう	技術交流
ぎじゅつこうじょう	技術向上
ぎじゅつけんきゅう	技術研究
ぎじゅつきょうしつ	技術教室
ぎじゅつきかくしつ	技術企画室
ぎじゅつかいはつぶ	技術開発部
ぎじゅついいんかい	技術委員会
ぎじちょっこうけい	擬似直交系
ぎじかがくしょせき	疑似科学書籍
ぎかいかいさんけん	議会解散権
ぎいんないかくせい	議院内閣制	議員内閣制
がんよくせいいんし	癌抑制因子
がんていしゅっけつ	眼底出血
がんじょうにんげん	頑丈人間
がんぐせんもんてん	玩具専門店
がんきゅううんどう	眼球運動
がめんひょうじよう	画面表示用
がめんひょうじいき	画面表示域
がめんにゅうりょく	画面入力
がめんちゅうおうぶ	画面中央部
がめんたてほうこう	画面縦方向
がめんしゅつりょく	画面出力
がめんいちまいぶん	画面一枚分
がめんいちばんうえ	画面一番上
がっぺいしゅうごう	合併集合
がっしょうれんこう	合従連衡
がっしょうだんいん	合唱団員
がっしょうたいかい	合唱大会
がっしゅくけいしき	合宿形式
がっこうせっちぎむ	学校設置義務
がっこうしゅうへん	学校周辺
がっこうしきちない	学校敷地内
がっこうきょういく	学校教育
がっきょくこうせい	楽曲構成
がっきゅうほうかい	学級崩壊
がっきはくぶつかん	楽器博物館
がっきてんしゅさい	楽器店主催
がっかいはっぴょう	学会発表
がっかいじむきょく	学会事務局
がっかいしゅっせき	学会出席
がっかいしけいさい	学会誌掲載
がっかいきょうさい	学会共催
がぞうにゅうりょく	画像入力
がぞうしょりそうち	画像処理装置
がぞうけんきゅうぶ	画像研究部
がすじょうせいうん	ガス状星雲
がじょえんかんこう	雅叙園観光
がくりょくいじょう	学力以上
がくゆうきょうかい	楽友協会
がくもんりょういき	学問領域
がくもんてきたいど	学問的態度
がくもんてきしんり	学問的真理
がくもんたんきゅう	学問探求
がくもんこうしょう	学問考証
がくふにゅうりょく	楽譜入力
がくふきじゅつよう	楽譜記述用
がくないはいふよう	学内配布用
がくどうほいくしょ	学童保育所
がくたんきょうかん	学担教官
がくせいりょうきん	学生料金
がくせいひかえしつ	学生控室
がくせいたいしょう	学生対象
がくせいじっしゅう	学生実習
がくせいしゅくしゃ	学生宿舎
がくせいきょういく	学生教育
がくせいえんごかい	学生援護会
がくじゅつろんぶん	学術論文
がくじゅつもくてき	学術目的
がくじゅつどうこう	学術動向
がくじゅつてきかち	学術的価値
がくじゅつだんたい	学術団体
がくじゅつしんこう	学術振興
がくじゅつかつどう	学術活動
がくしゅうもんだい	学習問題
がくしゅうほうほう	学習方法
がくしゅうほうしき	学習方式
がくしゅうばいあす	学習バイアス
がくしゅうないよう	学習内容
がくしゅうそうだん	学習相談
がくしゅうせいぎょ	学習制御
がくしゅうしんごう	学習信号
がくしゅうさんぷる	学習サンプル
がくしゅうさいくる	学習サイクル
がくしゅうけいとう	学習系統
がくしゅうけいすう	学習係数
がくしゅうかいすう	学習回数
がくしゅういんだい	学習院大
がくさいりょういき	学際領域
がくさいこうりゅう	学際交流
がくげいだいふぞく	学芸大付属
がくぎょうせいせき	学業成績
がくかんせつしょう	顎関節症
がくいじゅよきこう	学位授与機構
がくいきじゅよしき	学位記授与式
がいりょくせいぶん	外力成分
がいようしょうかい	概要紹介
がいむしょうじかん	外務省次官
がいぶにゅうりょく	外部入力
がいぶしゅつりょく	外部出力
がいぶこんごうしき	外部混合式
がいねんてきちしき	概念的知識
がいねんがくしゅう	概念学習
がいせんもんしょう	凱旋門賞
がいせんちょくつう	外線直通
がいせいせいちょう	外生生長
がいじんりょうきん	外人料金
がいじゅうないごう	外柔内剛
がいじにゅうりょく	外字入力
がいじどういりぐち	外耳道入口
がいさんようきゅう	概算要求
がいこくじんさっか	外国人作家
がいこくじんかしゅ	外国人歌手
がいこくじどうしゃ	外国自動車
がいこくごろんぶん	外国語論文
がいこくきゅうだん	外国球団
がいこうこうしょう	外交交渉
がいこうけいしせい	外向傾姿勢
がいかいじょうほう	外界情報
がいえんせいこうり	外延性公理
ごつちみかどてんのう	後土御門天皇
ごだいけっとうひょう	五代血統表
ごさんじょうてんのう	後三条天皇
ごさくらまちてんのう	後桜町天皇
ごこうみょうてんのう	後光明天皇
ごがくがくしゅうよう	語学学習用
ごかんせいようきゅう	互換性要求
ごかしわばらてんのう	後柏原天皇
ごうどうたいいくさい	合同体育祭
ごうどうえんそうかい	合同演奏会
ごうせいほぞんりょう	合成保存料
ごうせいかんみりょう	合成甘味料
ごうかくしゅくがかい	合格祝賀会
ごうかいちりゅうひん	豪華一流品
ごういじこうさくせい	合意事項作成
ごいちじょうてんのう	後一条天皇
げんぶつしきゅうひん	現物支給品
げんばんしようりょう	原盤使用料
げんばくしりょうかん	原爆資料館
げんばくいりょうほう	原爆医療法
げんていじょうけんか	限定条件下
げんちゅうしんちゅう	原中心柱
げんだいちゅうごくご	現代中国語
げんだいすうがくしゃ	現代数学社
げんだいさっきょくか	現代作曲家
げんだいこくごじてん	現代国語辞典
げんだいえいわじてん	現代英和辞典
げんたかちほてつどう	現高千穂鉄道
げんせんぶんりかぜい	源泉分離課税
げんせんちょうしゅう	源泉徴収
げんじつとうひちゅう	現実逃避中
げんじつてきたいおう	現実的対応
げんじつてきかいとう	現実的回答
げんしりょくれっしゃ	原子力列車
げんしりょくひこうき	原子力飛行機
げんしりょくはつでん	原子力発電
げんしりょくはくしょ	原子力白書
げんしりきこうがっか	原子力工学科
げんしょうしゅぎてき	減少主義的
げんしょうしゅぎしゃ	減少主義者
げんしながわえきまえ	現品川駅前
げんしきょうさんせい	原始共産制
げんしかくぶつりがく	原子核物理学
げんしかくこうがっか	原子核工学科
げんざいにゅうしゅか	現在入手可
げんざいしんこうけい	現在進行形
げんざいしようちゅう	現在使用中
げんざいしこうちゅう	現在試行中
げんごてきひょうげん	言語的表現
げんごけんきゅうじょ	言語研究所
げんごけんきゅうしょ	言語研究所
げんごけんきゅうかい	言語研究会
げんごがくてきけんち	言語学的見地
げんごがくだいじてん	言語学大辞典
げんこうひょうじゅん	現行標準
げんこうにゅうりょく	原稿入力
げんけいしつれんらく	原形質連絡
げんきんしゅうにゅう	現金収入
げんがくしじゅうそう	弦楽四重奏
げんかんさりょうほう	減感作療法
げんかしょうきゃくひ	減価償却費
げんかくしょうじょう	幻覚症状
げつれいきょうぎかい	月例競技会
げっしゅつたいしょく	月出帯蝕
げっかんよていひょう	月間予定表
げっかんあいどくしょ	月刊愛読書
げきやすこうくうけん	激安航空券
げきじょうこうかいじ	劇場公開時
げいのうやましろぐみ	芸能山城組
げいじゅつこうがくぶ	芸術工学部
げいじゅつげきじょう	芸術劇場
ぐんれいぶそうちょう	軍令部総長
ぐんまけんあづません	群馬県吾妻線
ぐんさんふくごうたい	軍産複合体
ぐれんなだいしきょう	紅蓮奈大司教
ぐたいてきたいしょう	具体的対象
ぐたいてきしょうめい	具体的証明
ぎんじょういんりょう	吟醸飲料
ぎんこうふつうこうざ	銀行普通口座
ぎんがちゅうしんいき	銀河中心域
ぎょらいはっしゃかん	魚雷発射管
ぎょぎょうそうぎょう	漁業操業
ぎょうれつひょうげん	行列表現
ぎょうれつちかんすう	行列値関数
ぎょうむぼうがいざい	業務妨害罪
ぎょうむじょうかしつ	業務上過失
ぎょうむしっこうしゃ	業務執行者
ぎょうせいのうりょく	行政能力
ぎょうせいじょうほう	行政情報
ぎょうせいくかくない	行政区画内
ぎょうせいくいきない	行政区域内
ぎょうせいかんちょう	行政官庁
ぎょうしょうせんよう	行商専用
ぎょうかんちょうせい	行間調整
ぎょうかいじょうほう	業界情報
ぎゅうにゅうせっけん	牛乳石鹸
ぎゃくてんゆうしょう	逆転優勝
ぎゃくせんいかんすう	逆遷移関数
ぎゃくかんじへんかん	逆漢字変換
ぎゃくいっぽんぜおい	逆一本背負
ぎむきょういくきかん	義務教育期間
ぎじんてきひょうげん	擬人的表現
ぎじらんすうはっせい	疑似乱数発生
ぎじゅつれんらくかい	技術連絡会
ぎじゅつほんぶちょう	技術本部長
ぎじゅつほうこくしょ	技術報告書
ぎじゅつぶもんいがい	技術部門以外
ぎじゅつぶでんきけい	技術部電気系
ぎじゅつぶぎじゅつか	技術部技術課
ぎじゅつてきよういん	技術的要因
ぎじゅつてきもんだい	技術的問題
ぎじゅつてきないよう	技術的内容
ぎじゅつてきそくめん	技術的側面
ぎじゅつてきせってい	技術的設定
ぎじゅつてきしゅだん	技術的手段
ぎじゅつてきこうさつ	技術的考察
ぎじゅつてきけっかん	技術的欠陥
ぎじゅつていけいてん	技術提携店
ぎじゅつたんとうしゃ	技術担当者
ぎじゅつせんしゅけん	技術選手権
ぎじゅつじっしょうき	技術実証機
ぎじゅつしんさいいん	技術審査委員
ぎじゅつけんきゅうぶ	技術研究部
ぎじゅつけいぶんしょ	技術系文書
ぎじゅつきょういくか	技術教育課
ぎじゅつかいはつしつ	技術開発室
ぎじゅつえいぎょうか	技術営業課
ぎじちょっこうきてい	擬似直交基底
ぎじぎゃくぎょうれつ	擬似逆行列
ぎいんしょうげんほう	議院証言法
がんめんしんけいつう	顔面神経痛
がめんちゅうおううえ	画面中央上
がっぺいぞうだいごう	合併増大号
がっしょうれんしゅう	合唱練習
がっしゅうこくせいふ	合衆国政府
がっこうきゅうしょく	学校給食
がっこうかんけいしゃ	学校関係者
がっかそつぎょうしゃ	学科卒業者
がっかぜんきょういん	学科全教員
がっかいきかんちゅう	学会期間中
がぞくせっちゅうたい	雅俗折衷体
がぞうでんしがっかい	画像電子学会
がぞうせいせいそうち	画像生成装置
がぞうけんきゅうじょ	画像研究所
がぞうけんきゅうしつ	画像研究室
がくぶがくせいじだい	学部学生時代
がくふしゅっぱんしゃ	楽譜出版社
がくせいようあんない	学生用案内
がくせいせんしゅけん	学生選手権
がくせいじだいいらい	学生時代以来
がくせいきしゅくしゃ	学生寄宿舎
がくせいかいかくいご	学制改革以後
がくじゅつてきわだい	学術的話題
がくじゅつじょうほう	学術情報
がくじゅつしんぎかい	学術審議会
がくじゅつけんきゅう	学術研究
がくしゅうりょういき	学習領域
がくしゅうようりょう	学習容量
がくしゅうひょうげん	学習表現
がくしゅうのうりょく	学習能力
がくしゅうじょうほう	学習情報
がくしゅうじょうけん	学習条件
がくしゅうしんりがく	学習心理学
がくしゅうしょうがい	学習障害
がくしゅうしゅうごう	学習集合
がくしゅうしゃじしん	学習者自身
がくしゅうけんきゅう	学習研究
がくしゅうかんきょう	学習環境
がくしゅうかのうせい	学習可能性
がくしゅういんめじろ	学習院目白
がくしきけいけんしゃ	学識経験者
がくげいだいがくえき	学芸大学駅
がいようせつめいしょ	概要説明書
がいやじゆうせきけん	外野自由席券
がいぶちょうこうしき	外部調光式
がいぶきおくばいたい	外部記憶媒体
がいじとうろくきのう	外字登録機能
がいしょくさんぎょう	外食産業
がいしゅつきんしれい	外出禁止令
がいしゅういっしょく	鎧袖一触
がいこくばしょうたい	外国馬招待
がいこくばしゅっそう	外国馬出走
がいこくだいひょうば	外国代表馬
がいこくじんとうろく	外国人登録
がいこくじんとうしか	外国人投資家
がいこくじんだんせい	外国人男性
がいこくじんせんよう	外国人専用
がいこくじんせんしゅ	外国人選手
がいこくじんかんとく	外国人監督
がいこくしょうたいば	外国招待馬
がいこくしゅっちょう	外国出張
がいこくごきょういく	外国語教育
がいこくかわせてがた	外国為替手形
がいこくかわせそうば	外国為替相場
がいえんひがしどおり	外苑東通り
ごさとくせいきょくめん	誤差特性曲面
ごくとうぐんじほうてい	極東軍事法廷
ごくていおんれいきゃく	極低温冷却
ごうどうじょうざんほう	合同乗算法
ごうどうけんきゅうかい	合同研究会
ごうどうがくしゅうかい	合同学習会
ごうそっきゅうとうしゅ	豪速球投手
ごういけいせいほうほう	合意形成方法
ごういけいせいほうしき	合意形成方式
ごういけいせいしゅだん	合意形成手段
げんゆうとっきゅうしゃ	現有特急車
げんぶんいっちうんどう	言文一致運動
げんぱつようねんりょう	原発用燃料
げんていかいじょしけん	限定解除試験
げんだいぶんめいびょう	現代文明病
げんだいのうがくしゅう	現代能楽集
げんだいしゅうごうろん	現代集合論
げんぞうりょうむりょう	現像料無料
げんそうこうきょうがく	幻想交響楽
げんじょうほうこくしょ	現状報告書
げんじょうしゃけんるい	原乗車券類
げんじょうしゃけんがく	原乗車券額
げんじものがたりえまき	源氏物語絵巻
げんしりょくねんりょう	原子力燃料
げんしりょくさんぎょう	原子力産業
げんしりょくきほんほう	原子力基本法
げんしりょくいいんかい	原子力委員会
げんざいりょこうちゅう	現在旅行中
げんざいらいにちちゅう	現在来日中
げんざいはつばいちゅう	現在発売中
げんざいはいばんちゅう	現在廃盤中
げんざいちょうさちゅう	現在調査中
げんざいせんたくちゅう	現在選択中
げんざいじゅんびちゅう	現在準備中
げんざいしんこうちゅう	現在進行中
げんざいけんとうちゅう	現在検討中
げんざいけいかくちゅう	現在計画中
げんざいかいはつちゅう	現在開発中
げんざいかいちくちゅう	現在改築中
げんごけいせいよういん	言語形成要因
げんごがくてきこんきょ	言語学的根拠
げんごがくてきかんねん	言語学的観念
げんこうほうきそうらん	現行法規総覧
げんきんすいとうちょう	現金出納帳
げんきんかいいんかかく	現金会員価格
げんかしょうきゃくりつ	減価償却率
げんえきじょしこうせい	現役女子高生
げんえきさいねんちょう	現役最年長
げつめんなんちゃくりく	月面軟着陸
げすいどうきょうかいし	下水道協会誌
げきじょうようさくひん	劇場用作品
げきじょうそうかんとく	劇場総監督
げきじょうこうかいばん	劇場公開版
げいじゅつおんがくろん	芸術音楽論
ぐたいてきたいけんだん	具体的体験談
ぐうぞうすうはいひはん	偶像崇拝批判
ぐうぞうすうはいしゅぎ	偶像崇拝主義
ぎんがえいゆうでんせつ	銀河英雄伝説
ぎんいろゆうこうしょう	銀色有功賞
ぎろんきかんえんちょう	議論期間延長
ぎょうせいかんりちょう	行政管理庁
ぎょうしょうしゃりょう	行商車両
ぎょうかいひょうじゅん	業界標準
ぎょうかいじんそうほう	業界人双方
ぎゅうどんやてんちょう	牛丼屋店長
ぎゃくさんかくかんすう	逆三角関数
ぎむきょういくがっこう	義務教育学校
ぎむきょういくいじょう	義務教育以上
ぎてきしょうめいせいど	技適証明制度
ぎじゅつひょうろんしゃ	技術評論社
ぎじゅつてきすいじゅん	技術的水準
ぎじゅつてきけんきゅう	技術的研究
ぎじゅつしゃきょうかい	技術者協会
ぎじゅつこうしゅうかい	技術講習会
ぎじゅつけんきゅうじょ	技術研究所
ぎじゅつけんきゅうしょ	技術研究所
ぎじゅつけんきゅうしつ	技術研究室
ぎじゅつきょうりょくぶ	技術協力部
ぎじゅつかがくだいがく	技術科学大学
ぎじゅつかいはつほんぶ	技術開発本部
ぎじゅつかいはつじょう	技術開発上
ぎじゅつかいはつきこう	技術開発機構
ぎけんかぶしきがいしゃ	技研株式会社
がんりゅうじまけっせん	厳流島決戦
がめんしゅつりょくけい	画面出力系
がっしょうきょくしゅう	合唱曲集
がっしゅうこくほうれい	合衆国法令
がっしゅうこくどくとく	合衆国独特
がっしゅうこくけんぽう	合衆国憲法
がっこうきょういくほう	学校教育法
がっきゅういいんちょう	学級委員長
がぞうにゅうりょくよう	画像入力用
がぞうぎじゅつかいはつ	画像技術開発
がくもんてきこうりゅう	学問的交流
がくもんてきぎょうせき	学問的業績
がくせいしょうばんごう	学生証番号
がくせいえいがれんめい	学生映画連盟
がくじゅつようごしゅう	学術用語集
がくじゅつこうえんかい	学術講演会
がくしんけんきゅういん	学振研究員
がくしゅうじょうきょう	学習状況
がくしゅういんだいがく	学習院大学
がくしゅうあるごりずむ	学習アルゴリズム
がくしにゅうがくせいど	学士入学制度
がくしかいかんぶんかん	学士会館分館
がくかんせつだっきゅう	顎関節脱臼
がくえんまええきげしゃ	学園前駅下車
がいぶぶんぴつこうぞう	外部分泌構造
がいせつちょうほうけい	外接長方形
がいじんけんきゅうしゃ	外人研究者
がいしほういいかんそく	外篩包囲維管束
がいこくゆうびんかわせ	外国郵便為替
がいこくせんりょうぐん	外国占領軍
がいこくかわせぎんこう	外国為替銀行
がいけんじょうたいとう	外見上対等
げんぱつすいしんかんけい	原発推進関係
げんてんちゅうじつしゅぎ	原典忠実主義
げんだいしそうにゅうもん	現代思想入門
げんだいこうつうせいさく	現代交通政策
げんだいきょうようぶんこ	現代教養文庫
げんそうこうきょうきょく	幻想交響曲
げんせんちょうしゅうぜい	源泉徴収税
げんせいちゅうしんちゅう	原生中心柱
げんすいりょくちょうせい	減衰力調整
げんじょうふっきめいれい	現状復帰命令
げんしりょくはつでんしょ	原子力発電所
げんしょうしゅぎしゃてき	減少主義者的
げんざいかいしゅうちゅう	現在改修中
げんさんちしょうめいしょ	原産地証明書
げんがくしじゅうそうだん	弦楽四重奏団
げつれいけいざいほうこく	月例経済報告
げいじゅつしじょうしゅぎ	芸術至上主義
げいじゅつけんきゅうじょ	藝術研究所
げいじゅつけんきゅうしょ	藝術研究所
ぎょうむようきゅうとうき	業務用給湯機
ぎょうむじょうおうりょう	業務上横領
ぎょうむしっこうしゃいん	業務執行社員
ぎょうせいひょうかきょく	行政評価局
ぎょうせいしょぶんせいど	行政処分制度
ぎじゅつぶんしょさくせい	技術文書作成
ぎじゅつどうこうちょうさ	技術動向調査
ぎじゅつてきもんだいてん	技術的問題点
ぎじゅつてきせいじゅくど	技術的成熟度
ぎじゅつてきかいけつさく	技術的解決策
がっそうきょうそうきょく	合奏協奏曲
がっこうちゅうしゃじょう	学校駐車場
がぞうせいせいけんきゅう	画像生成研究
がくないえきでんたいかい	学内駅伝大会
がくじゅつけんきゅうとし	学術研究都市
がくしゅうないようしだい	学習内容次第
がくしゅうしゅうりょうご	学習終了後
がくしゅうけんきゅうしゃ	学習研究社
がくしゅういんしょとうか	学習院初等科
がいもくほういいかんそく	外木包囲維管束
がいぶにゅうりょくたんし	外部入力端子
がいとうこうしゅうでんわ	街頭公衆電話
がいこくせんぱくかんとく	外国船舶監督
がいこくじんろうどうしゃ	外国人労働者
がいこくじんりょこうしゃ	外国人旅行者
がいこくじんとうろくほう	外国人登録法
がいこくじんせんしゅわく	外国人選手枠
がいこくじんかんけいしゃ	外国人関係者
ごうせいちゃくしょくりょう	合成着色料
げんていせきにんのうりょく	限定責任能力
げんせんちょうしゅうひょう	源泉徴収票
げんじょうふざいしょうめい	現場不在証明
げんしりょくけんきゅうしょ	原子力研究所
げんごしゅうとくのうりょく	言語習得能力
げんこうりょうしゅうにゅう	原稿料収入
げんがくしじゅうそうきょく	弦楽四重奏曲
ぎょうせいふふくしんさほう	行政不服審査法
ぎょうせいだいしっこうほう	行政代執行法
がっこうきょういくばんぐみ	学校教育番組
がっこうきゅうぎょうきかん	学校休業期間
がっかいはっぴょうろんぶん	学会発表論文
がくせいやきゅうきょうかい	学生野球協会
がくしゅうしどうようりょう	学習指導要領
がいじんしょうたいせんしゅ	外人招待選手
がいこくじんりゅうがくせい	外国人留学生
がいこくじんとうろくしょう	外国人登録証
がいけいひょうじゅんかぜい	外形標準課税
げんしきのうてきかんすうるい	原始帰納的函数類
げんがくさんじゅうそうきょく	弦楽三重奏曲
ぎょうせいじけんそしょうほう	行政事件訴訟法
がぞうとくちょうちゅうしゅつ	画像特徴抽出
ぎょうしょうせんようしゃりょう	行商専用車両
ぎょうけいるいしんしょぐうれい	行刑累進処遇令
ぎょうかいひょうじゅんたいけい	業界標準体型	業界標準体形
がくりょうせんもんいいんちょう	学寮専門委員長
がいこくかわせこうにんぎんこう	外国為替公認銀行
がいこくかわせおよびがいこくぼうえきかんりほう	外国為替及び外国貿易管理法
