も	喪	持	茂	面	摸	姆	楙	裳	母	模	守	以	漏	藻	邑	貰	洩	燃	萌	揉	望	若	保	糢	盛
め	減	女	召	碼	愛	芽	目	雌	奴	眼	睨	賞	瑪
む	矛	務	咽	蒸	噎	毋	剥	六	梦	牟	群	夢	鵡	武	謀	無	无	向	霧
み	弥	身	満	己	巳	味	魅	御	視	滿	實	壬	深	充	美	観	三	箕	実	診	未	盈	觀	見	靡	稔	彌	看
ま	雑	卷	曲	万	播	満	真	墹	先	痲	磨	目	捲	舞	嘛	坐	俟	蒔	魔	巻	撒	麼	未	待	眞	敗	益	負	摩	間	交	混	増	麻	在	馬	茉	散	媽
もん	紋	文	問	捫	悶	門	聞
もろ	脆	諸	師
もれ	洩れ	漏れ
もり	護	森	守	萌梨	銛	杜	盛
もら	貰
もよ	最寄
もゆ	萌ゆ
もや	舫	靄	母屋
もも	股	桃	百	腿
もめ	揉め
もみ	樅	籾
もの	者	物
もぬ	蛻
もど	擬	戻
もと	元	幹	望都	下	求	本	悖	素	許	礎	戻	基
もつ	持つ	勿	物	縺
もっ	以
もぢ	捩
もち	用	持	餠	勿	黐	望	糯	餅	持ち
もだ	悶	黙
もた	靠	擡	持た	凭
もず	百舌	鴃	百舌鳥	鵙
もじ	門司	捩	綟	文字
もし	若し	模試
もさ	猛者
もこ	糢糊	模糊
もぐ	潜	濳	潛
もく	默	目	木	杢	黙	沐
もぎ	摸擬	茂木	模擬
もが	強請	藻掻	虎落
もえ	萠	燃え	萌え	萌絵	燃	萌
もう	蒙	罔	芒	艨	濛	曚	亡	朦	盲	設	耄	孟	魍	猛	網	申	莽	网	妄	毛	望	矇	檬	詣	儲	耗
めん	綿	眄	面	緜	緬	免	麺	麪	棉
めら	目良
めも	メモ
めめ	女々	女女
めべ	目減
めぶ	芽吹
めば	芽生	目張
めぬ	目抜
めど	目処	目途
めと	娶
めで	愛で	目出
めて	右手
めづ	目詰
めつ	眼付	滅	目付
めっ	滅
めだ	目立
めず	馬頭
めす	♀	雌	牝
めじ	目時	目地
めし	盲	飯
めざ	目刺	目醒	目覚	目指
めぐ	恵	愛	廻	回	惠	巡	繞	繚
めく	捲
めき	目利
めが	目掛	mega	女鹿
めか	粧
めお	目押
めい	冥	姪	名	酩	瞑	盟	迷	命	茗	鳴	滅入	溟	銘	明	謎	暝	榠
めあ	目明	目当	妻合
むろ	榁	室	牟婁
むれ	群れ	羣	群	牟礼
むり	無理
むら	斑	村	屯	邑	群	邨	叢	簇
むみ	無味
むま	夢魔
むび	夢寐
むひ	無比
むは	無派
むね	宗	棟	旨	胸	刀背
むに	無二
むな	宗	棟	胸	空	虚
むて	無手
むつ	陸奥	六	六つ	睦
むっ	六
むち	鞭	無恥	無知	笞
むだ	徒	無駄
むた	牟田	無佗
むせ	咽	噎
むす	結	掬
むじ	無地	無事
むし	蒸し	蟲	無死	寧	無始	無視	虫	毟	無私	夢死
むご	惨	酷
むこ	無辜	婿	壻	聟	向こ	向
むげ	無碍	無下	無礙
むけ	無卦	向
むく	報	浮腫	剥	酬	無垢	椋	向	尨
むぎ	麦	麥	牟岐
むき	無期	無機	無季	向き	無記	牟岐
むが	無我
むか	向か	邀	無化	対	迎	向
むい	無意	六	無位	無為
みん	閔	民	眠	明	罠
みわ	神酒	美和	三和	見分	三輪	巳波
みる	覩
みり	milli	粍
みよ	御代	身寄	美代
みや	見遣	宮	美弥
みも	身持
みめ	眉目	見目	美芽
みむ	見向	美夢
みみ	耳
みま	美馬	見舞	三間
みほ	三保	美峰	美帆	美浦	美穂	海蜂	美歩	美保	実穂	美豊
みぶ	見振	壬生	身振
みば	見映	見栄	見端
みは	見果	見晴	見張	瞠
みの	簑	蓑	三野	見逃	箕	実	簔	美濃	稔
みね	岑	美根	美祢	美禰	嶺	峰	峯	三根	三子
みぬ	見抜
みな	看做	皆	身投	見慣	見做	美那	美奈	見馴	美菜
みと	看取	美都	水戸	認	見蕩	弥刀	三戸	御津	見惚
みづ	美津
みつ	謐	満	凝視	三つ	見詰	貢	滿	光	櫁	充	密	瞶	三	見積	蜜	見付	円
みっ	三
みち	謐	通	路	途	倫	満ち	未知	蹊	道	美知
みだ	見出	濫	猥	乱	弥陀	妄	淫	紊	亂
みた	見立	満	充	見田	美田	三田
みぞ	溝	渠
みそ	三十	見逸	見初	味噌	晦
みせ	三瀬	廛	店	壥
みず	瑞	水
みす	見据	見過	視据	御簾	簾	見透	見棄	見捨	三栖
みじ	惨	慘	短
みし	見知
みさ	見下	弥撒	美沙	未沙	魅紗	美紗	美佐	美砂
みこ	見越	見込	皇子	御子	美子	巫	巫女
みけ	三毛
みく	美久	美来	未来
みぎ	」	＞	→	右	）	】	』
みき	実紀	幹	神酒	美季	未稀	美希	三城	三紀	美樹	光希	三基	美貴	御酒	御木	三喜	三樹	三木	美来	未希	見切	美紀	未木	未来	美喜	見聞
みが	磨
みか	美佳	実花	見掛	実可	美華	見兼	美歌	見交	美香	美夏	美伽	甕	三香	美加
みお	未緒	見下	実音	澪	美央	水脈	水尾	美緒	見終	美尾	見落	三尾	美織	未央
みえ	美江	美恵	美枝	見え	見栄	水絵	美瑛	三重	見得
みう	見受	身売
みい	見入	魅入	魅衣	御井	実入	三井
みあ	未亜	見上	見当	見飽	見合
まん	万	満	蹣	曼	悗	幡	饅	滿	瞞	萬	懣	幔	慢	鬘	漫	縵	蔓	鰻	謾
まゐ	參
まわ	囘	廻	回	周	巡
まろ	転	麻呂	麿	円
まれ	稀	希
まる	゜	槫	圓	〇	◯	○	丸	◎	●	。	・	円	．
まり	真理	鞠	満利	麻理	麻里	茉利	真里	掬	茉莉	万里	毬
まら	摩羅
まよ	魔除	麻世	眞夜	迷	真代	真世
まゆ	眉	繭	真由	麻愉	麻由
まや	麻矢	麻那	摩耶	魔夜	麻弥	馬屋
まも	防	護	守
まめ	忠実	荳	肉刺	豆
まむ	真向
まみ	茉美	塗	麻美	昌未	真美	麻弥	真実	舞美	見	麻実	眞美	磨美	魔美	魔魅
まま	侭	媽媽	墹	壗	儘	圸	随
まほ	真帆	真秀
まぶ	塗	眩	間夫
まび	間引	魔美
まひ	麻痺	痲痺
まば	疎
まは	廻	万葉	回
まの	真野	間延	間野
まね	招	真似	学
まぬ	間抜
まに	摩尼
まな	茉奈	愛	真奈	學	斈	真名	麻奈	学
まど	惑	間取	窓	悗	窗	円
まと	魔都	纒	纏	的	繚
まで	迄
まて	待て	蟶
まづ	不味	先づ
まつ	秣	松	末	枩	祭	纏	靺	奉	祀	抹	待つ	沫	茉
まっ	真っ
まち	甼	襠	万智	待ち	町	真知	区	街
まだ	未だ
また	俣	又	股	跨	亦	叉
まぜ	馬瀬
ませ	真瀬	間瀬
まず	不味	マズ	貧	先ず
ます	升	枡	桝	益	舛	増	鱒
まじ	雑	間近	蠱	交	混	真風
まし	況し	増	麻紙
まさ	勝	正	真	麻早	政	将	雅	眞	昌	征	優	柾	成	匡
まご	馬子	孫
まこ	魔子	真子	麻子	眞子
まげ	曲げ	曲	髷
まけ	負け	敗け
まぐ	紛
まく	膜	捲	幕
まぎ	紛	間木
まき	真城	卷	槙	槇	真紀	真樹	真季	麻紀	牧	巻き	麻貴	麻希	蒔	真希	巻	真貴	薪	真木
まが	曲	間貸	彎	擬	枉	弯	紛	間借
まか	罷	摩訶	摩可	委	任
まお	麻央	真麻	真央	苧麻	真緒
まえ	前
まう	設	申	詣	儲
まい	昧	真衣	眛	舞衣	妹	麻衣	舞	枚	米	參	邁	真依	参	詣	瑁	毎	埋
まあ	間合
もんめ	問目	匁
もんま	門真	門馬
もんぶ	文部
もんぴ	門扉
もんび	紋日
もんの	門野
もんな	門奈	文無
もんど	主水	門戸
もんと	門徒
もんち	門地
もんじ	文字
もんし	門歯	悶死
もんこ	門戸
もんく	文句
もんか	門下
もろや	諸矢
もろみ	醪	諸味
もろば	両刃
もろは	両刃	諸刃
もろて	諸手	双手
もろた	茂呂田	諸田
もろこ	諸子
もろお	師尾
もろえ	諸江
もろい	諸井
もれだ	漏れ出
もりん	茂林
もりや	守谷	守屋	森谷	森屋
もりべ	守部	森部
もりの	森野
もりと	森戸
もりつ	森津	盛り付
もりた	守田	盛田	森田	守り立
もりせ	森瀬
もりさ	盛り下
もりこ	盛り込
もりき	守木
もりお	森生	盛夫	守夫	盛雄	森尾	森男	守男	杜夫
もりい	森井
もりあ	盛り上	盛り合	盛上
もより	最寄	最寄り
もよお	催
もよう	模様
もやし	萌やし
ももよ	百代
ももや	桃屋
ももた	百田
ももせ	百瀬
ももこ	桃子
ももき	百木
ももか	百夏
ももえ	百枝	百恵
ももい	桃井
もめん	木綿
もみて	揉み手
もみじ	楓	椛	紅葉
もみけ	揉み消
もみい	籾井
もみあ	揉み合
もほう	模倣
もふく	喪服
もばら	茂原
もはん	模範
もはら	茂原
もはや	最早
ものも	物持
ものみ	物見
ものほ	物干	物欲
ものべ	物部
ものび	物日
ものな	物慣
ものた	物足
ものず	物好
ものし	物知
ものご	物乞
ものか	物書
ものお	桃生	物怖
ものう	物憂	懶
ものい	物入	物言
もぬし	喪主
もぬけ	蛻
もにわ	茂庭
もなか	最中
もどり	戻り
もどき	擬き
もとる	乖
もとや	元也
もとめ	求め
もとむ	求む
もとぶ	本部
もとび	元火
もとの	本埜	元野	基乃
もとね	元値
もとに	基に	元に
もとで	元手
もとづ	基
もとだ	元田
もとす	本栖	本巣
もとじ	元司
もとし	基史	元志	元司	基志
もとこ	元子	基子	茂登子	素子
もとき	元紀	基紀	本木	元木	元基	基樹
もとお	誠生	元男	元夫	元朗	基夫
もとえ	元絵
もとう	元売
もとい	基
もてな	持て成
もてぎ	茂木
もつれ	縺れ
もつご	没後
もっぱ	專	専
もっと	最	尤
もって	以て
もっけ	物怪	勿怪
もっか	黙過	目下
もちよ	持ち寄
もちや	餅屋
もちば	持ち場	持場
もちだ	持田	持ち出
もちさ	持ち去
もちこ	持ち込	持込	持ち越
もちき	持ち切
もちか	持ち替	持ち掛
もちお	持尾
もちい	用い
もちあ	持ち上	持ち合
もだえ	悶え
もたれ	凭れ	靠れ
もたら	齎
もぞう	摸造	模造
もそう	模奏
もせい	茂生
もずめ	物集	物集女
もずみ	茂住
もずく	水雲	海蘊	海雲
もすそ	裳裾
もじり	捩
もじめ	文字目
もじば	文字化
もじか	文字化
もじお	文字落
もしゅ	喪主
もしゃ	模写	摸写	摸冩
もしも	若しも
もしき	模式	摸式
もしか	若しか
もさく	摸索	模作	模索
もこと	藻琴
もこく	摸刻	模刻
もけい	模型
もぐら	土竜	土龍
もぐさ	藻草
もくろ	目論
もくめ	木目
もくぶ	木部
もくひ	黙秘	木皮
もくば	木馬
もくの	杢野
もくと	目睹	目途
もくづ	藻屑
もくず	藻屑
もくじ	目次	黙示
もくし	黙視	黙止	目指	目視	黙示
もがり	強請	殯	虎落
もがみ	最上
もがさ	痘瘡
もおか	真岡
もえつ	燃え尽
もえだ	萌え出
もえた	燃え立	萌え立
もえこ	萌子
もえぎ	萌え木	萌葱	萌木	萌黄
もえあ	燃え上
もうり	毛利
もうら	網羅
もうぼ	孟母
もうふ	毛布
もうで	詣で	詣
もうだ	猛打
もうし	孟子
もうご	妄語
もうこ	蒙古	猛虎
もうけ	儲
もうき	盲亀
もうか	猛火	真岡
もうう	猛雨
もうい	猛威
もうあ	盲唖
もいち	茂一
めんま	麺麻
めんぷ	綿布
めんぶ	面部
めんぴ	面皮
めんば	面罵
めんつ	面子
めんだ	免田
めんそ	免租	免訴	面素
めんし	綿糸
めんこ	面子
めんく	面食	面喰
めんが	面画
めんか	綿花	綿価	棉花
めろう	女郎
めりこ	減り込
めりか	芽里香
めやに	目ヤニ	目脂	目やに
めやす	目安
めもり	目盛	目盛り
めもま	メモ魔
めもと	目許	目元
めむろ	芽室
めみえ	目見え
めまひ	目眩い	目眩ひ	眩暈
めまい	目眩い	眩暈	暈
めぼし	目星
めべり	目減り
めへん	目偏
めびき	目引
めばる	眼張
めばり	目貼り
めばな	雌花
めばえ	芽生え
めはな	目鼻
めはし	目端
めのと	乳母
めのう	瑪瑙
めぬま	妻沼
めぬき	目貫	目抜き
めなみ	女波
めなだ	赤目魚
めどぎ	蓍
めどき	女時
めどお	目通
めとき	目時
めでた	目出度
めづら	珎	珍
めつご	滅後	滅期
めつけ	目付
めつき	眼つき	眼付	目つき
めった	滅多
めっし	滅私
めっき	滅金	鍍金
めちゃ	目茶
めだま	目玉	眼球
めだつ	目立つ
めだち	目立
めせん	目線
めずら	珎	珍
めじろ	目白
めじり	目尻
めじか	牝鹿	女鹿
めしや	飯屋
めしべ	雌蘂	雌蕊
めした	目下
めしい	召し入	盲
めしあ	召し上
めざわ	目障
めざめ	目覚め
めざま	目覚
めざと	目敏
めざす	目指す
めざし	目刺	目刺し
めさき	目先	目崎
めごち	雌鯒
めぐろ	目黒
めぐむ	萠	恵
めぐみ	恵	惠	慈	恵美	めぐ美	愛美
めくら	目眩	盲
めくば	目配
めくち	目口
めくそ	目糞	目屎	目クソ	目くそ
めくぎ	目釘
めぎれ	目切れ
めぎみ	妻君	女君
めぎか	Berberidaceae	メギ科
めきき	目利き
めがわ	女川
めがみ	女神
めがね	眼鏡
めがお	目顔
めかま	目蒲
めかぶ	和布蕪	雌株
めかど	目角
めかた	目方
めかけ	妾
めかく	目隠
めおと	娚	夫婦
めおし	目押し
めうつ	目移
めうち	目打	目打ち
めうし	牝牛	雌牛
めうえ	目上
めいわ	明和
めいろ	目色	迷路
めいる	滅入る
めいり	名利
めいよ	名誉
めいゆ	明喩
めいむ	迷夢
めいみ	芽美
めいぼ	名簿
めいふ	冥府
めいび	名媚	明媚
めいば	名馬
めいど	冥途	冥土	明度
めいち	命知	明智	明知
めいだ	銘打
めいた	目板
めいじ	明治	名辞	明示
めいし	名刺	名士	名詞	名氏	明視
めいご	明午	迷語
めいこ	茗子
めいけ	女池	名家
めいく	名句
めいぎ	名妓	名義
めいき	銘器	銘記	名器	名機	銘機	明記
めいが	名画
めいか	銘菓	名歌	名家	名花	名菓
めいう	銘打
めいい	名医
めあわ	娶
めあて	貭	目当て
めあき	目明き
むろん	無論
むろや	室哉	室谷	室屋
むろみ	室見
むろね	室根
むろと	室戸
むろつ	室津
むろた	室田
むろが	室賀
むろか	無濾過
むろう	室生
むろい	室井
むれい	牟礼
むるい	無類
むりょ	無慮
むりじ	無理強
むりし	無利子
むらの	村野
むらち	村地
むらた	邑田	村田
むらせ	村瀬
むらじ	連	村地
むらき	村木
むらお	村尾	村生
むらい	村井
むよく	無欲	無慾
むよう	無用
むゆう	夢遊
むやみ	無闇
むやま	無山
むやく	無役	無益
むもん	無文	無紋
むもう	無毛
むめい	無銘	無名
むぼう	無謀	無帽
むほん	謀叛	謀反
むほう	無法
むへん	無辺
むふか	無負荷
むふう	無風
むひつ	無筆
むばつ	無罰
むはい	無敗	無配
むのう	無能
むねん	無念
むねや	胸焼
むねだ	宗田
むねた	崇田
むねお	宗夫	宗男	宗雄
むねあ	棟上
むにき	無に帰
むなち	胸乳
むなせ	皆瀬
むなげ	胸毛
むなぎ	棟木
むどく	無毒
むどう	無道	武堂
むとど	無届
むとく	無徳
むとう	無糖	無答	武藤	無頭
むでん	無電
むてき	無敵	霧笛
むづか	難	憤
むつよ	睦予
むつみ	睦美	睦つ美	睦都美	六実	睦
むつび	睦び
むつこ	睦子
むつき	睦月	襁褓	睦紀
むつか	難
むつお	睦夫
むつう	無痛
むっつ	六つ
むちん	無賃
むちゃ	無茶
むちく	無畜
むちう	鞭	鞭打
むだん	無断
むだげ	無駄毛	徒毛	ムダ毛
むだい	無題	無代
むたい	無体
むそじ	六十路
むそう	無想	無双	夢想
むぜい	無税	無勢
むせん	無銭	無線
むせき	無籍
むせい	夢精	無声	無性
むずか	難	憤
むすめ	娘
むすび	結び
むすこ	息子
むすう	無数
むすい	無水
むじん	無尽	無人
むじひ	無慈悲
むじな	豸	貉
むじつ	無実
むじこ	無事故
むしん	無心
むしろ	莚	筵	寧ろ	蓆
むしよ	虫除
むしゅ	無主
むしゃ	武者
むしぼ	虫干
むしば	蠹	蝕	虫歯	蠧
むしと	虫取
むしず	虫唾	虫酸
むしけ	虫気
むしく	虫食
むしき	蒸し器	無支奇
むざん	無残	無惨
むざつ	無雑
むざい	無罪
むさん	霧散	無産
むさぼ	貪
むさつ	無札
むさし	武蔵
むさく	無策
むさい	無才
むごん	無言
むこん	無根
むこく	無告
むこう	向日	無功	無向	無効	向う	向こう
むげん	∞	夢幻	無限	無幻
むげい	無芸
むけん	無間	無券
むけつ	無欠	無血
むけい	無茎	無形
むぐら	葎
むくろ	躯	骸
むくみ	浮腫
むくな	椋名
むくち	無口
むくだ	椋田
むくげ	葮	槿	毳
むくい	報
むぎゆ	麦湯
むぎや	麦谷
むぎこ	麦粉
むきん	無菌
むきだ	剥き出
むきず	無傷
むきえ	向江
むきあ	向き合
むがく	無学
むがい	無害	無蓋
むかん	無冠	無官	無感
むかわ	武川	鵡川
むかひ	無花被
むかで	蜈蚣	百足
むかち	無価値
むかし	昔
むかご	零余子
むかか	無花果
むかえ	迎え	迎
むかい	向かい	向井	迎	向
むおん	無音
むおう	夢奥
むえん	無鉛	無塩	無援	無煙	無縁
むえき	無益
むいん	無韻
むいみ	無意味
むいか	六日	6日	６日
みんわ	民話
みんぶ	民部
みんな	皆	皆な
みんど	民度
みんだ	民田
みんそ	民訴
みんじ	民事
みんし	明史
みんぐ	民具
みんか	民家
みんい	民意
みわだ	三輪田
みわた	見渡	三輪田
みわす	見忘
みわこ	美和子
みわけ	見分け	見分
みわく	魅惑
みろく	彌勒	弥勒
みれん	未練
みれい	美麗
みるめ	見る目
みりん	味醂	未林
みりは	ミリ波
みらの	未蘭
みらい	未来	味蕾
みより	身寄り
みよた	御代田
みよし	三吉	三次	三膳	三芳	三好	三善
みよこ	美代子
みよう	見様
みょう	冥	名	螟	妙	命	明	榠
みゆき	美有紀	美由起	深雪	行幸	幸	美由紀	美幸	み雪	御幸	美由希	美雪
みゆう	美憂
みゅう	μ
みゅー	μ
みやら	宮良
みやみ	未也美
みやま	三山	深山	美山	海山
みやべ	宮部
みやぶ	見破
みやび	雅
みやの	宮野
みやと	宮戸
みやづ	宮津
みやぢ	宮地
みやち	宮地
みやた	宮田
みやせ	宮瀬
みやす	見易
みやじ	宮地	宮路
みやご	三八五
みやこ	宮子	宮古	都	美弥子	美也子	宮戸	京都
みやげ	土産
みやけ	宮家	三宅
みやく	未訳
みやぎ	宮城	宮木
みやき	宮木
みやお	宮尾
みやい	宮井	宮居
みゃく	脉	脈
みもん	未聞
みもり	未森	深森
みもの	見物	実物
みもと	身元
みもち	身持	身持ち
みもだ	身悶
みもう	味盲
みめよ	見目好
みめい	未明
みむろ	三室
みむら	三村
みみわ	耳輪
みみよ	耳寄
みみな	耳慣	耳馴	耳鳴
みみず	蚯蚓
みみか	耳掻
みみう	耳打
みまん	未満
みまわ	見回
みまも	見守
みまね	見真似	見まね
みまな	任那
みまつ	三松
みまた	三股
みまき	御牧
みまが	見紛
みまか	身罷
みまい	見舞い	見舞
みほん	見本
みほろ	美浦
みほた	三保田
みほこ	美穂子	美保子	美帆子	三穂子
みへん	身偏
みぶん	身分	未分
みぶる	身震
みぶり	見ぶり	身振	身振り
みぶな	壬生菜
みふね	御船	三船
みふじ	美富士
みひら	三平	見開
みひつ	未必
みばん	三晩
みばえ	見映え	見栄え
みはる	三春	美晴	見張る	美春
みはり	見張り
みはら	美原	見晴	三原	未払
みはま	御浜	美浜
みはな	見放
みはつ	未発
みはっ	見張
みはた	御旗
みはじ	見始
みはし	三橋
みはか	見計
みはい	未配
みのわ	蓑輪	箕輪
みのる	實	実	穣	稔
みのり	美野里	御法	稔	実り
みのべ	美濃部
みのぶ	美乃夫	身延
みのと	美濃戸
みのだ	箕田	蓑田	簑田
みのげ	蓑毛
みのけ	身の毛
みのが	見逃
みのお	箕面
みのう	箕面	未納	美濃
みねの	峯野
みねこ	峰子
みねお	峰央	峰夫	実音夫	岑夫	峰雄	岑生	峯夫
みねう	峰打
みねい	嶺井
みにつ	身に付
みにく	見難	儖	醜
みにい	見に行
みなわ	水泡
みなり	身形	身なり
みなら	見習
みなよ	美奈代
みなも	水面
みなみ	皆実	美並	美波	南美	南	三波
みなべ	南部
みなの	皆野
みなと	港	湊
みなつ	美夏
みなせ	水無瀬
みなす	皆好
みなこ	三奈子	みな子	美奈子	美名子	美菜子	実奈子	皆子
みなげ	身投げ
みなぎ	漲
みなお	見直
みなえ	美奈江
みない	美内	南井
みどり	美登里	緑	美土里	碧	翠
みども	身共
みどし	巳年
みどく	未読	味読
みどう	御堂
みとり	見取
みとよ	三豊
みとや	三刀屋
みとめ	認め	三留
みとみ	三富
みとど	見届
みとせ	三年
みとし	水戸市
みとけ	水戸家
みとく	味得
みとが	見咎
みとお	見通
みとう	未踏	未到	美東	見通	見透
みてと	見て取
みてこ	見て来
みてく	見て来	見て呉
みてき	見て来
みてい	未定
みづら	見辛
みづの	美津濃
みづち	蛟
みづき	観月
みづか	自
みつわ	三輪
みつる	満	滿	充	美弦
みつよ	光代	光世
みつゆ	密輸
みつや	三矢	三ッ矢
みつも	見積
みつめ	三つ目
みつば	三葉
みつど	密度
みつづ	見続
みつだ	満田	光田
みつた	光田
みつせ	三瀬	光瀬
みつじ	密事	光地
みつご	蜜語	三子	三つ子
みつこ	光子	三津子	満子	美都子	充子	美津子
みつけ	見附	見付
みつぐ	貢
みつく	見尽
みつぎ	調	三ッ木	密議	密儀	三ツ木
みつき	観月	美月
みつが	密画
みつか	見付か
みつお	光穂	満男	光雄	三雄	充雄	光男	満雄	光夫	三男	光生	満夫	三夫
みつえ	光枝	光江	御杖	光恵
みつい	三井
みっつ	3つ	三つ	３つ
みっそ	密訴
みっし	密使
みっか	三日	３日	3日
みぢか	身近
みちる	未散	未知瑠
みちよ	通代	美千代	三千代	美千世	路代	道世	満代	道代	美智代
みちゆ	道行
みちむ	道向
みちべ	道辺
みちび	導
みちひ	満ち干
みちば	道場
みちづ	道連
みちた	満ち足	道田
みちご	未知語
みちこ	三智子	美千子	道子	美智子	光知子	通子	美知子	満子	倫子	路子
みちが	見違
みちか	美智香
みちお	通夫	三千夫	道生	道夫	三千雄	道央	道雄	道男
みちえ	道恵	美智恵
みだれ	乱れ
みだら	婬
みだし	■	◇	＊	見出し	※
みだい	見台	御台
みため	見た目
みたま	御霊	三珠
みたび	三度
みたに	三谷	見谷
みたて	御館	見立て
みたけ	三岳	身丈	御岳	三嶽	御嵩
みたか	三鷹
みぞれ	霙
みぞべ	溝辺
みぞて	溝手
みぞた	溝田
みぞう	未曾有
みぞい	溝井
みそん	見損
みそら	身空	美空
みその	三園	御園	美薗
みそに	味噌煮
みそづ	味噌漬
みそじ	三十路
みそこ	見損
みそぎ	禊
みそか	晦日	三十日	晦
みそう	未送
みぜん	未然
みぜに	身銭
みせや	店屋
みせば	見せ場
みせつ	見せ付	未設
みせか	見せ掛
みずわ	水割
みずら	髻	鬟
みずよ	瑞代
みずや	水屋
みずも	水漏
みずま	水撒	三潴	水間	水増
みずほ	瑞穂
みずべ	水辺
みずば	水場
みずは	水捌
みずの	水野
みずに	水煮
みずな	水菜
みずち	蛟
みずだ	水出
みずた	水炊	水田
みずぜ	水責	水攻
みずせ	水瀬
みずし	瑞史
みずこ	水子
みずけ	水気
みずぎ	水着
みずき	水城	水切	水樹	未図紀	美寿紀	瑞希	水木	瑞季	瑞木
みずが	水涸
みずか	自
みずお	瑞生	瑞男
みずえ	瑞江	瑞枝	水絵
みずい	水井	水入
みずあ	水浴	水揚
みすみ	三隅	三角
みすず	美鈴	三鈴
みすじ	三筋
みすご	見過
みすぎ	美杉
みすか	見透	美須賀
みすえ	御末	三末
みすい	未遂
みじん	微塵
みじめ	惨め
みじか	身近	短
みしま	三島	三嶋
みしな	三品
みしお	美潮
みさわ	三沢	三澤
みさと	美郷	美里	三郷	箕郷
みさだ	見定
みささ	三笹	三篠	三朝
みさご	雎鳩	鶚
みさこ	美砂子	美沙子	美佐子	美咲子
みさき	岬	御前	美咲	三崎	美沙紀	崎	三咲
みさか	三阪	御坂
みさお	美沙緒	操
みさい	未済
みごろ	見殺	見頃
みごも	妊	身籠
みごと	見事
みごた	見応
みこん	未婚	未墾
みこみ	見込み	見込
みこと	三言	命	尊	美琴
みこし	御輿
みこう	未稿
みけん	未見	眉間
みけつ	未決
みけた	三桁
みぐる	見苦
みぐし	御髪
みくら	見較	見比
みくも	三雲
みくま	三隈
みくに	三國	皇國	御国	御國	三国
みくち	三口
みくだ	見下
みぎわ	水際	頻	汀
みぎり	砌
みぎや	→	⇒	右矢
みぎめ	右目
みぎて	右手
みぎず	右図
みぎこ	右子
みぎき	右利
みぎが	右書
みきわ	見極
みきり	見切り
みきよ	幹代
みきや	御喜家	幹哉
みきほ	美喜帆
みきこ	幹子	美希子	美貴子	美紀子	実希子	美樹子
みきき	見聞き
みきお	幹雄	三起男	幹夫	幹男
みがわ	身代
みがる	身軽
みがら	身柄	見柄
みがま	身構
みがた	身固
みがく	研
みかん	未完	蜜柑	味感	未刊
みかわ	実川	三加和	美川	見川	三河	三川
みかり	美加理
みかも	美甘	三加茂
みかめ	三瓶
みかみ	三上	三神	見上
みかほ	美華保
みかど	御門	帝	三門
みかだ	三ヶ田
みかた	見方	三方	美方	味方
みかさ	三笠
みかこ	美佳子	美加子	美香子
みかげ	御蔭	御影
みかけ	見掛け	見かけ
みかく	味覚
みかぎ	見限
みかえ	見返
みかい	味解	未開
みおわ	見終
みおり	美織
みおも	身重
みおぼ	見覚
みおと	見落	見劣
みおこ	美央子
みおく	見送
みえみ	見え見
みえだ	三枝
みえす	見え透
みえこ	三恵子	美枝子	三枝子	三重子	実枝子	美恵子
みうり	身売り	身売
みうら	三浦
みうち	身内	御内
みうご	見動	身動
みうけ	身請	身請け
みいり	実入り
みいら	木乃伊
みいつ	御稜威
みいだ	見出
みいし	御石
みいけ	三池
みあわ	見合
みあま	三甘
みあた	見当
みあさ	美麻
みあげ	見上
みあけ	三宅
みあい	美合	見合い	見合
まんぽ	漫歩
まんぷ	漫符
まんぶ	万部
まんぱ	万波
まんば	万場	漫罵	万馬
まんと	満都
まんち	満地
まんた	万太
まんず	萬子
まんじ	卍	万治
まんざ	満座	万座
まんこ	万個
まんき	満期
まんが	漫画	萬画
まわり	回り	周り	廻り
まわた	真綿
まわし	廻	回し
まれき	希樹
まるわ	丸和
まるや	丸焼	丸谷	丸屋
まるめ	丸め
まるみ	円美	丸見
まるひ	丸秘	マル秘
まるの	丸野
まるに	丸煮
まるな	丸投
まるだ	丸出
まるた	丸太	丸田
まるこ	丸子
まるき	丸木
まるが	丸刈
まるか	満留賀
まるお	丸尾	丸生	円尾
まるい	丸井
まりん	まりン
まりも	毬藻
まりな	満里奈
まりこ	マリ子	満利子	真里子	万里子	真梨子	麻理子	茉里子	真理子	まり子	真璃子	真利子	丸子	麻里子	鞠子
まりお	麻利夫	真理雄	眞理雄
まりえ	麻里絵	鞠絵	真理恵	真理絵
まりい	麻利衣
まりあ	万梨阿	真里亜	真利亜
まらや	馬來
まよこ	真横
まよけ	魔除け
まよい	迷い
まゆみ	真弓	真祐美	檀	万友美	誠由美	真由美	雅弓	魔弓	麻由美
まゆね	眉根
まゆこ	眉子	繭子	万由子	真由子
まゆげ	眉毛
まやま	真山	間山
まやべ	真矢部
まやこ	麻也子
まやく	麻薬	痲薬
まやか	瞞
まもる	守	衛	衞
まもり	護	守り	護り
まもの	魔物
まもな	間も無
まもう	磨耗	摩耗
まめや	豆屋
まめつ	磨滅	摩滅
まめだ	豆田
まめか	マメ科	豆科
まむし	蝮
まむき	真向き
まみや	間宮	魔実也
まみな	真美奈
まみず	真水
まみこ	麻巳子	真美子	麻美子
ままこ	継子
まほろ	真帆呂
まほか	真帆香
まほう	魔法
まぶね	馬槽
まぶに	摩文仁
まぶち	馬淵	馬渕
まぶた	瞼	目蓋
まぶか	目深
まふゆ	真冬
まふね	真船
まびき	間引き	間引
まひわ	真鶸
まひる	真昼
まひと	真人
まばら	疎ら	疎
まばゆ	目映	眩
まばた	瞬
まばし	馬橋
まのび	間延	間延び
まのて	魔の手
まのあ	目の当
まねび	学び
まぬけ	間抜け
まぬが	免
まぬか	免
まにわ	真庭
まにら	馬尼剌
まにし	真西
まにう	真に受
まにあ	間に合
まなみ	真奈美	愛美	真名美
まなべ	真部	真鍋
まなぶ	學	斈	学
まなび	愛日	学び
まなつ	真夏
まなざ	目差
まなご	真砂
まなこ	眼
まなか	愛香	真中
まどろ	微睡
まどり	間取り
まどべ	窓辺
まどが	窓掛
まどか	窓掛	円	円か
まどお	間遠
まどう	魔導	魔道
まとり	真鳥
まとや	的矢
まとも	真艫	真面
まとむ	統
まとば	的場
まとう	纏う
まとい	纒	纏	纒い
まてき	魔笛
まつろ	末路
まつり	祭	祀	祀り	祭り
まつら	松浦
まつや	松屋
まつも	松藻
まつみ	松見
まつび	末尾
まつば	松葉
まつの	松野	松乃
まつね	松根
まつど	松戸
まつち	真土
まつだ	松田
まつた	松田
まつじ	末寺
まつざ	末座
まつご	末期
まつげ	睫	睫毛
まつき	松木
まつお	松男	松尾	松雄	松夫
まつえ	松江
まつい	松為	末位	松井	松居
まっぱ	末派
まっと	全
まっち	燐寸
まった	全	待った
まっせ	末世
まっす	真っ直
まっし	末子
まっき	末期	末岐
まっか	真っ赤	真赤
まぢか	間近	真近
まちや	町屋	町家	町谷
まちぶ	待ち伏
まちの	街乗	町野
まちだ	町田
まちこ	麻知子	磨智子	街子	待ち焦	真知子	満智子	町子	眞智子
まちく	麻竹
まちが	間違
まちか	間違	待ち兼
まちう	待ち受
まちい	町井
まちあ	待合	待ち合	待ち明
まだる	間怠
まだら	斑	真鱈
まだし	未だし
まだこ	真蛸
まだい	真鯛
またま	真玉
または	又は
またの	俣野
またた	瞬
またぎ	又聞
またが	又貸	又借
まそん	摩損
まぜが	交ぜ書
まぜあ	混ぜ合
ませき	魔石
まずい	不味い
ますや	升谷
ますめ	枡目	升目	桝目
ますみ	益美	満寿美	眞澄	萬純	真純	真澄	増実	真寿
ますほ	増穂
ますの	増野
ますど	益戸
ますだ	升田	舛田	益田	増田	桝田
ますじ	鱒二
ますこ	万寿子	益子	増子
ますき	増木
ますお	満寿夫	増尾	益夫	満洲雄
ますい	麻酔	魔酔	痲酔	魔睡	桝井	増井
まじん	魔神	魔人
まじろ	瞬
まじり	交じり
まじょ	魔女
まじめ	真面目
まじま	真島	間島	間嶋
まじな	呪
まじき	間仕切
まじか	間近	真近
ましん	麻疹	真芯
ましら	猿
ましゅ	魔手
ましも	真下
ましば	間柴	真柴
ましど	益戸
まして	増して	況して
ました	真下	間下	増田
ましこ	益子	猿子	増子
ましけ	増毛
ましき	益城
ましお	真潮
まさる	勝	秀	賢	太	大	優
まさよ	真砂代	正代	雅代	昌代
まさや	昌也	正弥	正也	昌哉	正哉	雅哉	匡哉	雅也
まさめ	正目	正眼	柾目
まさみ	正己	雅美	真己	雅三	政美	昌未	公美	雅己	昌己	昌巳	雅巳	正実	眞美	正巳	正美	雅実	昌美
まさの	雅野
まさに	正に
まさな	雅名
まさと	正人	真人	政人	雅斗	雅人	雅刀	昌人
まさつ	摩擦
まさじ	政司	雅二	正治	正次	政治	政次
まさし	正史	正	雅史	将司	正志	昌士	政司	雅志	仁	将	祐史	雅士	正司	昌嗣	将史	雅司	政志	昌	將	匡史	真史	政資	真志	昌史	昌志	匡
まさご	真砂
まさこ	真紗子	真佐子	雅子	昌子	真砂子	真沙子	正子	正沙子	政子	晶子	眞砂子	まさ子	誠子
まさぐ	弄
まさき	公輝	誠樹	雅樹	正規	正毅	正宣	正樹	昌樹	真樹	政樹	仁樹	眞希	眞幸	雅基	政輝	正木	昌己	政木	真咲	昌毅	正記	正紀	正輝	正喜	正揮	松前	真先	正基	真幸	真崎
まさか	雅香
まさお	政雄	征男	雅勇	雅男	昌男	政夫	昌生	方夫	政男	正雄	正夫	誠夫	昌夫	将生	雅夫	正男	眞生	雅雄	希男	真夫
まさえ	優江	雅江	正恵	正江	昌枝	雅恵
まごめ	馬込	馬籠
まごび	孫引
まごこ	孫子
まごい	真鯉
まこと	真湖人	信	真	誠	真人	実	眞	真琴	亮	純	誠人
まこう	磨香
まげは	曲げ波
まけん	魔剣
まけこ	負け越
まぐわ	耙
まぐろ	鮪
まぐれ	紛れ
まぐち	間口
まぐそ	馬糞
まぐし	馬櫛
まぐさ	秣	芻	蒭
まくら	枕
まくや	幕屋
まくま	幕間
まくつ	魔窟
まくぎ	幕切
まくあ	幕開
まぎわ	真際	間際
まぎれ	紛れ
まぎら	紛ら
まきわ	薪割
まきば	牧葉	牧場
まきの	槙野	牧野
まきつ	巻き付
まきち	撒き散
まきた	牧田	蒔田	真北
まきぞ	巻き添
まきせ	牧瀬
まきこ	真紀子	真貴子	巻き込	真木子	真樹子	麻起子	眞紀子	麻紀子	真生子	真希子	正希子	牧子	真喜子	万紀子	マキ子	満喜子	満紀子
まきげ	巻毛	巻き毛
まきお	真樹夫	牧尾	牧朗	真紀夫
まきえ	撒き餌	蒔絵
まきあ	巻き上
まがり	間借り
まがら	真柄
まがも	真鴨
まがた	澗潟
まがし	間貸し
まがき	籬
まがお	真顔
まがい	紛い	擬	紛
まかり	真狩
まかべ	真壁
まかな	賄
まかせ	任せ
まかず	間数
まかお	澳門
まかい	魔界
まおう	魔王
まえわ	前輪
まえむ	前向
まえみ	真恵美
まえほ	前穂
まえぶ	前触
まえふ	前振
まえび	前日
まえば	前歯	前場
まえの	前野
まえづ	前付
まえち	前地
まえだ	前田	前多
まえじ	前地
まえが	前書	前貸	前借
まえか	前掛
まえお	前尾	前置
まえう	前売
まうら	真裏
まうち	間内
まうえ	真上
まいる	哩
まいよ	毎夜
まいや	米谷	毎夜
まいめ	枚目
まいど	毎度
まいち	舞い散
まいだ	枚田
まいた	毎田	舞い立
まいじ	毎次	毎時
まいし	昧死
まいご	迷子
まいこ	舞妓	麻衣子	舞子	毎戸	舞い込	磨衣子	舞姑
まいき	毎期
まいか	真烏賊
まいお	舞い落	舞い降
まいあ	舞い上	舞上
まあじ	真鰺
まあこ	真亜子
まあい	間合	間合い
まーぼ	麻婆
もんよう	紋様	文様
もんもん	悶々
もんもう	文盲
もんべつ	紋別	門別
もんぷく	紋服
もんばん	門番
もんばつ	門閥
もんなし	文無し
もんない	門内
もんどう	問答
もんとう	門灯
もんでん	門田
もんてい	門弟
もんつき	紋付
もんだい	問題
もんぜん	文選	門前
もんぜつ	悶絶
もんぜき	門跡
もんせん	門扇
もんせき	問責
もんせい	門生
もんじん	門人	問訊
もんじょ	文書
もんじゅ	文珠	文殊
もんしん	問診
もんざい	問罪
もんさつ	門札
もんごん	文言
もんこく	旺角
もんげん	門限
もんくな	文句無
もんきり	紋切り	紋切
もんがく	文覚
もんがい	門外
もんかん	文観	門鑑
もんかく	門客
もんおり	紋織
もんえい	門衛
もろやま	毛呂山
もろもろ	諸	諸々
もろむき	諸向き	双向き
もろぼし	諸星
もろほし	諸星
もろびと	諸人
もろひざ	諸膝
もろはだ	諸肌
もろはし	諸橋	師橋
もろどみ	諸富
もろとも	諸共
もろつか	諸塚
もろずみ	両角	双墨	諸角
もろさと	諸里
もろごえ	諸声
もろごい	諸恋
もろこし	蜀黍
もろくち	諸口
もろおか	師岡	師丘	諸岡
もろえや	諸江屋
もりわけ	守分
もりわき	森脇
もりわか	森若
もりよし	守克	森吉
もりゆき	森雪
もりやま	森山	守山
もりやす	森保	森安	守安
もりやく	守役
もりもと	守本	盛本	森本
もりむら	森村
もりみつ	森光
もりみち	守倫	守通
もりまつ	森松
もりびと	守人
もりひろ	護煕	守弘
もりひこ	守彦
もりばん	森番
もりばな	盛り花	盛花
もりばち	盛り鉢	盛鉢
もりのぶ	森信
もりなが	森永
もりとも	守友
もりとし	守利
もりとお	盛遠
もりとう	森藤
もりてん	森店
もりつち	盛り土
もりつけ	盛り付け
もりつぐ	森嗣
もりつか	杜塚
もりたに	森谷	守谷
もりたか	森高
もりぞの	森園
もりぞう	森蔵
もりそば	盛蕎麦
もりすみ	森住
もりすえ	森末
もりじり	森尻
もりじお	盛塩	盛り塩
もりしま	森嶋	森島
もりした	森下
もりしげ	護重	森重
もりさわ	森沢
もりさと	森里
もりさだ	森定
もりさき	森崎
もりけい	森景
もりぐち	守口	森口
もりくら	森蔵
もりくち	森口
もりきり	盛切り
もりきよ	森清
もりきた	森北
もりがき	森垣
もりかわ	森川	守川	森河
もりかず	盛和
もりかげ	森景
もりかえ	盛り返
もりおか	盛岡	守岡	森岡	森丘
もりえだ	森枝
もりうち	森内
もりいで	森出
もりあわ	盛合
もりあげ	盛り上げ
もりあき	守章
もりあが	盛り上
もりあい	盛合
もらいゆ	貰い湯
もらいび	貰い火
もらいて	もらい手	貰い手
もらいご	貰い子
もらいう	貰い受
もよおし	催し
もようが	模様替
ももわれ	桃割れ
ももやま	桃山
ももむら	百村
ももみみ	桃耳
ももひめ	桃姫
ももひき	股引
もものき	桃の木
ももにく	モモ肉	腿肉
ももだに	桃谷
ももぞの	桃園
ももざき	百崎
ももさき	桃崎
ももかわ	桃川	百川
ももうち	桃内
ももいろ	桃色
ももいし	百石
もめごと	揉事	揉め事
もみほぐ	揉み解
もみぬか	籾糠
もみつぶ	揉み潰
もみだね	籾種
もみぞく	Abies	モミ属
もみすり	籾摺り
もみごめ	籾米
もみがら	籾殻
もみあげ	揉み上げ
もみあい	揉み合い
ものわび	物侘
ものわす	物忘
ものやわ	物柔
ものもの	物々
ものもち	物持	物持ち
ものまね	物真似	物まね
ものまえ	物前
ものほし	物干	物干し
もののべ	物部
もののふ	武士
もののけ	物怪	物の怪
ものども	者共
ものとり	物取り
ものだね	物種
ものたち	者達
ものずき	物好き
ものすご	物凄
ものしり	物知り
ものしず	物静
ものさび	物淋	物寂
ものさし	物差し	物指	物指し
ものごと	物事
ものごし	物腰	物越し
ものごい	物乞い	物乞
ものぐさ	懶
ものぎわ	物際
ものがな	物悲
ものがた	物語
ものかず	物数
ものかげ	物影	物陰
ものかき	物書き
ものおも	物思
ものおぼ	物覚
ものおと	物音
ものおぢ	物怖
ものおじ	物怖	物怖じ
ものおき	物置
ものうり	物売り
ものうち	物打	物打ち
ものうげ	物憂げ
ものうい	懶い	物憂い
ものいり	物入り
ものいみ	物忌み
ものいい	物言い
もどりち	戻り値	戻値
もとよし	本吉	元慶	元吉	基良	基吉
もとゆき	幹之	基之
もとゆい	元結
もとやん	元ヤン
もとやま	元山	本山
もともと	元々	基々
もとめあ	求め合
もとむら	本村
もとみや	本宮
もとみち	素道
もとまち	元町
もとふみ	元文
もとひろ	基史	礎弘	元洋	基博
もとひで	元秀	元英
もとひさ	基久	幹久	元久
もとひこ	元彦
もとばこ	元箱
もとはる	元春
もとはら	本原
もとはま	元浜
もとはし	本橋
もとのり	一徳	素典	元紀
もとのぶ	元信
もとねた	元ネタ
もとなり	本成り	元成	本生り	元就
もとなが	源久
もとどり	髻
もとどお	元通
もとでら	元寺
もとちじ	元知事
もとだか	元高
もとただ	元正
もとたか	元孝	基隆
もとせん	元栓
もとすこ	本栖湖
もとすえ	本末
もとじめ	元締	元締め
もとじま	本島
もとしげ	元重
もとざわ	本澤
もとさと	理元
もとごえ	基肥
もとぎぼ	元義母
もときん	元金
もときじ	元記事
もとかわ	本川
もとかれ	元カレ
もとかの	元カノ
もとかど	本門
もとかず	元一
もとおり	本居
もとおか	元岡
もとえい	基栄
もとうり	元売り
もとうた	元歌
もとうけ	元請け
もといれ	元入れ
もといせ	元伊勢
もといし	本石	元石
もといけ	本池
もとあり	本有
もとあき	元明	元昭
もでるか	モデル化
もてはや	持て栄	持て囃
もてあま	持て余
もてあそ	玩	弄
もつれこ	縺れ込
もつやく	没薬
もつなべ	もつ鍋	モツ鍋
もっぱら	専ら
もっとも	尤も	最も
もったい	勿体
もっこん	目今
もっこつ	木骨
もっこう	木瓜	木工	黙考
もっけい	木鶏	黙契
もっきん	木琴
もっきょ	黙許
もっきつ	勿吉
もっかん	木簡	木管
もっかく	木槨
もっかい	黙会
もちろん	勿論
もちゅう	喪中
もちもの	持物	持ち物
もちむね	用宗
もちまわ	持ち回
もちまる	持丸
もちまえ	貭	持ち前
もちぶん	持分	持ち分
もちふだ	持ち札
もちひろ	望洋
もちばん	持番
もちはだ	餅肌	餅膚
もちはこ	持ち運
もちぬし	持主	持ち主
もちにげ	持逃げ
もちなお	持ち直
もちてん	持ち点
もちづき	餅月	望月
もちつづ	持ち続
もちつき	餅搗き	餅つき
もちだし	持ち出し
もちだい	餅代
もちずき	望月
もちごめ	糯米	糯	餅米
もちごま	持駒
もちこみ	持ち込み	持込
もちこた	持ち堪
もちこし	持越
もちげい	持ち芸
もちぐさ	持ち腐
もちくず	持ち崩
もちきり	持ち切り
もちがね	持ち金
もちがせ	用瀬
もちがし	餅菓子
もちかぶ	持株	持ち株
もちかた	持ち方
もちかえ	持ち帰
もちうた	持ち歌
もちいえ	持ち家
もちあわ	持ち合
もちある	持ち歩
もちあみ	餅網
もちあじ	持ち味
もちあい	持合
もぞうし	模造紙
もせうし	妹背牛
もすくわ	莫斯科
もじわく	文字枠
もじれつ	文字列
もじよう	文字用
もじみと	文字認
もじぶん	文字分
もじばん	文字盤	文字版
もじばけ	文字化け
もじはば	文字幅
もじどお	文字通
もじづら	文字面
もじすう	文字数
もじしゅ	文字種
もじした	文字下
もじしき	文字式
もじごと	文字毎
もじこう	門司港
もじぐん	文字群
もじがた	文字型
もじかん	文字間
もじおち	文字落
もじえき	門司駅
もじいち	文字位置
もじいか	文字以下
もしょう	喪章
もしくは	若しくは
もしきず	模式図
もしきか	模式化
もけいや	模型屋
もけいず	模型図
もけいか	模型化
もぐりこ	潜り込
もくろん	目論
もくろみ	目論見
もくろく	目録	黙録
もくれん	木蓮
もくれい	目礼	黙礼
もくらん	木蘭
もくよく	沐浴
もくよう	木曜
もくやく	黙約
もくもく	黙々
もくほん	木本
もくへん	木片
もくはん	木版
もくねん	黙念	黙然
もくにん	黙認
もくどく	黙読
もくとう	黙祷
もくてき	目的
もくだく	黙諾
もくたん	木炭
もくぞう	木像	木造
もくそく	目測
もくそう	目送	黙想
もくぜん	黙然	目前
もくせい	木製	木犀	木星	木精
もくじき	木食
もくしつ	木質
もくざい	木材
もくさん	目算
もくさつ	黙殺
もくさく	木酢	木柵
もくげき	黙劇	目撃
もくぐん	目群
もくぐう	木偶
もくぎょ	木魚
もくきん	木金
もくがす	木ガス
もくかい	黙会
もくあみ	木阿弥	黙阿弥
もぎどう	没義道
もぎてん	模擬店
もぎせん	模擬戦
もぎけい	模擬系
もおかし	真岡市
もえさか	燃え盛
もえがら	燃え殻
もえうつ	燃え移
もうろく	耄碌
もうろう	朦朧
もうれつ	猛烈
もうよう	網様
もうゆう	猛勇
もうもん	網紋
もうもく	盲目
もうもう	濛々	濛濛
もうまく	網膜
もうまい	曚昧	矇昧	濛昧	蒙昧
もうほう	毛包
もうひつ	毛筆
もうぱい	盲牌
もうばく	猛爆	盲爆
もうはつ	毛髪
もうのう	毛嚢
もうねん	妄念
もうない	網内
もうどく	猛毒
もうどう	盲導	艨艟	妄動
もうとく	孟徳
もうとう	毛頭
もうてん	盲点
もうつい	猛追
もうだん	妄断
もうたい	毛帯
もうそう	妄想	網総
もうぜん	猛然
もうせん	毛氈
もうせつ	妄説
もうせい	猛省
もうじん	盲人	蒙塵
もうじゃ	亡者	盲者
もうしん	盲信	盲進	猛進	妄信
もうしわ	申し分
もうしょ	猛暑
もうしゃ	猛射	盲者
もうしの	申し述
もうしで	申し出
もうしつ	申し付
もうした	申し立	申立
もうしそ	申し添
もうしご	申し子
もうしこ	申込	申し込
もうしか	申し兼
もうしう	申し受
もうしい	申し入
もうしあ	申し合	申し上
もうさい	毛細
もうこん	毛根
もうこは	猛虎派
もうこう	猛攻
もうげん	妄言
もうけん	猛犬
もうきん	猛禽
もうかん	毛管
もううん	妄雲
もうあく	猛悪
もうあい	妄愛	盲愛
めんるい	麺類
めんよう	綿羊	面容	緬羊	面妖
めんもく	面目
めんもう	綿毛
めんめん	面面	面々	綿々
めんみつ	綿密
めんぽお	面頬
めんぽう	面皰
めんぼく	面目
めんぼう	綿紡	綿棒	麺棒	面貌
めんない	面内
めんどり	雌鳥
めんどう	面堂	面倒
めんとり	面取り
めんとう	面頭
めんでん	免田
めんてい	免停	面体
めんつゆ	麺つゆ
めんだん	面談
めんたい	面対	面体
めんそう	面相
めんぜん	面前
めんぜい	免税
めんせつ	面接
めんせき	面積	免責
めんせい	面性
めんすう	面数
めんじょ	免除
めんしん	免震
めんしゃ	綿紗
めんしき	面識
めんざい	免罪
めんくら	面喰
めんくい	面食い	面食
めんぎょ	面魚
めんきょ	免許
めんきつ	面詰
めんかん	免官
めんかい	面会
めんえき	免疫	免役
めんいつ	面一
めんあつ	面圧
めりょう	馬寮
めりはり	減り張り	乙張	減張
めもめも	\(\.\.\)φ
めめしい	女々しい
めまとい	目纏い
めまぐる	目紛
めはちぶ	目八分
めのまえ	目の前
めどおり	目通り
めでとう	目出当
めづまり	目詰まり	目詰り
めつれつ	滅裂
めつぼう	滅亡
めつじん	滅尽
めつざい	滅罪
めっぽう	滅法
めったに	滅多に
めったう	滅多打
めっそう	滅相
めっしつ	滅失
めっさつ	滅殺
めっさう	滅相
めっきん	滅菌
めちがい	目違い
めずらか	珍か
めすねこ	雌猫
めすかぶ	雌株
めすうま	牝馬	雌馬
めすいぬ	牝犬
めじろお	目白押
めじるし	目印
めしもり	飯盛り
めしもの	召し物
めしびつ	飯櫃
めしつぶ	飯粒
めしつか	召し使
めしだい	飯代
めしたき	飯炊き
めしかか	召し抱
めしあい	飯合
めざわり	目障り
めざまし	目覚し	目覚まし
めこぼし	目溢し
めぐろく	目黒区
めぐりあ	回り合	巡り逢	巡り合
めぐすり	目薬
めくるめ	目眩
めくらま	目眩
めくばり	目配り
めくばせ	眼配せ	目配せ
めくじら	目鯨	目くじら
めくされ	目腐れ
めぎつね	女狐
めきしこ	墨西哥
めがねや	メガネ屋	眼鏡屋
めがしら	目頭
めかじき	眼旗魚
めかしこ	粧し込
めかくし	目隠	目隠し
めうつり	目移り
めいわく	迷惑
めいろん	名論
めいろう	明朗
めいれき	明暦
めいれい	命令
めいりん	明林
めいよう	没有
めいゆう	盟友	名優
めいやく	名訳	名薬	盟約
めいもん	名門
めいもく	瞑目	名目
めいもう	迷妄
めいめつ	明滅
めいめい	命名	明々	銘々
めいぼく	銘木	名木
めいぼう	明眸	名望
めいほう	盟邦	明芳	名豊	名峰	名宝
めいぶん	明文	名分	銘文	名文	名聞
めいぶつ	名物
めいふく	冥福
めいびん	明敏
めいひん	名品	名牝
めいひつ	名筆
めいばん	名盤
めいはん	名阪
めいはく	明白
めいにち	命日
めいどう	鳴動
めいとく	明徳
めいとう	名答	名東	銘刀	名刀	名湯	明答
めいてん	名店
めいてつ	明哲	名鉄
めいてい	酩酊	名艇
めいっこ	姪っ子
めいちょ	名著
めいちゃ	銘茶
めいだん	明断
めいだい	名大	明大	命題	名古屋大学
めいたん	名短
めいたつ	明達
めいぞく	名族
めいそう	瞑想	名僧	明窓	迷走	冥想
めいせん	名川	銘仙
めいせつ	名節
めいせき	名跡	明晰
めいせい	明星	名聲	名声
めいすう	命数	名数
めいすい	名水
めいじん	名人	明神
めいじや	明治屋
めいじつ	名実	名實
めいじき	明治期
めいじか	明示化
めいしん	名神	迷信
めいしょ	名所	名処
めいしゅ	名手	銘酒	盟主	名主	明珠	明主	名酒
めいしゃ	鳴謝	眼医者	目医者	名車
めいしく	名詞句
めいしか	名詞化
めいざん	名山
めいさん	名産
めいさま	名様
めいさつ	名刹	明察
めいさく	名作	迷作
めいさい	明細	迷彩
めいこう	名港	名工	名香
めいげん	名言	鳴弦	迷言	明言
めいげつ	明月	名月
めいげき	名劇
めいけん	名剣	名犬	迷犬
めいけつ	名血
めいけい	明経
めいくん	明訓	名君	明君
めいぎん	名吟
めいがら	銘柄
めいがざ	名画座
めいがく	明学
めいかん	名鑑	銘肝
めいかく	明確
めいかい	明解	冥界	明快
めいおう	明応	冥王
めいえん	名演
めいうん	命運
めいあん	名案	明暗	冥暗
めあたら	目新
めあかん	雌阿寒
めあかし	目明かし
むろらん	室蘭
むろやま	室山
むろまち	室町
むろふし	室伏
むろはし	室橋
むろどう	室堂
むろとし	室戸市
むろたに	室谷
むろかわ	室川
むろおか	室岡
むろあじ	室鰺
むりょく	無力
むりょう	無料	無量	無聊
むりやり	無理矢理
むりそく	無利息
むりぜめ	無理攻め
むりすう	無理数
むりじい	無理強い
むりかい	無理解
むりおし	無理押し
むらわき	村脇
むらゆご	ムラユ語
むらやま	村山
むらもと	村本
むらむら	村々
むらまつ	村松
むらまさ	村正
むらびと	村人
むらにし	村西
むらなか	村中
むらたに	村谷
むらした	村下
むらざと	村里
むらさわ	村澤	村沢
むらさめ	叢雨	村雨
むらさき	紫	村さ来
むらこし	村越
むらくも	叢雲
むらくし	村櫛
むらかみ	村上
むらかた	村方
むらおか	村岡
むらうち	村内
むらいし	村石
むみょう	無明
むぼうび	無防備
むほせい	無補正
むほしゅ	無保守
むほけん	無保険
むべんか	無弁花
むへんか	無変化
むびょう	無病
むびゅう	無謬
むひょう	無標	霧氷
むひはん	無批判
むばんち	無番地
むねよし	宗吉	宗良
むねゆき	宗幸
むねやけ	胸やけ	胸焼け
むねもと	胸元
むねまち	棟区
むねふじ	宗藤
むねひろ	宗裕
むねひさ	宗久
むねはる	宗治
むねのり	宗典
むねにく	胸肉
むねとも	宗朋
むねとし	宗敏	宗俊
むねたけ	宗武
むねたか	宗高
むねしげ	宗重
むねざわ	宗澤
むねくに	宗国
むねくそ	胸糞
むねかた	宗片
むねうち	刀背打ち
むねあげ	棟上げ
むねあき	宗昭	宗明
むにんか	無認可
むにねん	無二念
むなもと	胸元
むなびれ	胸鰭
むなつき	胸突き
むなだか	胸高
むなさわ	胸騒
むなさき	胸前	胸先
むなぐら	胸倉	胸座
むなくそ	胸糞
むながい	胸懸	鞅
むなかた	宗形	宗方	棟方	宗像
むないた	胸板
むどくか	無毒化
むとどけ	無届け
むとそう	無塗装
むとうは	無党派
むとうか	無灯火	無燈火
むてんぽ	無店舗
むてんか	無添加
むていし	無停止
むていぎ	無定義
むつわん	陸奥湾
むつわり	六つ割り
むつゆき	睦之
むつみあ	睦み合
むつひろ	睦裕
むつのり	睦典
むつしげ	睦茂
むつざわ	睦沢
むつごと	睦言
むつうら	六浦
むつあき	睦明
むつあい	六会
むちゅう	夢中	霧中
むちうち	鞭打	鞭打ち
むだめし	徒飯	無駄飯
むだぼね	無駄骨
むだばな	徒花
むだにく	無駄肉
むだづか	無駄使	無駄遣
むだじに	無駄死に
むだぐち	無駄口
むだがね	無駄金
むだあし	無駄足
むたんぽ	無担保
むたぐち	牟田口
むぞうさ	無造作	無雑作
むそうか	夢想家
むせんや	無線屋
むせんき	無線機
むせんか	無線家
むせびな	噎び泣
むせかえ	蒸返	噎返
むせいふ	無政府
むせいか	無声化
むずがゆ	むず痒
むすめご	娘御
むすびめ	結び目
むすびつ	結び付
むじんき	無人機
むじんか	無人化
むじるし	無印
むじょう	無情	無常	無上
むじゅん	⊥	矛盾
むじゅう	無住
むじゃき	無邪気
むじまく	無字幕
むじげん	無次元
むじかく	無自覚
むしりょ	無思慮
むしりと	毟り取
むしよけ	虫除け
むしょり	無処理
むしょく	無職	無色	夢色
むしょう	霧消	無性	無償
むしゅみ	無趣味
むしゅく	無宿
むしゅう	無臭
むしやき	蒸し焼き
むしゃぶ	武者振
むしゃく	無錫
むしもの	蒸し物
むしぼし	虫干し
むしへん	虫偏
むしぶろ	蒸し風呂
むしふう	虫封
むしぱん	蒸しパン
むしばら	虫腹
むしとり	虫取り
むしてい	無指定
むししゃ	無視者
むしけん	無試験
むしけら	虫螻
むしがた	虫型
むしかご	虫かご	虫籠
むしかく	無資格
むしかえ	蒸し返
むしあつ	蒸し暑
むしあき	虫明
むさんそ	無酸素
むさべつ	無差別
むさしの	武蔵野
むさくい	無作為
むごんか	無言歌
むことり	婿取り
むこがわ	婿側	武庫川
むこうか	無効化
むこいり	婿入り
むげんこ	無限個
むげんぎ	無限木
むげがわ	武芸川
むけなお	向け直
むくのき	椋木
むくどり	椋鳥
むくだい	椋代
むくいぬ	尨犬
むぎわら	麦わら	麦ワラ	麦藁
むぎめし	麦飯
むぎぶえ	麦笛
むぎひと	麦人
むぎとろ	麦薯蕷
むぎちゃ	麦茶
むぎたに	麦谷	麥谷
むぎさく	麦作
むきりつ	無規律
むきょく	無極
むきょか	無許可
むきょう	無響
むきゅう	無給	無窮	無休	無級
むきめい	無記名
むきむき	向き向き
むきぶつ	無機物
むきはい	無気肺
むきなお	向き直
むきどう	無軌道
むきてき	無機的
むきしつ	無機質
むきげん	無期限
むきけい	無機系
むきかた	剥き方
むきおん	無気音
むきおく	無記憶
むきえん	無機塩
むかんさ	無鑑査
むかべん	無花弁
むかばら	向か腹
むかしつ	無過失
むかしき	昔聞
むかえび	迎え火
むかえい	迎え入
むかいや	向谷
むかいの	向野
むかいあ	向かい合	向い合
むえんか	無煙化
むいんし	無韻詩
むいみご	無意味語
むいはん	無違反
むいそん	無医村
むいしき	無意識
むあんだ	無安打
むーみん	夢民
みんよう	民謡
みんゆう	民有
みんまや	三厩
みんぽう	民法	民放
みんぼう	民望
みんぺい	民平	民兵
みんぷう	民風
みんぱく	民博	民泊
みんはく	民博
みんてつ	民鉄
みんぞく	民族	民俗
みんせん	民選
みんせい	民生	民青	民政	民声
みんじゅ	民需
みんしん	民心
みんしゅ	民主
みんしゃ	民社
みんざい	眠剤
みんこく	民国	民國
みんこう	民航
みんこー	明刻
みんげい	民芸
みんけん	民権
みんかん	明槓	民間
みんおん	民音
みんえい	民営
みわやま	三輪山
みるみる	見る見る
みるがい	海松貝
みりょく	魅力
みりょう	未了	魅了
みらさか	三良坂
みらいは	未来派
みらいき	未来記
みよはら	みよ原
みょうり	名利	冥利
みょうや	明夜
みょうみ	妙味
みょうぶ	命婦
みょうは	妙葩
みょうな	妙な
みょうじ	名字	苗字
みょうく	妙句
みょうぎ	妙義	妙技
みょうが	茗加	茗荷	冥加
みょうえ	明恵
みやわき	宮脇
みやもり	宮森	宮守
みやもと	宮本
みやむら	宮村
みやまる	宮丸
みやまち	宮町
みやまえ	宮前
みやまい	宮参
みやびと	宮人
みやはら	宮原
みやのぎ	宮野木
みやにし	宮西
みやなぎ	三柳
みやなが	宮永
みやでら	宮寺
みやづか	宮仕
みやちよ	宮千代
みやだい	宮大
みやたに	宮谷
みやたけ	宮武	宮竹
みやぞの	宮苑
みやぞえ	宮副
みやずみ	宮住
みやじま	宮嶋	宮島
みやしろ	宮代
みやしの	宮篠
みやした	宮下
みやざわ	宮沢	宮澤
みやざと	宮里
みやざき	宮崎
みやさま	宮様
みやさと	宮里
みやさか	宮坂
みやごし	宮越
みやこじ	都路
みやこお	都落
みやこう	宮交
みやげや	土産屋
みやぐち	宮口
みやくら	宮倉
みやくぼ	宮窪
みやくに	宮国
みやぎの	宮城野
みやがわ	宮川
みやがた	宮方
みやがく	宮学
みやかわ	宮川
みやおか	宮岡
みやえき	宮駅
みやうち	宮内
みやいり	宮入
みゃくう	脈搏	脈打
みもだえ	身悶え
みみより	耳寄り
みみもと	耳許	耳元
みみへん	耳偏
みみぬき	耳抜
みみなり	耳鳴り	耳鳴
みみづか	耳塚
みみたぶ	耳朶	耳たぶ
みみせん	耳詮	耳栓
みみずく	木菟	角鴟
みみしい	耳癈
みみざわ	耳障
みみざと	耳聡
みみくそ	耳くそ	耳クソ	耳糞
みみがた	耳型
みみかき	耳掻き
みみうち	耳打	耳打ち
みみあか	耳垢
みまわし	見廻し
みまちが	見間違
みまさか	美作
みほんし	見本誌
みほとけ	御仏
みほぞん	未保存
みほそう	未舗装
みほぜき	美保関
みぶんか	未分化
みぶるい	身震い
みふたつ	身二つ
みびいき	身贔屓
みひらき	見開き
みひとつ	身一つ
みばらい	未払	未払い
みはらし	見晴らし
みはらい	未払い
みはまく	美浜区
みはから	見計
みはかし	御刀
みのわた	三の焦
みのやき	美濃焼
みのむし	蓑虫
みのまわ	身の回
みのぼん	美濃本
みのほど	身の程
みのばん	美濃判
みのはら	箕原	蓑原
みのはた	蓑畑
みのたけ	身の丈
みのしろ	身の代
みのしま	箕島
みのがみ	美濃紙
みのがし	見逃し
みのかわ	身の皮
みのかも	美濃加茂
みのうら	箕浦
みのうえ	身の上
みねゆき	峰幸
みねやま	峰山
みねむら	峯村	峰村
みねまつ	峰松
みねひさ	峰久
みねはま	峰浜
みねせん	美祢線
みねざき	峯崎	峰崎
みねごし	峰越
みねぎし	峰岸	嶺岸	峯岸
みねうち	峰打ち
みにかぶ	ミニ株
みならい	見習い	見習
みなもと	源
みなみむ	南向
みなみの	南野
みなみで	南出
みなみだ	南田
みなみく	南区
みなまた	水俣
みなとく	港区
みなづき	水無月	水月
みなつき	水無月
みなそこ	水底
みなしご	孤児
みなさん	皆さん
みなさま	皆様
みなごろ	皆殺
みなぐち	源口	皆口
みなくち	水口
みながわ	皆川
みなかわ	皆川
みなかみ	水上
みなかた	皆方	南方
みなおな	皆同
みなおし	見直し
みどりや	緑屋
みどりみ	緑味
みどりご	嬰児
みどりく	緑区
みどころ	見所	見どころ
みとりず	見取図	見取り図
みとめあ	認め合
みとそう	未塗装
みとせん	水戸線
みところ	三所
みとおし	見通し
みとえき	水戸駅
みてぐら	幣
みてくれ	見て呉れ
みていち	未定値
みていぎ	未定義
みづくろ	身繕
みつろう	蜜蝋	光郎
みつりん	密林
みつよし	光義
みつゆび	三ッ指	三つ指
みつゆき	三幸	光之	充之
みつやく	密約
みつもり	見積	見積り	三森	見積もり
みつもと	光本
みつもう	密毛
みつめい	密命
みつまめ	蜜豆
みつまた	三椏
みつまさ	光正	光政	光雅
みつぼし	三星	三ッ星	三つ星
みつぶつ	密勿
みつびし	三菱
みつひろ	充博	満浩	光浩	充浩	光裕	光弘	光博	充弘	充洋	充宏	満弘	円博	光宏
みつひで	光秀
みつひさ	三久	充久
みつひこ	美比古	光彦
みつばち	蜜蜂
みつばい	密売
みつはる	充治	光晴
みつはし	三橋	三ツ橋
みつのり	光範	充則	光徳	光紀
みつのぶ	光伸	光信	光延
みつなり	三成	実成	光成
みつなが	満永	光永
みつとも	三友
みつとし	光俊	充敏	光年
みつてん	密天
みつてる	光輝	充照
みつづか	三塚
みつつぼ	蜜壺
みつつじ	光辻
みつだん	密談
みつたけ	満武	光威
みつたか	充隆	光毅
みつぞろ	三つ揃
みつぞう	密造
みつせん	蜜腺
みつしま	満島	美津島
みつざわ	光澤
みつさと	満里
みつごん	密言
みつこし	三越
みつげつ	蜜月
みつけだ	見付け出	見つけ出
みつぐみ	三つ組	三組
みつくろ	見繕
みつくり	箕作
みつくち	兎唇
みつかん	蜜柑
みつかげ	光影
みつうん	密雲
みついわ	三岩
みついし	三ッ石	三石
みつあみ	三つ編み
みつあき	充璋	光璋	光明	光昭	充章
みっぺい	密蔽	密閉
みっぷう	密封
みってい	密偵
みっつめ	三つめ
みっつう	密通
みっそう	密送	密葬	密奏
みっせん	密栓
みっせつ	密接
みっせい	密生
みっしょ	密書
みっしつ	密室
みっさつ	密殺
みっこく	密告
みっこう	密航	密行
みっけい	密計
みっかめ	三日目
みっかび	三ヶ日	三ケ日
みっかい	密会
みちろう	道郎
みちよし	道由
みちょう	未聴
みちゆき	道行
みちゃく	未着
みちむら	道村
みちむこ	道向
みちみち	道々
みちひろ	倫広	通洋	道宏	道洋	倫洋	道広	通博	道弘
みちひで	通秀
みちひこ	導彦
みちばた	道端	路傍	道傍
みちはる	亨治	道春
みちはら	道原
みちはば	道幅
みちのり	道のり	道程
みちのし	道師
みちのく	陸奥
みちにし	道西
みちなり	途也	道也	道成
みちなか	道中
みちとし	通敏
みちづれ	道連れ
みちつた	道蔦
みちたか	道隆	命孝	通隆	充隆
みちぞい	道沿
みちすじ	道筋
みちすう	未知数
みちしお	満ち汐	満ち潮
みちさと	満里
みちくさ	道草
みちがわ	道側
みちがみ	道上
みちがえ	見違え
みちがい	見違い
みちうえ	道上
みちいと	道糸
みちあふ	満ち溢
みちあき	通明	道明	通晃	道朗
みだれば	乱れ刃
みだれと	乱れ飛
みだしな	身嗜
みだしご	見出し語
みたらし	御手洗
みたらい	御手洗
みたむら	三田村
みたまや	御霊屋
みたせん	三田線
みたがわ	三田川
みたかん	三田間
みたかし	三鷹市
みたえき	三田駅
みぞぶち	溝渕	溝淵
みぞはし	溝端
みぞぐち	溝口
みぞおち	鳩尾
みぞうち	溝内
みぞうえ	溝上
みそんじ	見損じ
みそやき	味噌焼
みそまめ	味噌豆
みそのう	御園生
みそづけ	味噌漬
みそっぱ	味噌っ歯
みそだま	味噌玉
みそしる	味噌汁
みそしき	未組織
みそこし	味噌漉し
みそぐら	味噌蔵
みそくそ	味噌糞
みそかつ	味噌カツ
みそいた	味噌炒
みそあん	味噌餡
みそあじ	味噌味
みせもの	見せ物	見世物
みせびら	店開
みせばん	店番
みせじま	店仕舞
みせしめ	見せしめ
みせさき	店先
みせこう	未施行
みせがわ	店側
みせがま	店構
みせがね	見せ金
みせかた	見せ方
みせかけ	見せ掛け
みせいり	未整理
みせいび	未整備
みずわり	水割り
みずやま	水山
みずもれ	水漏れ
みずもり	水杜
みずもの	水物
みずもと	水本
みずむし	水虫
みずむけ	水向け
みずみず	水水	瑞瑞	瑞々	水々
みずまわ	水回
みずまち	水町
みずまし	水増し	水増
みずまき	水撒き	水巻
みずぼり	水堀
みずぶろ	水風呂
みずぶと	水太
みずぶき	水拭き
みずびた	水浸
みずひろ	瑞洋
みずひと	瑞史
みずひき	水引
みずばり	水張り
みずばら	水腹
みずはら	水原
みずはし	水橋
みずはけ	水捌け
みずのみ	水呑み	水飲み
みずのと	癸
みずのて	水の手
みずのえ	壬
みずぬま	水沼
みずぬき	水抜
みずなみ	瑞浪
みずなし	水梨	水無
みずとり	水鳥
みずてん	不見点	不見転
みずづけ	水漬け
みずだし	水出し
みずだこ	水蛸
みずたま	水玉	水溜
みずたに	水谷
みずたき	水炊き
みずぜめ	水責め	水攻め
みずぜき	水関
みずせん	水栓
みずしろ	水城
みずしま	水島	水縞	水嶌	水嶋
みずさわ	水澤	水沢
みずさし	水差し
みずさき	水先	水崎
みずごり	水垢離
みずごえ	水肥
みずこし	水越
みずげい	水芸
みずぐち	水口
みずくぼ	水窪
みずくさ	水臭	水草
みずくき	水茎
みずぎわ	水際
みずきり	水切り
みずがれ	水涸れ
みずがめ	水瓶
みずがき	瑞籬	水垣	瑞垣	水柿
みずかわ	水川
みずから	自ら
みずかみ	水上
みずかさ	水かさ	水嵩
みずかげ	水影
みずかき	蹼	水掻き
みずおと	水音
みずおけ	水桶
みずうみ	湖
みずいろ	水色
みずいり	水入り
みずいも	水芋
みずいで	水出
みずいけ	水池
みずあら	水洗
みずあめ	水飴
みずあび	水浴び
みずあそ	水遊
みずあし	水足
みずあげ	水揚げ
みずあか	水垢
みすみす	見す見す
みすがた	御姿
みじんこ	微塵子	微塵粉
みじんぎ	微塵切
みじろぎ	身じろぎ
みじゅり	未受理
みじゅく	未熟
みじまい	身仕舞
みじっし	未実施
みじたく	身支度	身仕度
みじかめ	短め
みじかす	短過
みしりお	見知り置
みしらず	身知らず
みしよう	未使用
みしょり	未処理
みしょう	御荘	未生	実生	未詳
みしゅく	三宿
みしゅう	未収
みしまし	三島市
みしこう	未施行
みさんか	未参加
みさわし	三沢市
みさとし	三郷市
みささぎ	御陵	陵	山陵
みさげは	見下げ果
みさくぼ	水窪
みさかい	見境
みごろし	見殺し
みごたえ	見応え
みごしら	身拵
みことば	御言葉
みこしば	御子柴
みこころ	御心
みけねこ	三毛猫
みくろん	μ
みくるま	御車
みくりや	御厨
みぎより	右寄
みぎよつ	右四つ
みぎよせ	右寄
みぎよこ	右横
みぎむね	右胸
みぎむき	右向き
みぎみみ	右耳
みぎまわ	右回
みぎまつ	右末	右松
みぎまき	右巻	右巻き
みぎまえ	右前
みぎひじ	右肘
みぎひざ	右膝
みぎはし	右端
みぎのり	右乗
みぎどな	右隣
みぎづめ	右詰め
みぎぞろ	右揃
みぎそろ	右揃
みぎすみ	右隅
みぎした	右下
みぎこし	右腰
みぎぎし	右岸
みぎきき	右利き	右利
みぎがわ	右側
みぎがき	右書き
みぎかた	右肩
みぎおく	右奥
みぎえだ	右枝
みぎうで	右腕
みぎうち	右打ち
みぎうえ	右上
みぎあし	右脚	右足
みきわめ	見極め
みきもと	美樹本
みきひこ	未来彦	三紀彦	幹彦
みきはら	美樹原
みきのり	幹典
みきどう	未起動
みがわり	身代り
みがまえ	身構え
みがって	身勝手
みがため	身固め
みがきた	磨き立
みがきこ	磨き粉
みがきあ	磨き上
みかんか	ミカン科
みかわや	三河屋
みかみね	三神峯
みかづき	三日月
みかつき	三日月
みかげつ	三ケ月
みかぐら	御神楽
みかえり	見返り
みかえし	見返し
みかいち	未開地
みおぼえ	見覚え
みおとり	見劣り
みおとし	見落とし	見落し
みおさめ	見納め
みおくり	見送り
みえみえ	見え見え
みえぼう	見栄坊
みえっぱ	見栄っ張
みえだい	三重大
みえせん	三江線
みえけん	三重県
みえぐん	三重郡
みえかた	見え方
みえかく	見え隠
みうしな	見失
みうごき	身動き
みいらく	三井楽
みいでら	三井寺
みあやま	見誤
まんるい	満塁
まんりき	万力
まんよう	万葉
まんゆう	漫遊
まんもく	万目	満目
まんもう	満蒙	滿蒙
まんめん	満面
まんまん	満々
まんまる	真円	真ん丸
まんまく	幔幕
まんまえ	真ん前
まんまい	万枚
まんぼう	翻車魚
まんべん	満遍	万便	万遍
まんぷく	満腹	万福	満幅
まんぶん	漫文
まんぴつ	漫筆
まんびき	万引き	万引
まんぱん	満帆
まんぱち	万八
まんぱい	満配	満杯
まんばい	万倍
まんのう	満濃
まんねん	万年	萬年
まんにん	万人
まんなか	まん中	真中	真ん中
まんどう	万灯
まんとみ	万富
まんてん	万点	満点	満天
まんてつ	滿鐵	満鉄
まんだん	漫談
まんだら	曼陀羅	曼荼羅
まんだい	万代	万台
まんたん	満タン
まんたに	萬谷
まんぞく	満足
まんぜん	万善	漫然
まんせん	満船
まんせき	満席
まんせい	慢性
まんすい	満水
まんじゅ	万寿
まんしん	慢心	満身	万進
まんしゃ	満車
まんしつ	満室
まんざん	満山
まんざら	満更
まんざい	漫才	万歳
まんさん	蹣跚
まんさつ	万冊	万札
まんさく	満作	万作
まんさい	満載
まんごく	万石
まんごう	万劫
まんこう	満腔
まんげん	万言	漫言
まんげつ	満月
まんけん	漫研
まんきん	万金
まんきつ	満喫
まんがん	Mn	満願	満貫	万巻	Manganese
まんがず	漫画好
まんがし	漫画誌
まんがく	満額
まんがか	漫画化	漫画描	マンガ家	漫画家
まんかん	満貫	満干
まんかぶ	満株
まんかい	満開	万回
まんえん	満塩	万円	萬延	万延	蔓延
まんえつ	満悦
まんいん	満員
まんいつ	万一
まんいち	万一
まわりこ	回り込
まわたり	馬渡
まろやか	円やか
まろうど	客人
まれすけ	希典
まれーご	マレー語
まるゆう	マル優
まるやま	丸山	円山
まるやね	丸屋根
まるやけ	丸焼け
まるやき	丸焼	丸焼き
まるもり	丸森
まるもと	丸本	丸元
まるもち	丸餅
まるもじ	丸文字
まるもう	丸儲
まるめこ	丸め込
まるみつ	丸光
まるみえ	丸見え
まるまる	丸々	○○
まるまど	円窓
まるまげ	丸髷
まるぼし	丸干し
まるほん	丸本
まるべに	丸紅
まるぶん	丸文
まるぶつ	丸物
まるふく	丸福
まるばつ	○×
まるばし	丸橋
まるはち	丸八
まるはし	丸橋
まるはい	丸灰
まるのみ	丸呑み
まるのこ	丸鋸
まるぬま	丸沼
まるにし	丸西
まるなげ	丸投げ
まるどり	丸取り
まるとう	丸東
まるてん	丸天
まるづけ	丸漬
まるづか	丸塚
まるだし	丸出し
まるたに	丸谷
まるぞん	丸損
まるぜん	丸善	丸全
まるざら	丸皿
まるざい	丸材
まるさん	丸三
まるごと	丸ごと
まるごし	丸腰
まるこし	丸腰
まるこう	丸興
まるくび	丸首
まるくに	丸国
まるきん	丸金
まるがり	丸刈り
まるがめ	丸亀
まるがた	丸型	丸形
まるがか	丸抱
まるがお	丸顔
まるかん	丸漢
まるかわ	丸川
まるかじ	丸齧
まるおか	丸岡
まるえり	丸襟
まるえい	丸栄
まるうつ	丸写
まるいち	丸一
まるいす	丸椅子
まるいけ	丸池
まるあら	丸洗
まるあな	丸穴
まるあき	丸明き
まりょく	魔力
まりはな	茉莉花
まりのす	横浜マリノス
まよなか	真夜中
まよいご	迷い子
まよいこ	迷い込
まゆやま	眉山
まゆむら	眉村
まゆつば	眉唾
まゆだま	繭玉
まゆずみ	黛
まゆじり	眉尻
まやさん	摩耶山
まもりぬ	守り抜
まもなく	間も無く
まめみそ	豆味噌
まめまき	豆まき
まめほん	豆本
まめつぶ	豆粒
まめたん	豆単	豆炭
まめぞう	豆蔵
まめおか	豆岡
まむすび	真結び
まむかい	真向かい	真向い
まみなみ	真南
まみづか	馬見塚
ままはは	継母
ままちち	継父
ままさん	ママさん
ままごと	飯事
ままおや	継親
まぼろし	幻
まぶしさ	眩しさ
まふゆび	真冬日
まびさし	目庇
まびきな	間引き菜
まひがし	真東
まひかり	真光
まばたき	瞬き
まばしら	間柱
まねもの	真似物
まねごと	真似事
まねきよ	招き寄
まねきい	招き入
まぬえど	真鵺道	Manued	Manuscript Editing
まにまに	随に
まにあわ	間に合
まなびや	学舎	学び舎
まなでし	愛弟子
まなづる	真鶴
まなつる	真鶴
まなつび	真夏日
まなじり	眥	眦
まなざし	眼差し
まないた	俎板	真魚板	まな板	俎
まどわり	窓割
まどわく	窓枠
まどりず	間取り図
まどよう	窓用
まどはん	窓販
まどない	窓内
まどだい	窓台
まどころ	政所
まどぐち	窓口
まどぎわ	窓際
まどがわ	窓側
まどうし	魔道師	魔導士	魔道士	魔導師
まとまり	纒まり
まとはず	的外
まてがい	蟶貝
まつりか	茉莉花
まつりあ	祭り上
まつよし	松吉
まつよう	末葉
まつゆき	松雪
まつやま	松山
まつやに	松脂
まつもり	松森
まつもと	松本	松元
まつもか	Ceratopyllaceae	マツモ科
まつむろ	松室
まつむら	松村
まつむし	松虫
まつまる	松丸
まつまえ	松前
まつまい	末妹
まつぶん	末文
まつぶし	松伏
まつふる	松古
まつふじ	松藤
まつびし	松菱
まつひろ	松弘
まつばら	松原
まつばせ	松橋
まつはた	松畑
まつのべ	松延
まつのぶ	松延
まつねん	末年
まつぬま	松沼
まつなん	末男
まつなみ	松波
まつなが	末永	松長	松永
まつなか	松中
まつなえ	松苗
まつどし	松戸市
まつとも	松友
まつづき	松月
まつつか	松塚
まつだん	末段
まつだい	末代	松代
まつたに	松谷
まつたけ	松茸
まつたか	松高
まつじょ	末女
まつじめ	末締め
まつじつ	末日
まつしろ	松代
まつしま	松嶋	松島
まつした	松下
まつしげ	松重	松茂
まつざわ	松澤	松沢
まつざき	松崎	松嵜
まつざか	松阪	松坂
まつさわ	松沢
まつさき	松崎
まつさか	松阪	松坂
まつくら	松倉
まつがや	松ヶ谷
まつかわ	松河	松川
まつかた	松方
まつかぜ	松風
まつかざ	松飾
まつかさ	松毬
まつおか	松岡
まつえだ	松枝
まつえし	松江市
まつえい	末裔
まつうら	松浦
まついち	松一
まついだ	松井田
まついし	松石
まっぽう	末法
まっぷた	真っ二
まっぴら	真平	真っ平
まっぴつ	末筆
まっぱい	末輩
まっとう	真っ当	全う	松任
まってい	末弟
まっちゃ	抹茶
まったん	末端
まったく	全	全く
まったい	真っ平
まっそん	末孫
まっせつ	末節
まっせき	末席
まっすぐ	真っ直	真っ直ぐ
まっしろ	真白	真っ白
まっしゃ	末社
まっさら	真っ新
まっさつ	抹殺
まっさき	真っ先	真先
まっさか	真っ盛
まっさお	真青	真っ青
まっこう	真向	抹香	真っ向
まっくろ	真っ黒	真黒
まっくら	真っ暗	真暗
まっかん	末巻
まっかり	真狩
まっかつ	靺鞨
まちんか	Loganiaceae	マチン科
まちまち	区々	町々	区区	街々
まちぼう	待ち惚
まちぶせ	待ち伏せ	待伏せ
まちびと	待ち人	待人
まちばり	待ち針	待針
まちはず	町外	街外
まちのぞ	待ち望
まちなみ	街並	町並	町並み
まちなか	街中	町中
まちどお	待ち遠
まちでら	待寺
まちづく	町作
まちっこ	町っ子
まちっが	間違
まちだし	町田市
まちすじ	町筋
まちざわ	町沢	町澤
まちがい	間違い
まちかま	待ち構
まちかね	待兼
まちかど	町角	街角
まちかた	町方
まちあわ	待ち合わ	待合
まちあぐ	待ち倦
まちあい	待合
まだらお	斑尾
またわり	股割
またもの	陪臣	又者
またたび	股旅
またたき	瞬き
またぞろ	又候
またした	股下
またぐら	胯座	股座
またぎき	又聞き
またがり	又借り
またがみ	股上
またがし	又貸し
まぜもの	混ぜ物
まぜかえ	雑ぜ返
まぜあわ	混ぜ合
ますらお	丈夫	益荒男
ますやま	益山	増山
ますもと	升本	増本	桝本
ますます	益々
ますぶち	増淵
ますひこ	益彦
ますはら	増原
ますなが	増永
ますづり	鱒釣
ますだや	増田屋
ますたに	益谷	増谷	升谷
ますたつ	倍達
ますぞえ	舛添	桝添
ますぞう	益造
ますせき	桝席
ますずし	鱒寿司
ますざわ	増澤	増沢
ますかわ	増川
ますおか	舛岡	増岡	益岡
ますいち	増市
ますいか	麻酔科
ますいい	麻酔医
まじわり	∩	交わり
まじゅつ	魔術
まじゅう	魔獣
まじもの	蠱物
まじめす	真面目過
まじない	呪い
まじきり	間仕切り	間仕切
ましんご	マシン語
ましょう	魔障	魔性
ましゅう	摩周
ましゃく	間尺
ましかく	真四角
まざりあ	混ざり合
まさより	政頼
まさよし	正善	政義	正義	正芳	雅義	昌吉	昌義	正好	正元	正良
まさよう	将容
まさゆめ	正夢
まさゆき	将行	政征	昌之	政之	政行	雅祐	正之	正幸	雅之	昌幸	政幸	誠之	正行	理之	真幸	雅行	真之	雅幸
まさやす	昌泰	誠康	正康	雅康	政康	雅保	正泰
まさもと	政本	理元
まさむね	正宗	政宗
まさみつ	昌光	正光	真光
まさみち	真理	正道	雅道
まさぶみ	正文
まさふみ	昌文	雅文	将史	将文	真詞	雅史	正文
まさふさ	政房
まさひろ	正大	雅裕	征洋	雅宏	正裕	雅弘	正宏	正洋	真弘	正弘	昌寛	政広	雅浩	雅洋	昌弘	匡弘	政宏	正央	誠広	正広	正博	政弘	雅博	正寛	昌宏	正浩	将容	政浩	昌広
まさひと	雅仁	昌人	正人	正仁	賢人
まさひで	正秀	正英	昌英
まさひさ	真久	昌久
まさひこ	正彦	昌彦	雅彦	真彦	眞彦	允彦	政彦
まさはる	昌治	正治	雅春	正晴	正春	政春
まさのり	正紀	真典	雅則	雅典	正規	昌典	正則	政宣	正範	成憲	公則	正典	正徳	昌則	正憲	政典
まさのぶ	雅修	政信	正亘	雅宣	雅信	昌信	昌延	匡伸	正信	正伸
まさなり	政成	正業	正成
まさなお	正尚	雅尚	政直	正直
まさとみ	正富	正美	政富
まさとし	政利	昌利	真俊	正敏	正利	雅敏	盛敏	眞利	雅俊	正俊
まさてる	正輝	政輝	雅照
まさてつ	正哲
まさつぶ	摩擦部
まさつね	正恒
まさつぐ	雅紹	仁継	正継
まさたけ	正武
まさたか	昌孝	正孝	正隆	誠孝	政貴	真考	正高	政孝	真隆	雅隆	政敬	政隆
まさずみ	正純
まさすけ	正祐
まさしち	政七
まさしげ	雅重	政重	正成	正茂
まさしく	正しく
まさこひ	雅子妃
まさきよ	政清
まさきち	政吉
まさがね	正金
まさかり	鉞
まさかね	斉加年
まさかど	将門
まさかつ	政勝	正勝	誠勝
まさかず	正一	正和	雅和	昌一	賢和	政和
まさおみ	正臣
まさおき	正興
まさおか	正岡	政岡
まさいち	正一	政一
まさあき	真昭	正彰	昌晃	昌之	匡章	雅昭	正明	政明	正昭	雅章	昌昭	正章	雅明	政昭	政秋	正晃	昌明
まごびき	孫引き
まごのて	孫の手
まごでし	孫弟子
まごころ	真心
まごおり	馬郡
まごうた	馬子唄
まけんき	負けん気
まけぼし	負星
まけつづ	負け続
まけぐみ	負け組
まけいろ	負け色
まけいぬ	負け犬	負犬
まくりあ	捲り上
まくらぎ	枕木	鍖
まくらえ	枕絵
まくべつ	幕別
まくはり	幕張
まくなし	幕無し
まくない	膜内
まくしつ	膜質
まくした	捲し立	幕下
まくしき	幕式
まくしあ	捲し上
まくぎれ	幕切れ	幕切
まくうち	幕内
まくあつ	膜厚
まくあけ	幕開け
まくあき	幕開き
まくあい	幕合	幕間
まぎれこ	紛れ込
まぎらわ	紛らわ
まぎょう	マ行	ま行
まきわり	薪割り
まきょう	魔鏡	魔境
まきゅう	魔球
まきもの	巻き物	巻物
まきもど	巻き戻	巻戻
まきもと	牧本
まきむら	槙村	牧村
まきぼー	まきボー
まきほん	巻本
まきびと	牧人
まきひこ	眞木彦
まきひげ	巻鬚	巻ひげ	巻きひげ
まきばい	蒔き灰
まきはら	牧原	槙原	槇原
まきのせ	牧之瀬
まきのお	槇尾
まきなお	蒔き直	巻き直
まきとり	巻取
まきつけ	巻き付け	巻きつけ	蒔付け
まきつき	巻き付き	巻きつき
まきちら	撒き散ら
まきぞの	牧園
まきぞえ	巻添	巻き添え
まきせん	巻き線	巻線
まきずし	巻き鮨	巻き寿司	巻寿司
まきすう	巻数
まきじた	巻き舌	巻舌
まきじく	巻軸
まきしま	槙島	牧島
まきこみ	巻き込み
まきぐも	巻雲
まきぐち	牧口
まきがみ	巻紙	巻き紙	巻上
まきがい	巻貝	巻き貝
まきかわ	巻川
まきかえ	巻き返
まきおこ	巻き起
まきおか	牧丘	牧岡
まきあみ	巻き網	巻網
まきあげ	巻揚	捲揚	巻上
まがまが	曲々	兇々	禍禍	禍々
まがどり	凶鳥
まがたま	勾玉
まかりな	罷り成
まかまか	摩可摩可
まかない	賄い
まかじき	真旗魚
まかいの	馬飼野
まおとこ	間男
まえわた	前渡
まえやま	前山
まえやち	前谷地
まえやく	前厄
まえもっ	前以
まえむき	前向き
まえまえ	前々
まえほり	前堀
まえぶれ	前触れ
まえふり	前振
まえびろ	前広
まえばる	前原
まえばり	前貼り
まえばら	前原	前払
まえばし	前橋
まえはら	前原
まえはた	前畑
まえはし	前橋
まえのり	前ノリ
まえのぶ	前信
まえのひ	前の日
まえにわ	前庭
まえどり	前録り
まえづけ	前付
まえつぼ	前壺
まえつえ	前津江
まえだれ	前垂れ
まえだて	前立
まえだお	前倒
まえぜつ	前説
まえせつ	前説
まえずり	前刷り	前刷
まえじま	前島	前嶋
まえしま	前島
まえざわ	前澤	前沢
まえさわ	前沢
まえさと	前里
まえきん	前金
まえがわ	前川	前側
まえがり	前借り
まえがみ	前髪
まえがし	前貸し
まえがき	前垣	前書	前書き
まえかわ	前川
まえかた	前方
まえかけ	前掛け
まえおき	前置き	前置
まえおか	前岡
まえうり	前売り	前売
まえうけ	前受
まえいわ	前祝
まえいた	前板
まえあし	前足	前脚
まうしろ	真後ろ	真後
まいわし	真鰯
まいよう	枚葉
まいゆう	毎夕
まいもど	舞い戻
まいまい	毎々
まいぼつ	埋没
まいふん	毎分
まいひめ	舞姫
まいばん	毎晩
まいばら	米原
まいはら	米原
まいはま	舞浜
まいねん	毎年
まいにち	毎日
まいなつ	毎夏
まいなす	－
まいない	賂
まいとし	毎年
まいづる	舞鶴
まいつき	毎月
まいたけ	舞茸
まいぞう	埋蔵
まいそう	昧爽	埋葬
まいせつ	埋設
まいせき	毎夕
まいすう	枚数
まいしん	邁進
まいさか	舞阪
まいごう	毎号
まいこつ	埋骨
まいげつ	毎月
まいぐみ	枚組
まいくろ	micro	μ
まいくる	舞い狂
まいぎぬ	舞衣
まいきょ	枚挙
まいかぜ	舞風
まいかい	毎回
まいおど	舞い踊
まいおか	舞岡
まいあさ	毎朝
まあたら	真新	目新
まーぼー	麻婆
もんりゅう	門柳
もんみゃく	門脈
もんぴょう	門標
もんばやし	門林
もんどころ	紋所
もんていし	門弟子
もんちょう	紋帳
もんちゅう	門柱	問中
もんちゃく	悶着
もんだいず	問題図
もんだいじ	問題児
もんだいし	問題視	問題史
もんだいか	問題化
もんしょう	紋章
もんごるご	モンゴル語
もんくなし	文句無し	文句無
もんがまえ	門構え
もんかせい	門下生
もりやまく	守山区
もりぶでん	Mo	Molybdenum
もりのみや	森の宮
もりのさと	森の里
もりちょう	森町
もりさがり	盛り下がり
もりぐちし	守口市
もりおかし	盛岡市
もりあわせ	盛り合わせ	盛合せ	盛り合せ
もりあがり	盛り上がり
もらいもの	貰い物
もらいなき	貰い泣き
もよりえき	最寄駅
もようがえ	模様替	模様替え
ももとみみ	桃と耳
ももたろう	桃太郎
もめんばり	木綿針
もみじのが	紅葉賀
もみじがり	紅葉狩り	紅葉狩
もみあらい	揉み洗い
もほうせい	模倣性
もばらえき	茂原駅
もはんてき	模範的
ものわらい	物笑い
ものわすれ	物忘れ
ものわかれ	物別れ
ものわかり	物分り
ものもらい	物貰い
ものめずら	物珍
ものみだか	物見高
ものまねし	物真似師
ものぶそく	物不足
ものはじめ	物始め
もののほん	物の本
もののべし	物部氏
ものねたみ	物妬み
ものづくし	物尽し
ものじたい	物自体
ものしらず	物知らず
ものしずか	物静か
ものごころ	物心
ものぐるい	物狂い
ものがたり	物語
ものおもい	物思い
ものおぼえ	物覚え
ものおしみ	物惜しみ
ものあんじ	物案じ
もにみあか	Monimiaceae	モニミア科
もどりさき	戻り先
もどってこ	戻って来
もどってく	戻って来
もどってき	戻って来
もとやわた	本八幡
もとめかた	求め方
もとひしょ	元秘書
もとばらい	元払
もとばやし	本林
もとはこね	元箱根
もとどおり	元通り
もとちょう	元帳
もとたなか	元田中
もとじろう	基次郎
もとじゅく	本宿
もとしゅふ	元主婦
もとさぎし	元詐欺師
もときゅう	本久
もとがしわ	本柏
もとかんじ	元幹事
もとかしゅ	元歌手
もとあざぶ	元麻布
もつにゅう	没入
もってまわ	持って回
もってこい	持って来い
もってかえ	持って帰
もったいぶ	勿体振
もったいな	勿体無
もちはこび	持ち運び
もちじかん	持ち時間
もちぐされ	持腐れ	持ち腐れ
もちかえり	持ち帰り
もちあわせ	持合せ	持ち合せ
もぞうひん	模造品
もじれつか	文字列化
もじゆらい	文字由来
もじまちが	文字間違
もじどおり	文字通り
もじつうか	門司通過
もじちょう	文字長
もじたんい	文字単位
もじぜんぶ	文字全部
もじじたい	文字自体
もじじしょ	文字辞書
もじしょり	文字処理
もじしてん	門司支店
もじこうほ	文字候補
もじこーど	文字コード
もじくばり	文字配り
もじきょう	文字鏡
もじきごう	文字記号
もじいがい	文字以外
もしきてき	模式的
もさくてき	模索的
もこくぼん	模刻本
もけいよう	模型用
もけいてん	模型店
もけいてき	模型的
もけいぐん	模型群
もけいかい	模型界
もぐさえん	百草園
もくれんか	モクレン科	Magnoliaceae
もくようび	木曜日
もくひょう	目標
もくひけん	黙秘権
もくはんが	木版画
もくてきち	目的地
もくてきご	目的語
もくちょう	木彫
もくたーる	木タール
もくせいか	モクセイ科
もくじろく	黙示録
もくじゅう	黙従
もくじあん	目次案
もくしろく	黙示録
もくきんど	木金土
もぎせいど	模擬精度
もぎしけん	模擬試験
もぎかのう	模擬可能
もがりぶえ	虎落笛
もがりたけ	虎落竹
もがみがわ	最上川
もえぎいろ	萌木色	萌黄色	萌葱色
もうりょう	魍魎
もうらりつ	網羅率
もうらてき	網羅的
もうらせい	網羅性
もうふぶき	猛吹雪
もうひょう	猛豹	妄評
もうちょう	猛鳥	盲腸
もうそうか	妄想家
もうすこし	もう少し
もうじょう	毛状	網状
もうじゅう	盲従	猛獣
もうしわた	申し渡
もうしわけ	申し訳	申訳
もうしょう	猛将
もうしゅん	孟春
もうしゅう	妄執	猛襲
もうしもく	網翅目
もうしぶん	申し分
もうしひら	申し開
もうしつた	申し伝	申伝
もうしたて	申立て	申し立て	申立
もうしこみ	申込	申し込み
もうしおく	申し遅	申し送
もうしいれ	申入れ	申し入れ
もうしあわ	申し合
もうこれき	猛虎暦
もうこはん	蒙古斑
もうことう	猛虎党
もうけやく	儲け役	儲役
もうけもの	儲け物
もうけぐち	儲け口
もうぎゅう	猛牛
もういちど	もう一度
もーどめい	モード名
めんようそ	面要素
めんみつど	面密度
めんどくさ	面倒臭
めんどうみ	面倒見
めんとおし	面通し
めんちょう	面疔
めんたいこ	明太子
めんせつび	面接日
めんせきず	面積図
めんじょう	免状	面状	面上
めんじゅう	面従
めんしょく	免職
めんざいふ	免罪符
めんきょと	免許取
めんかやく	綿火薬
めりけんこ	メリケン粉
めやすばこ	目安箱
めもちょう	メモ帳
めまんべつ	女満別
めはなだち	目鼻立ち
めぬきどお	目抜き通
めつけやく	目付役
めったぎり	メッタ斬り	滅多斬り
めったうち	滅多打ち
めっきんご	滅菌後
めっきゃく	滅却
めだまやき	目玉焼
めぞぴあの	mezzo piano
めじろどお	目白通
めじろかん	目白間
めじろおし	目白押し	目白押
めしつかい	召使	召使い	召し使い
めぐろどお	目黒通
めぐろがわ	目黒川
めぐろえき	目黒駅
めぐりめぐ	巡り巡
めぐりあい	巡り合い
めくるめく	目眩く
めくらばん	盲判
めきゃべつ	芽キャベツ
めがみぞう	女神像
めがみさま	女神様
めがねばし	眼鏡橋
めがねてん	眼鏡店
めがねっこ	眼鏡っ娘	メガネっ娘
めかません	目蒲線
めかけばら	妾腹
めいわくど	迷惑度
めいわくか	迷惑掛
めいろない	迷路内
めいれいご	命令語
めいりょう	明瞭
めいりゅう	名流
めいもんく	名文句
めいみゃく	命脈
めいぶんか	明文化
めいぶつし	名物紙
めいびゅう	迷謬
めいひょう	名票
めいばめん	名場面	迷場面
めいどふく	メイド服
めいっぱい	目一杯
めいちょう	明徴	迷鳥	明澄
めいちゅう	命中
めいぜりふ	名台詞
めいすいり	名推理
めいじんい	名人位
めいじょう	名城	名状
めいじゃく	名弱
めいじむら	明治村
めいじばし	明治橋
めいじどお	明治通
めいじてき	明示的
めいじだい	明治大
めいじせん	明治戦
めいじいご	明治以後
めいしんか	迷信家
めいしょく	明色
めいしょう	名称	鳴鐘	名匠	名相	名将	明証	名勝
めいしばん	名刺判
めいしてき	名詞的
めいしせつ	名詞節
めいしけい	名詞形
めいさんち	名産地
めいげつき	明月記
めいげかい	名外科医
めいぎにん	名義人
めいぎがし	名義貸し
めいきょく	名局	名曲
めいきょう	明鏡
めいきゅう	迷宮
めいかんぶ	名幹部
めいかくか	明確化
めいえんぎ	名演技
めいうせん	名羽線
めいあらし	明嵐
めーるびん	メール便
むろらんし	室蘭市
むろたけん	室田研
むりょうか	無料化
むりむたい	無理無体
むりからぬ	無理からぬ
むらやくば	村役場
むらむすめ	村娘
むらまつり	村祭	村祭り
むらはちぶ	村八分
むらすずめ	群雀
むらさきの	紫野
むらおこし	村起こし
むもくてき	無目的
むめんきょ	無免許
むめいすう	無名数
むむじゅん	無矛盾
むほんにん	謀反人
むほしょう	無保証
むほきゅう	無補給
むほうもの	無法者
むほうしゃ	無法者
むべんべつ	無弁別
むへんざい	無辺際
むへんこう	無変更
むへんけい	無変形
むへんかん	無変換
むふんべつ	無分別
むびよくき	無尾翼機
むひょうじ	無表示
むひきすう	無引数
むばんそう	無伴奏
むはんのう	無反応
むはんせい	無反省
むはんしゃ	無反射
むはいりょ	無配慮
むはいとう	無配当
むのうやく	無農薬
むのうしゃ	無能者
むねまわり	胸囲り
むねがわら	棟瓦
むにむさん	無二無三
むなさわぎ	胸騒ぎ
むないよう	無内容
むとくてん	無得点
むとうろく	無登録
むとうせい	無統制
むてんぼん	無点本
むてんとう	無転倒
むてっぽう	無鉄砲
むてじゅん	無手順
むていでん	無停電
むていしゃ	無停車
むていこう	無抵抗
むていけん	無定見
むていけい	無定形	無定型
むつれじま	六連島
むつうせい	無痛性
むつうしん	無通信
むちつじょ	無秩序
むだんかい	無段階
むだばなし	無駄話
むだづかい	無駄遣い	徒遣い	無駄使い
むだじかん	無駄時間
むたいぶつ	無体物
むそんしつ	無損失
むそうやま	武双山
むそうてき	夢想的
むそうかん	無相関
むぜんてい	無前提
むぜいひん	無税品
むせんよう	無線用
むせんまい	無洗米
むせんとじ	無線綴じ
むせんけん	無線研
むせんぎし	無線技師
むせんきや	無線機屋
むせんきき	無線機器
むせんかい	無線界
むせってん	無接点
むせってい	無設定
むせっそう	無節操
むせきにん	無責任
むせいらん	無精卵
むせいぶつ	無生物
むせいげん	無制限
むせいおん	無声音
むずかしさ	難しさ
むすめやく	娘役
むすめむこ	娘婿
むすびとじ	結び綴じ
むすびつき	結び付き
むすびかた	結び方
むすこたち	息子達
むすいなべ	無水鍋
むじんとう	無人島
むじんぞう	無尽蔵
むじんせん	無人船
むじんえき	無人駅
むしんろん	無神論
むしんこく	無申告
むしんこう	無信仰
むしんけい	無神経
むしりょく	無資力
むしょぞく	無所属
むしゅぶつ	無主物
むしゅうさ	無収差
むしゃけん	無車検
むしめがね	虫メガネ	虫めがね	虫眼鏡
むしふうじ	虫封じ
むしのいき	虫の息
むしていじ	無指定時
むしつかい	蟲使い
むしってん	無失点
むしさされ	虫刺され
むしぐすり	虫薬
むしくだし	虫下し
むしきかい	無色界
むしかえし	蒸し返し
むざせきか	無座席化
むさぼりく	貪り食	貪り喰
むさしまる	武蔵丸
むさしのし	武蔵野市
むさしだい	武蔵台	武蔵大
むさしせき	武蔵関
むごんげき	無言劇
むこんきょ	無根拠
むこようし	婿養子
むこのそう	武庫之荘
むこくせき	無国籍
むこくいん	無刻印
むこうみず	向こう見ず
むこうまち	向日町
むこうせい	無効性
むこうずね	向う脛	向こう脛
むこうじま	向島
むこうきず	向こう疵
むこうがわ	向こう側
むこうがい	無公害
むこうかん	無交換
むこういん	無効印
むげんれつ	無限列
むげんてき	夢幻的
むげんてい	無限定
むげんだい	∞	無限大
むげんそく	無原則
むげんせい	無限性
むげんけい	無限系
むげんかい	無限回
むげんえん	無限遠
むげんあつ	無限厚
むけんしき	無見識
むけってい	無決定
むけいぶつ	無形物
むけいかく	無計画
むぎばたけ	麦畑
むぎこがし	麦焦がし
むきりょく	無気力
むきょだく	無許諾
むきゅうゆ	無給油
むきふむき	向き不向き
むきにゅう	無記入
むききんこ	無期禁錮
むきかがく	無機化学
むきえんき	無期延期
むがくしゃ	無学者
むかんどう	無感動
むかんしん	無関心
むかんけい	無関係
むかんがえ	無考え
むかんかく	無感覚
むかっぱら	向かっ腹
むかじゅう	無荷重	無果汁
むかしふう	昔風
むかしなつ	昔懐
むかきゅう	無過給
むかえかく	迎え角
むかいやま	向山
むかいへん	無改変
むかいはら	向原
むかいなだ	向洋
むかいとう	無回答
むかいたに	向谷
むかいぞう	無改造
むかいしま	向島
むかいさつ	無改札
むかいがわ	向川
むかいかぜ	向い風	向かい風
むおんせい	無音声
むおうとう	無応答
むえんぼち	無縁墓地
むえんたん	無煙炭
むいちもん	無一文
むいちぶつ	無一物
むいしぜん	無為自然
むいしきか	無意識下
むいかまち	六日町
むいかいち	六日市
むあつしき	無圧式
みんりょく	民力
みんぶんか	明文化
みんちょう	明朝
みんたろう	民太郎
みんぞくし	民族誌
みんぞくご	民族語
みんせいぶ	民生部
みんせいき	民生機
みんじょう	民情
みんじてき	民事的
みんしゅく	民宿
みんしゅか	民主化
みんしゅう	民衆
みんぎょう	民業
みんかんき	民間機
みんかへい	民家塀
みんえいか	民営化
みわくてき	魅惑的
みれんらく	未連絡
みるからに	見るからに
みりんぼし	味醂干し	味醂干
みりんかい	未臨界
みりんあじ	味醂味
みりぐらむ	瓱
みらいよち	未来予知
みらいへん	未来編
みらいとし	未来都市
みらいてき	未来的
みらいぞう	未来像
みらいじん	未来人
みらいけい	未来形
みらいがた	未来型
みらいがく	未来学
みょんどん	明洞
みょうれん	明連
みょうれい	妙齢
みょうよう	妙用
みょうやく	妙薬
みょうもん	名聞
みょうもく	名目
みょうほう	妙法
みょうばん	明礬	明晩
みょうねん	明年
みょうにち	明日
みょうちん	明珍
みょうだに	名谷
みょうだい	名代
みょうぜつ	妙絶
みょうせき	名跡
みょうじん	明神
みょうしょ	妙所
みょうしゅ	妙趣	妙手
みょうさく	妙策
みょうごう	名号
みょうこう	妙高
みょうけん	妙見
みょうけい	妙計
みょうかい	冥界
みょうおん	妙音
みょうおう	明王
みょうあん	妙案
みょうあさ	明朝
みゆにゅう	未輸入
みゆきせん	美幸線
みやまえく	宮前区
みやまいり	宮参り
みやのぼり	宮登
みやのさわ	宮の沢
みやのうえ	宮之上
みやづせん	宮津線
みやづかえ	宮仕え
みやだいく	宮大工
みやじょう	宮絛
みやざきし	宮崎市
みやこわん	宮古湾
みやこびと	都人
みやこどり	都鳥
みやこじま	宮古島	都島
みやこおち	都落ち
みやこいり	都入り
みやげよう	土産用
みやげもの	土産物
みやげひん	土産品
みやけじま	三宅島
みやけざか	三宅坂
みやぎのく	宮城野区
みやぎしま	宮城島
みやぎけん	宮城県
みやきょう	宮教
みやいだい	宮医大
みゃくらく	脈絡
みゃくはく	脈搏	脈拍
みゃくどう	脈動
みゃくけい	脈系
みゃくかん	脈管
みゃくあつ	脈圧
みもりまる	美森丸
みめうるわ	見目麗
みみぶくろ	耳袋
みみないぶ	耳内部
みみどしま	耳年増
みみそうじ	耳掃除
みみずばれ	蚯蚓脹れ
みみざわり	耳触り	耳障り
みみかざり	耳飾り	耳飾
みみかくし	耳隠し
みみいがい	耳以外
みみあたら	耳新
みまちがい	見間違い
みまいもう	見舞申
みまいきん	見舞金
みぼうじん	未亡人
みほんひん	見本品
みほんずり	見本刷
みほんいち	見本市
みほのせき	美保関
みほそうろ	未舗装路
みほしょう	未保証
みほうそう	未放送
みほうしゃ	未放射
みほうえい	未放映
みへんとう	未返答
みへんかん	未変換
みひょうか	未評価
みひつてき	未必的
みひじゅん	未批准
みはるえき	三春駅
みはりやく	見張り役
みはりばん	見張り番
みはつばい	未発売
みはったつ	未発達
みはっけん	未発見
みはいそう	未配送
みのまわり	身の回り
みのぶせん	身延線
みのぶさん	身延山
みのとぐち	美濃戸口
みのしょう	美濃庄
みのがこい	美濃囲い
みのおせん	箕面線
みのおおた	美濃太田
みのうぶん	未納分
みのうしゃ	未納者
みねのはら	峰の原
みなもとけ	源家
みなみゆふ	南由布
みなみゆき	南行
みなみもん	南門
みなみもと	南本
みなみむろ	南牟婁
みなみむれ	南牟礼
みなみむら	南村
みなみむき	南向き
みなみまち	南町
みなみまき	南牧
みなみなす	南那須
みなみなか	南那珂
みなみでわ	南出羽
みなみつる	南都留
みなみちた	南知多
みなみちく	南地区
みなみだて	南館
みなみだか	南高
みなみだい	南台
みなみたま	南多摩
みなみたか	南高
みなみせん	南線
みなみしが	南志賀
みなみさく	南佐久
みなみこま	南巨摩
みなみぐち	南口
みなみがわ	南側
みなみかん	南館	南舘
みなみかわ	南河
みなみかた	南方
みなみかぜ	南風
みなみうわ	南宇和
みなみいず	南伊豆
みなまたし	水俣市
みなべがわ	南部川
みなのもの	皆の者
みなとまち	港街	港町	湊町
みなとふじ	湊富士
みなとがわ	湊川
みなごろし	皆殺し	鏖
みどろいけ	深泥池
みどりやま	緑山
みどりまめ	緑豆
みどりまち	緑町
みどりまい	緑米
みどりがめ	緑亀
みどりかわ	緑川
みどりかい	緑会
みどりいろ	緑色
みどくぶん	未読分
みどくきじ	未読記事
みどうすじ	御堂筋
みとめいん	認め印	認印
みとにこう	水戸二高
みとせいぶ	水戸西武
みとうろく	未登録
みとうさい	未搭載
みとうこう	未投稿
みといずみ	水戸泉
みていねん	未丁年
みていこう	未定稿
みていぎご	未定義語
みづくろい	身繕い
みつりょう	密猟	密漁
みつゆせん	密輸船
みつめなお	見つめ直	見詰め直
みつどもえ	三つ巴
みつぞろい	三つ揃い
みつぎもの	貢ぎ物
みつがさね	三つ重ね
みっぺいど	密閉度
みっちゃく	密着
みっしょく	密植
みっしゅう	密集
みっきょう	密教
みっかかん	三日間
みっかいち	三日市
みちわしゃ	未知話者
みちょうさ	未調査
みちょうか	未超過
みちぶしん	道普請
みちびきだ	導き出
みちのなか	道の中
みちのえき	道の駅
みちなかば	道半ば
みちたろう	道太郎	美知太郎
みちじゅん	道順
みちしるべ	道標
みだればん	乱れ版
みだれがみ	みだれ髪	乱れ髪
みだしなみ	身嗜み	身だしなみ
みたんさく	未探索
みたよしこ	三田佳子
みたかせん	三鷹線
みたかかん	三鷹間
みたかえき	三鷹駅
みたいしょ	未対処
みたいけん	未体験
みたいおう	未対応
みぞのくち	溝の口
みそにこみ	味噌煮込
みそっかす	味噌っ滓
みそさざい	鷦鷯
みそくばく	未束縛
みそくてい	未測定
みぜんけい	未然形
みせんたく	未選択
みせんげん	未宣言
みせびらき	店開き
みせどころ	見せ所
みせつぞく	未接続
みせってい	未設定
みせじまい	店仕舞い	店仕舞	店じまい
みせじたい	店自体
みせがまえ	店構え
みせいねん	未成年
みせいせい	未生成
みずまくら	水枕
みずへびざ	水蛇座
みずぶんし	水分子
みずぶとり	水太り
みずぶそく	水不足
みずぶくれ	水脹れ
みずびたし	水浸し
みずばしら	水柱
みずのもり	水の森
みずのみば	水飲み場
みずのとみ	癸巳
みずのとう	癸卯
みずのとい	癸亥
みずのけん	水野研
みずのえね	壬子
みずのえき	水野駅
みずのあわ	水の泡
みずどけい	水時計
みずたまり	水溜まり	水溜
みずすまし	水澄
みずしらず	見ず知らず
みずしまや	水島屋
みずしぶき	水飛沫
みずしごと	水仕事
みずしげん	水資源
みずさわし	水沢市
みずごころ	水心
みずこぼし	水翻
みずけむり	水煙
みずぐるま	水車
みずぐすり	水薬
みずくぼこ	水窪湖
みずくさい	水臭い
みずぎょう	水行
みずききん	水飢饉
みずがめざ	水瓶座
みずがかり	水掛
みずかげん	水加減
みずかがみ	水鏡
みずいらず	水入らず
みずあらい	水洗い
みずあそび	水遊び
みずあさぎ	水浅葱
みずあかと	水垢取
みすぎさと	三杉里
みすぎいそ	三杉磯
みすいざい	未遂罪
みじんぎり	微塵切り
みじゅこう	未受講
みじゅくじ	未熟児
みじっそう	未実装
みしようじ	未使用時
みしょぶん	未処分
みしょきか	未初期化
みしょうり	未勝利
みしょうか	未消化
みしゅとく	未取得
みしゅうり	未修理
みしまえき	三島駅
みしきべつ	未識別
みさわやま	実沢山
みさわえき	三沢駅
みさごずし	鶚鮨
みさくせい	未作成
みさきこう	三崎港
みさきぐち	三崎口
みさいぶん	未済分
みごとかえ	見事返
みごしらえ	身拵え
みごうしゃ	見巧者
みこんしゃ	未婚者
みこみがく	見込額
みことのり	敕	勅	詔
みこうかい	未公開
みけんとう	未検討
みけんせつ	未建設
みけってい	未決定
みけっさい	未決済
みけいやく	未契約
みけいさん	未計算
みけいさい	未掲載
みけいけん	未経験
みくらしま	御蔵島
みくにやま	三国山
みぎようそ	右要素
みぎめよう	右目用
みぎまわり	右回り
みぎまがり	右曲り
みぎぼたん	右ボタン
みぎひだり	右左
みぎどなり	右隣り	右隣
みぎてよう	右手用
みぎてまえ	右手前
みぎてけい	右手系
みぎてくび	右手首
みぎてがわ	右手側
みぎだせき	右打席
みぎだしゃ	右打者
みぎそろえ	右揃え
みぎしもて	右下手
みぎかっこ	右括弧	】	』
みぎうしろ	右後
みきにゅう	未記入
みきたけお	三木武夫
みがきずな	磨き砂
みかんもく	Rutales	ミカン目
みかんばこ	みかん箱
みかんせい	未完成
みかんけつ	未完結
みかわわん	三河湾
みかわもの	三河者
みかわべん	三河弁
みかわせん	三河線
みかわしま	三河島
みかにゅう	未加入
みかづきこ	三日月湖
みかたはら	三方原
みかたがわ	味方側
みかげいし	御影石
みかくにん	未確認
みかくてき	味覚的
みかくてい	未確定
みかいめい	未解明
みかいふう	未開封
みかいとう	未回答
みかいつう	未開通
みかいたく	未開拓
みかいせき	未解析
みかいじん	未開人
みかいけつ	未解決
みおつくし	澪標
みえっぱり	見栄張り	見栄っ張り
みえがくれ	見え隠れ
みえかくれ	見え隠れ	見えかくれ
みうらわん	三浦湾
みうらきた	美浦北
みいけこう	三池港
まんりょう	万両	満了
まんゆうき	漫遊記
まんぽけい	万歩計
まんぷくじ	万福寺
まんぴょう	満票	漫評
まんびょう	万病
まんばけん	万馬券
まんどころ	政所
まんてんか	満天下
まんちょう	満潮
まんちゃく	瞞着
まんたんい	万単位
まんぞくど	満足度
まんせきじ	満席時
まんせいか	慢性化
まんじょう	満場
まんじゅう	饅頭
まんしょく	万色
まんしょう	満床
まんしゅう	滿洲	満州
まんざいし	漫才師
まんげつじ	満月時
まんぎょう	万行
まんきじつ	満期日
まんがぼん	マンガ本
まんがほん	漫画本
まんがばん	漫画版
まんがてき	漫画的
まんがかい	漫画界
まんがおう	漫画王
まんがいち	万が一
まわれみぎ	回れ右
まわりみち	回り道
まわりばな	回り花
まわりずみ	回り炭
まわりえん	回り縁
まわしもの	回し者
まわしげり	廻し蹴り
まるもうけ	丸儲け
まるめごさ	丸め誤差	丸目誤差
まるぽちゃ	丸ぽちゃ
まるぼうず	丸坊主
まるばやし	丸林
まるばしら	丸柱
まるはだか	丸裸
まるのうち	丸の内	丸ノ内
まるにねん	丸二年
まるどけい	丸時計
まるつぶれ	丸潰れ
まるたまち	丸太町
まるせっぷ	丸瀬布
まるせいゆ	馬耳塞
まるすうじ	丸数字
まるじるし	丸印
まるしょう	丸正
まるこばし	丸子橋
まるきゅう	丸久
まるがめし	丸亀市
まるがかえ	丸抱え
まるかっこ	丸括弧
まるかじり	丸かじり	丸齧り
まるうつし	丸写し
まるあんき	丸暗記
まるあらい	丸洗い
まりしてん	摩利支天
まりこうじ	鞠小路
まよいねこ	迷い猫
まよいいぬ	迷い犬
まやくろん	麻薬論
まやくてき	麻薬的
まやくせい	麻薬性
まもりふだ	守り札
まもりとお	守り通
まもりつづ	守り続
まもりがみ	守り神
まものたち	魔物達
まめもよう	豆模様
まめちしき	豆知識
まめしぼり	豆絞り
まめきゅう	豆球
まめあぶら	豆油
まむろがわ	真室川
まほりかん	馬堀間
まほうびん	魔法瓶
まほうてき	魔法的
まほうつか	魔法使
まほうせん	魔法戦
まほうせき	魔法石
まほうじん	魔法陣	魔方陣
まほうしょ	魔法書
まほうけん	魔法剣
まほうがい	魔法街
まふじえき	間藤駅
まのあたり	目の当たり
まねきねこ	招き猫
まぬけづら	間抜面
まにんげん	真人間
まにらあさ	マニラ麻
まにあわせ	間に合せ	間に合わせ
まなむすめ	愛娘
まながつお	真魚鰹
まどりーど	馬徳里
まどはいち	窓配置
まどのうち	窓の中
まどちょう	窓長
まどがらす	窓ガラス
まどうしょ	魔導書
まとわりつ	纏わり付
まとはずれ	的外れ
まとうだい	的鯛
まてんろう	摩天楼
まつわこう	松輪港
まつりゅう	末流
まつりごと	祭事	政
まつやまし	松山市
まつもむし	松藻虫
まつもとし	松本市
まつまえづ	松前漬
まつぶさか	Schisandraceae	マツブサ科
まつばらこ	松原湖
まつばやし	松林
まつばづえ	松葉杖
まつばがに	松葉蟹
まつばいろ	松葉色
まつのやま	松之山
まつのうち	松の内
まつとうや	松任谷
まつだぐみ	松田組
まつだいら	松平
まつたろう	松太郎
まつざかや	松坂屋
まつごろう	松五郎	松吾郎
まつがさき	松ヶ崎
まつがおか	松が丘
まつかざり	松飾り
まつえはん	松江藩
まっぷたつ	真っ二つ
まっぴるま	真っ昼間	真昼間
まっぱだか	真っ裸
まっとうや	松任谷
まっとうし	松任市
まっちょう	末長
まっちばこ	マッチ箱
まったなし	待った無し
まったいら	真っ平ら
まっしょう	末梢	抹消
まっしゅう	末秋
まっしぐら	驀地
まっさかり	真っ盛り
まっくろけ	真っ黒け
まっきゃく	末脚
まっきてき	末期的
まっきがん	末期癌
まっかっか	真赤っか
まちやっこ	町奴
まちやくば	町役場
まちむすめ	街娘	町娘
まちぼうけ	待ちぼうけ	待ち惚け
まちはずれ	町外れ
まちぢゅう	町中
まちだてん	町田店
まちだかん	町田間
まちだえき	町田駅
まちじゅう	町中	街中
まちじかん	待ち時間	待時間
まちこうば	町工場
まちくたび	待ち草臥
まちいしゃ	町医者
まちあわせ	待合	待ち合わせ	待合せ
まちあるき	街歩き
まだらゆき	斑雪
まためがね	股眼鏡
またひばち	股火鉢
またどなり	又隣
まただのみ	又頼み
またたくま	瞬く間
またいとこ	又従兄弟	又従姉妹
まぜごはん	混ぜ御飯
ますじろう	益治郎
ますかがみ	増鏡
ますいやく	麻酔薬
ますいかい	麻酔科医
まじょがり	魔女狩り
まじょおう	魔女王
まじゅつし	魔術師
まじないし	呪い師
ましゅうこ	摩周湖
ましばがき	真柴垣
ましこやき	益子焼
まさつおん	摩擦音
まさかどき	将門記
まごめえき	馬込駅
まごむすめ	孫娘
まけじあい	負け試合
まけぎらい	負け嫌い
まけおしみ	負け惜しみ
まけいくさ	負け軍	負け戦
まぐさおけ	秣桶
まくわうり	真桑瓜
まくらもと	枕元
まくらめし	枕飯
まくらぼん	枕本
まくらざき	枕崎
まくらがみ	枕上	枕紙
まくのうち	幕の内
まくでんい	膜電位
まぎらわし	紛らわし
まきもどし	巻き戻し
まきばしら	真木柱
まきのはら	牧の原
まきのこう	牧の郷	牧之郷
まきのうち	牧之内
まきじゃく	巻尺
まきかえし	巻き返し
まきおとし	巻き落とし
まがりなり	曲がり形	曲り形
まがりかど	曲り角
まがいもの	紛い物	擬物	紛物
まかりとお	罷り通
まかふしぎ	摩可不思議	摩訶不思議
まかいむら	魔界村
まかいとし	魔界都市
まかいじん	魔界人
まえわたし	前渡し
まえやまだ	前山田
まえもって	前以て	豫て	前もって
まえばらい	前払い	前払
まえばしし	前橋市
まえのめり	前のめり
まえどまり	前泊
まえどなり	前隣
まえどうさ	前動作
まえだおし	前倒し
まえずもう	前相撲
まえじらせ	前知らせ
まえしょり	前処理
まえさがり	前下がり
まえこぐち	前小口
まえこうか	前効果
まえげいき	前景気
まえがしら	前頭
まえかがみ	前屈み
まえうしろ	前後ろ
まえいわい	前祝い	前祝
まいびょう	毎秒
まいばしょ	毎場所
まいのうみ	舞の海
まいそうち	埋葬地
まいせいじ	毎正時
まいじかん	毎時間
まいしょく	毎食
まいしゅう	毎週
まいしあい	毎試合
まいくろは	マイクロ波
まいおさめ	舞い納め
まいいがい	枚以外
まいあきら	舞アキラ
まあじゃん	麻雀
まーじゃん	麻雀
もんもうしゃ	文盲者
もんべつえき	紋別駅
もんぶしょう	文部省
もんはぶたえ	紋羽二重
もんどうほう	問答法
もんどうへん	問答篇
もんだいれい	問題例
もんだいぶん	問題文
もんだいなし	問題無
もんだいてん	問題点
もんだいせい	問題性
もんだいすう	問題数
もんだいさく	問題作
もんだいきじ	問題記事
もんだいがい	問題外
もんだいあり	問題有
もんぜんまち	門前町
もんぜんばら	門前払
もんじょかん	文書館
もんきりがた	紋切型
もんがいかん	門外漢
もんかんばん	紋看板
もんかろくじ	門下録事
もんかじろう	門下侍郎
もんかしょう	文科省
もりらんまる	森蘭丸
もりつちしき	盛土式
もりだくさん	盛り沢山	盛沢山
もりしんいち	森進一
もりしたがみ	森下紙
もりおうがい	森鴎外
もりあげかた	盛りあげ方
もらいっぱな	貰いっ放
もよおしもの	催物	催し物
もめんどうふ	木綿豆腐
もみじばふう	モミジ葉楓	紅葉葉楓
もみじおろし	紅葉卸し
もはんじあい	模範試合
もはんしゅう	模範囚
もはんこうい	模範行為
もはんえんぎ	模範演技
ものみゆさん	物見遊山
ものみやぐら	物見櫓
ものほしだい	物干台
ものほしざお	物干し竿
もののあわれ	物の哀れ
ものたりない	物足りない
ものしりがお	物知り顔
ものうらやみ	物羨み
ものいっぱん	物一般
ものあらそい	物争い
もぬけのから	蛻けの殻
もどりてがた	戻手形	戻り手形
もとよこづな	元横綱
もとやまかん	本山間
もとまちえき	元町駅
もとまくうち	元幕内
もとひろしま	元広島
もとばこづき	元箱付
もとはんしん	元阪神
もとどくしゃ	元読者
もととうだい	元東大
もととうしゅ	元投手
もとでんきや	元電気屋
もとだいじん	元大臣
もとたいいん	元隊員
もとせんしゅ	元選手
もとせきわけ	元関脇
もとすみよし	元住吉
もとじょうし	元上司
もとしんぱん	元審判
もとしんじゃ	元信者
もとしりょう	元資料
もとしゃいん	元社員
もとごうかく	元合格
もとこむすび	元小結
もとこくてつ	元国鉄
もとこくさい	元国際
もとぐんじん	元軍人
もといあんふ	元慰安婦
もとあいぼう	元相棒
もっともやく	尤役
もってのほか	以ての外
もったいない	勿体ない	勿体無い
もっこうよう	木工用
もっかんぐん	木管群
もちこみうま	持込馬
もちかぶかい	持株会
もじれつがた	文字列型
もじほうそう	文字放送
もじへんすう	文字変数
もじへんこう	文字変更
もじひょうじ	文字表示
もじひょうき	文字表記
もじはいれつ	文字配列
もじにんしき	文字認識
もじとくてん	文字得点
もじていすう	文字定数
もじつうしん	文字通信
もじたんまつ	文字端末
もじたいだん	文字対談
もじたいけい	文字体系
もじたいおう	文字対応
もじしゅるい	文字種類
もじさくじょ	文字削除
もじかんかく	文字間隔
もじかくてい	文字確定
もじえきがわ	門司駅側
もじいじょう	文字以上
もさくちゅう	模索中
もけいざっし	模型雑誌
もぐらたたき	モグラ叩き	土竜叩き
もくろみしょ	目論見書
もくれんもく	Magnoliales	モクレン目
もくめもよう	木目模様
もくひょうち	目標値
もくひょうき	目標機
もくてきろん	目的論
もくてきべつ	目的別
もくてきぶつ	目的物
もくてきぜい	目的税
もくてきごと	目的毎
もくてきがわ	目的側
もくてきがい	目的外
もくてきかく	目的格
もくてきおん	目的音
もくてきえき	目的駅
もくてきいん	目的因
もくせいもく	モクセイ目	Oleales
もくせいめん	木星面
もくしけんさ	目視検査
もくざいこう	木材港
もくこうぞう	木構造
もくげきだん	目撃談
もくげきしゃ	目撃者
もぎじっけん	模擬実験
もぎしゅほう	模擬手法
もぎさいばん	模擬裁判
もうろうたい	朦朧体
もうようたい	毛様体
もうもくてき	盲目的
もうまくえん	網膜炎
もうひつたい	毛筆体
もうはんぱつ	猛反発
もうはんたい	猛反対
もうはんげき	猛反撃
もうはつよう	毛髪用
もうどうけん	盲導犬
もうとっくん	猛特訓
もうだしょう	猛打賞
もうたくとう	毛沢東
もうたいかく	毛帯核
もうそうちく	孟宗竹
もうせんごけ	毛氈苔
もうしひらき	申し開き
もうしこみび	申込日
もうしこみじ	申込時
もうしこみご	申込後
もうしあわせ	申し合せ	申し合わせ	申合せ
もうさいかん	毛細管
もうこしょう	蒙古症
もうこうねん	孟浩然
もうこうげき	猛攻撃
もうけばなし	儲け話
もうきんるい	猛禽類
もうがっこう	盲学校
もーどぎょう	モード行
めんれんけつ	面連結
めんどうくさ	面倒臭
めんぜんちん	門前清
めんぜいひん	免税品
めんぜいてん	免税点	免税店
めんぜいさく	免税策
めんせつしつ	面接室
めんせつかん	面接官
めんせきぶん	面積分
めんせきがく	免責額
めんこうげん	面光源
めんけつごう	面結合
めんきょにん	免許人
めんきょせい	免許制
めんきょしょ	免許書
めんかいしつ	面会室
めんおりもの	綿織物
めんえきたい	免疫体
めんえきせい	免疫性
めんえきけい	免疫系
めやすひょう	目安表
めやすていど	目安程度
めぶんりょう	目分量
めぬきどおり	目抜き通り
めったやたら	滅多矢鱈
めっきんまえ	滅菌前
めっきんずみ	滅菌済み
めちゃめちゃ	滅茶滅茶
めちゃくちゃ	滅茶苦茶	目茶苦茶
めだまぜんぶ	目玉全部
めだまじいん	目玉寺院
めだまきかく	目玉企画
めぞふぉるて	mezzo forte
めしぢゃわん	飯茶碗
めぐろげしゃ	目黒下車
めぐろくみん	目黒区民
めぐろきねん	目黒記念
めくされがね	目腐れ金
めがねちがい	眼鏡違い
めいわくもの	迷惑者
めいわきやく	名脇役
めいれいれつ	命令列
めいれいもと	命令元
めいれいほう	命令法
めいれいぶん	命令文
めいれいすう	命令数
めいれいしょ	命令書
めいれいけい	命令形
めいれいぐん	命令群
めいれいがた	命令型
めいりんどう	明林堂	明倫堂
めいりんかん	明倫館
めいりょうど	明瞭度
めいよだんい	名誉段位
めいよしょく	名誉職
めいよごせい	名誉碁聖
めいよこづな	名横綱
めいよきそん	名誉毀損	名誉棄損
めいよおうざ	名誉王座
めいもんこう	名門校
めいめいほう	命名法
めいめいしゃ	命名者
めいめいしき	命名式
めいめいけん	命名権
めいへんこう	名変更
めいふまどう	冥府魔道
めいでんしゃ	明電舎
めいでんこう	名電高
めいてんがい	名店街
めいてんかい	名展開
めいちょうし	名調子
めいだいまえ	名大前	明大前
めいだいない	名大内
めいだいこう	名大工
めいたんてい	名探偵
めいそうほう	瞑想法
めいそうてき	瞑想的
めいせんしゅ	名選手
めいすうほう	命数法
めいじんせん	名人戦
めいじんげい	名人芸
めいじどおり	明治通り
めいじつとも	名実共
めいじせいか	明治製菓
めいじじだい	明治時代
めいじしょき	明治初期
めいじいらい	明治以来
めいじいぜん	明治以前
めいじいしん	明治維新
めいじいこう	明治以降
めいしょずえ	名所図会
めいしょうぶ	名勝負
めいしかんり	名刺管理
めいさんぼう	名参謀
めいさんひん	名産品
めいさいふく	迷彩服
めいさいしょ	明細書
めいこうだい	名工大
めいげついん	明月院
めいけいどう	茗渓堂
めいぎじょう	名義上
めいきんせん	名金線
めいきゅうい	迷宮入
めいがらごと	銘柄毎
めいがくだい	明学大
めいかんとく	名監督
めいおうせい	冥王星
めいえんそう	名演奏
むろとみさき	室戸岬
むりょくかん	無力感
むりょうじゅ	無量寿
むりょうけん	無料券
むりなんだい	無理難題
むりさんだん	無理算段
むらやくにん	村役人
むらびとたち	村人達
むらたじょし	村田女子
むらたきかい	村田機械
むらさきもく	Biorraginales	ムラサキ目
むらさきうに	紫海胆
むらさきいろ	紫色
むらさきいも	紫芋
むゆうびょう	夢遊病
むもうしょう	無毛症
むめいじゅく	無名塾
むみむしゅう	無味無臭
むみかんそう	無味乾燥
むぼうふざい	無防腐剤
むほけんしゃ	無保険車
むほうちたい	無法地帯
むほうしゅう	無報酬
むへんちょう	無変調
むびゅうせい	無謬性
むのうりょく	無能力
むねんむそう	無念無想
むねぽけっと	胸ポケット
むねざんよう	胸算用
むねさんずん	胸三寸
むねいっぱい	胸一杯
むねあげしき	棟上式
むなざんよう	胸算用
むとんちゃく	無頓着
むとうひょう	無投票
むとうはそう	無党派層
むとうかしゃ	無燈火車
むでんくかん	無電区間
むてんぽがた	無店舗型
むてきぶぶん	無敵部分
むていりょう	無定量
むちょうせい	無調整
むちゅうせん	無抽選
むちゃくりく	無着陸
むちゃくちゃ	無茶苦茶
むちもうまい	無知蒙昧
むちつじょか	無秩序化
むだんしよう	無断使用
むせんようご	無線用語
むせんでんわ	無線電話
むせんでんぱ	無線電波
むせんせつび	無線設備
むせんしかく	無線資格
むせんざっし	無線雑誌
むせんきるい	無線機類
むせんきょく	無線局
むせんいがい	無線以外
むせってんか	無接点化
むせっしょく	無接触
むせきにんか	無責任化
むせいせだい	無性世代
むせいしおん	無声子音
むせいしいん	無声子音
むすめじだい	娘時代
むすめざかり	娘盛り
むじょうけん	無条件
むじょうかん	無常観
むじゅんりつ	矛盾律
むじゅんてん	矛盾点
むじゅんせい	矛盾性
むじかくてき	無自覚的
むしょくしゃ	無職者
むしゅくもの	無宿者
むしゅうせい	無修正
むしゃぶるい	武者震い
むしゃぶりつ	武者振り付
むしむしゅう	無始無終
むしまんるい	無死満塁
むしつりょう	無質量
むしこうせい	無指向性
むしかくしゃ	無資格者
むさしのせん	武蔵野線
むさしのかん	武蔵野館
むさしさかい	武蔵境
むさしこやま	武蔵小山
むさしこすぎ	武蔵小杉
むさしうらわ	武蔵浦和
むさいしょく	無彩色
むごんでんわ	無言電話
むこがわせん	武庫川線
むこがわえき	武庫川駅
むこうりょう	無香料
むこうひょう	無効票
むこうちょう	向日町
むこうじあい	無効試合
むこうがおか	向ヶ丘	向ケ丘
むこいりこん	婿入り婚
むげんれんさ	無限連鎖
むげんるーぷ	無限ループ
むげんりすと	無限リスト
むげんちょう	無限長
むげんじごく	無間地獄
むげんじげん	無限次元
むげんしんし	夢幻紳士
むげんしょう	無限小
むげんこうり	無限公理
むげんきどう	無限軌道
むけんだいり	無権代理
むけんじごく	無間地獄
むくろじもく	Sapindales	ムクロジ目
むぎわらぼう	麦藁帽
むきょくせい	無極性
むきょうよう	無教養
むきょうしつ	無響室
むきょういく	無教育
むきゅうどう	無窮動
むきめいしき	無記名式
むきひりょう	無機肥料
むきしつてき	無機質的
むがむちゅう	無我夢中
むかんじょう	無感情
むかんしょう	無干渉
むかべんるい	Apetalae	無花弁類
むかしむかし	昔々	昔昔
むかしばなし	昔話
むかしにほん	昔日本
むかしとんぼ	昔蜻蛉
むかしごころ	昔心
むかしがたり	昔語り
むかいがわら	向河原
むかいがおか	向ケ丘
むおんくかん	無音区間
むえんぼとけ	無縁仏
むえんたばこ	無煙煙草
むいとしょく	無為徒食
むいしきてき	無意識的
むあっしゅく	無圧縮
みんわしゅう	民話集
みんようふう	民謡風
みんゆうりん	民有林
みんみんぜみ	みんみん蝉
みんぽうだい	民法第
みんてつせん	民鉄線
みんぞくめい	民族名
みんぞくむら	民族村
みんぞくふく	民族服
みんぞくてき	民族的
みんぞくせい	民族性
みんぞくがみ	民族神
みんぞくがく	民俗学	民族学
みんぞくかん	民族間
みんせいよう	民生用
みんせいひん	民製品	民生品
みんしゅとう	民主党
みんしゅてき	民主的
みんしゅせい	民主制	民主性
みんしゅこく	民主国
みんしゃとう	民社党
みんげいひん	民芸品
みんかんじん	民間人
みんえいかご	民営化後
みりんかいど	未臨界度
みりりっとる	竓
みりょくてき	魅力的
みりめーとる	粍
みらいにほん	未来日本
みらいせかい	未来世界
みらいせいき	未来世紀
みらいしこう	未来志向
みよしたつじ	三好達治
みようみまね	見よう見まね	見よう見真似	見様見真似
みょうれんじ	妙蓮寺
みょうほうじ	妙法寺
みょうちょう	明朝
みょうぜんじ	妙善寺
みょうじょう	明星
みょうしゅん	明春
みょうごねん	明後年
みょうごにち	明後日
みょうこうじ	妙興寺
みょうぎさん	妙義山
みょうきょく	妙曲
みょうがだに	茗荷谷
みゆきけおり	御幸毛織
みやもとけん	宮本研
みやまちょう	美山町
みやふくせん	宮福線
みやのじょう	宮之城
みやじません	宮島線
みやざわばし	宮沢橋
みやざきもの	宮崎物
みやざきどう	宮崎道
みやざきちく	宮崎地区
みやざきだい	宮崎台	宮崎大
みやざきけん	宮崎県	宮崎研
みやざきかん	宮崎間
みやざきおき	宮崎沖
みやこおおじ	都大路
みやげものや	土産物屋
みやげばなし	土産話
みやぎざおう	宮城蔵王
みやおとみこ	宮尾登美子
みやおそうか	Podophyllaceae	ミヤオソウ科
みゃくりゅう	脈流
みゃくりゃく	脈略
みゃくみゃく	脈々	脈脈
みもとふめい	身元不明
みみせんよう	耳栓用
みみしっかん	耳疾患
みみがくもん	耳学問
みまわりひん	見回品
みまっしょう	未抹消
みまいじょう	見舞状
みほんちょう	見本帳
みほじんじゃ	美保神社
みぶんしょう	身分証
みぶのただみ	壬生忠見
みふしとうげ	三伏峠
みひつのこい	未必の故意
みはらちょう	美原町
みはらいきん	未払金
みはっぴょう	未発表
みのしろきん	身代金	身の代金
みのうにゅう	未納入
みねんしょう	未燃焼
みねらるるい	ミネラル類
みねらるぶん	ミネラル分
みにゅうしゅ	未入手
みならいこう	見習工
みなみやまて	南山手
みなみみのわ	南箕輪
みなみまわり	南回り
みなみまちだ	南町田
みなみべっぷ	南別府
みなみふらの	南富良野
みなみはるお	三波春夫
みなみなさま	皆皆様	皆々様
みなみつがる	南津軽
みなみちょう	南町
みなみちとせ	南千歳
みなみちしま	南千島
みなみちいき	南地域
みなみたまち	南田町
みなみたかぎ	南高来
みなみたかき	南高来
みなみしなの	南信濃
みなみしたら	南設楽
みなみしこく	南四国
みなみさおり	南沙織
みなみかわち	南河内
みなみかやべ	南茅部
みなみおたり	南小谷
みなみおぐに	南小国
みなみうらわ	南浦和
みなみありま	南有馬
みなみあまべ	南海部
みなみあずみ	南安曇
みなみあざぶ	南麻布
みなみあきた	南秋田
みなみあいづ	南会津
みなのしゅう	皆の衆
みなとせいき	港製機
みなときたく	港北区
みなさまがた	皆様方
みないっしょ	皆一緒
みどろがいけ	深泥池
みどるきゅう	ミドル級
みどりのとう	緑の党
みどりでんし	緑電子
みどりちょう	緑町
みどりがおか	緑が岡	緑ヶ丘	緑ケ丘	緑が丘
みとらきょう	ミトラ教
みとなっとう	水戸納豆
みとどけやく	見届け役
みとさんこう	水戸三高
みところぜめ	三所攻め
みとこうもん	水戸黄門
みとかいどう	水戸街道
みとうちゃく	未到着
みていしゅつ	未提出
みつゆにゅう	密輸入
みつゆしゅつ	密輸出
みつもりしょ	見積書
みつまたやり	三又槍
みつぼうえき	密貿易
みつびしゆか	三菱油化
みつびしはつ	三菱初
みつびしせい	三菱製
みつびしけい	三菱系
みつどぶんぷ	密度分布
みつぞうしゅ	密造酒
みつせりゅう	光瀬龍
みつこしまえ	三越前
みつこしちか	三越地下
みつけつごう	密結合
みつぎりぼん	三つ切本
みつかいどう	水海道
みついふとう	三井埠頭
みついそうこ	三井倉庫
みついせきか	三井石化
みっぺいせい	密閉性
みっぺいしき	密閉式
みっぺいけい	密閉型
みっぺいがた	密閉型
みっちゃくど	密着度
みっしつぶつ	密室物
みっしつせい	密室性
みっこくしゃ	密告者
みっこうしゃ	密航者
みっかみばん	三日三晩
みっかぼうず	三日坊主
みっかてんか	三日天下
みちゃくよう	未着用
みちゃくしゅ	未着手
みちへんすう	未知変数
みちのくがみ	陸奥紙
みちおんせい	未知音声
みちあんない	道案内
みだいどころ	御台所
みたかいとう	三鷹以東
みそらひばり	美空ひばり
みそらーめん	味噌ラーメン
みそひともじ	三十一文字
みそしょうゆ	味噌醤油
みせばんごう	店番号
みせいじゅく	未成熟
みずようかん	水羊羹
みずぼうそう	水疱瘡
みずばしょう	水芭蕉
みずのととり	癸酉
みずのとうし	癸丑
みずのきえき	水軒駅
みずのえとら	壬寅
みずのえたつ	壬辰
みずのえさる	壬申
みずのえうま	壬午
みずのえいぬ	壬戌
みずでっぽう	水鉄砲
みずせつやく	水節約
みずさきにん	水先人
みずさかずき	水盃	水杯
みずさいばい	水栽培
みずぎすがた	水着姿
みずかけろん	水掛論	水掛け論
みじゅくもの	未熟者
みしんせんか	未芯線化
みしようぶん	未使用分
みしようひん	未使用品
みしょうりば	未勝利馬
みしょうにん	未承認
みしょうだく	未承諾
みしゅつげん	未出現
みしゅっそう	未出走
みしゅうろく	未収録
みしゅうせい	未修正
みしゅうきん	未収金	未集金
みしまゆきお	三島由紀夫
みしまたまち	三島田町
みさきちょう	三崎町
みこみちがい	見込み違い
みこうにゅう	未購入
みけんしゅつ	未検出
みけつしゅう	未決囚
みくにとうげ	三国峠
みくにちょう	三国町
みくだりはん	三下り半	三下半	三行半
みぎやじるし	⇒	→	右矢印
みぎまえあし	右前足	右前脚
みぎほうこう	右方向
みぎはんめん	右半面
みぎはんぶん	右半分
みぎはんどる	右ハンドル
みぎとうしゅ	右投手
みぎてんかい	右転回
みぎそくめん	右側面
みぎぜんりん	右前輪
みぎぜんぽう	右前方
みぎしゃめん	右斜面
みぎしゃせん	右車線
みぎしたすみ	右下隅
みぎけつごう	右結合
みぎくりっく	右クリック
みぎかいてん	右回転
みぎうえすみ	右上隅
みぎいっぱい	右一杯
みきょうらん	美狂乱
みきさいてん	未記載点
みがくしゅう	未学習
みがきにしん	身欠き鰊
みかんりょう	未完了
みかわちほう	三河地方
みかみひろし	三上博史
みかさのみや	三笠宮
みかけじょう	見掛け上
みかえりひん	見返り品
みかいしゅう	未回収
みかいこんち	未開墾地
みえだいこう	三重大工
みえだいがく	三重大学
みえこうつう	三重交通
みえけんじん	三重県人
みあいばなし	見合い話
みあいあいて	見合相手
まんるいだん	満塁弾
まんるいさく	満塁策
まんりょうび	満了日
まんようせん	万葉線
まんようがな	万葉仮名
まんようかな	万葉仮名
まんぷくかん	満腹感
まんねんろう	迷迭香
まんねんれき	万年暦
まんねんれい	満年齢
まんねんゆき	万年雪
まんねんひつ	万年筆
まんねんどこ	万年床
まんちんろう	萬珍楼
まんぞくかん	満足感
まんせいばし	万世橋
まんせいてき	慢性的
まんせいしん	慢性心
まんじどもえ	卍巴
まんじがため	卍固
まんしんほう	万進法
まんしゅうご	満州語
まんしゅいん	曼殊院
まんざいらく	萬歳楽
まんさくもく	Hamamelidales	マンサク目
まんごじしょ	万語辞書
まんげきょう	万華鏡
まんがぶんか	漫画文化
まんがのもり	まんがの森
まんがじたい	漫画自体
まんがしょう	漫画賞
まんがしゅう	漫画集
まんがざっし	漫画雑誌
まんがきっさ	漫画喫茶	マンガ喫茶
まんえんだい	万円代
まんえんさつ	万円札
まわるまわる	\(\^o\^\)\(o\^ \)\(\^  \)\(   \)\(  \^\)\( \^o\)\(\^o\^\)
まれーしあご	マレーシア語
まるやまだい	丸山台
まるもじけい	丸文字系
まるばつしき	○×式
まるはんにち	丸半日
まるてーぶる	丸テーブル
まるたんぼう	丸太ん棒
まるがめこう	丸亀高
まるかめがわ	丸亀側
まるかめかん	丸亀間
まるいちにち	丸一日
まゆつばもの	眉唾物
まやぶんめい	マヤ文明
まものたいじ	魔物退治
まもうぶぶん	摩耗部分
まめでっぽう	豆鉄砲
まめせいひん	豆製品
まみどりいろ	真緑色
まほうりょく	魔法力
まほうつかい	魔法使い
まほうけんし	魔法剣士
まにゅあるか	マニュアル化
まなつるこう	真鶴港
まどぜんたい	窓全体
まどぜんかい	窓全開
まどぐちやく	窓口役
まどぐちまえ	窓口前
まどぐちない	窓口内
まどぐちすう	窓口数
まどぐちおく	窓口奥
まどぎわせき	窓際席
まどかんすう	窓関数
まつりばやし	祭り囃子
まつやままち	松山町
まつやまびん	松山便
まつやまかん	松山間
まつまえはん	松前藩
まつまえづけ	松前漬
まつぼうきき	松貿機器
まつびさいき	末尾再帰
まつだせいこ	松田聖子
まつしたはん	松下藩
まつしたせい	松下製
まつざかにく	松坂肉
まつくいむし	松喰虫
まっちゃまち	松屋町
まっただなか	真只中	真っ只中
まっしょうぶ	末梢部
まっさかさま	真っ逆さま
まっさーじき	マッサージ機
まっこうくさ	抹香臭
まっくらやみ	真っ暗闇	真暗闇
まちぶぎょう	町奉行
まちだしみん	町田市民
まちぜんたい	町全体
まちかねやま	待兼山
まちあいしつ	待合い室	待合室
またたびもの	股旅者
またさぶろう	又三郎	又三朗
ますらおぶり	丈夫振り	益荒男振り
ますおかけん	舛岡研
ますいじゅう	麻酔銃
ますいさよう	麻酔作用
ますいこうか	麻酔効果
まじゅつてき	魔術的
まじゅつしょ	魔術書
まじめやろう	真面目野郎
ましょうめん	真正面
ましょうねん	魔少年
ましょうじき	真正直
ましゅうえき	摩周駅
ましこちょう	益子町
まさりおとり	優り劣り
まさつりょく	摩擦力
まさつぶぶん	摩擦部分
まさつそくど	摩擦速度
まさおかしき	正岡子規
まさいちろう	雅一郎
まこそうよう	麻姑掻痒
まげしんどう	曲げ振動
まげごうせい	曲げ剛性
まけとうしゅ	負け投手
まけずぎらい	負けず嫌い
まぐれあたり	紛れ当たり
まぐまだまり	マグマ溜り
まぐねしうむ	Mg	Magnesium
まくらことば	枕詞	枕言葉
まくらかばー	枕カバー
まくはりてん	幕張店
まくうちかい	幕内下位
まくあいげき	幕合劇
まきせんすう	巻線数
まきしょてん	槇書店
まかりまちが	罷り間違
まかつきゅう	磨羯宮
まえほうこう	前方向
まえばんぐみ	前番組
まえせんでん	前宣伝
まえすうれつ	前数列
まえじゅんび	前準備
まえしょりぶ	前処理部
まえこうてい	前工程
まえがりきん	前借金
まえがしきん	前貸金
まえうりけん	前売券
まいばらえき	米原駅
まいねんびと	毎年人
まいにちはい	毎日杯
まいにちごご	毎日午後
まいづるせん	舞鶴線
まいちもんじ	真一文字
まいぞうぶつ	埋蔵物
まいぞうひん	埋蔵品
まいぞうきん	埋蔵金
まいそうたい	埋葬隊
まいせつぶつ	埋設物
まいげつだい	毎月第
まーぼどうふ	麻婆豆腐
まーぼどーふ	麻婆豆腐
もんむてんのう	文武天皇
もんぶだいじん	文部大臣
もんどうむよう	問答無用
もんどうしゅう	問答集
もんつきはかま	紋付袴
もんちゅうじょ	問注所
もんだいようし	問題用紙
もんだいていき	問題提起
もんだいじたい	問題自体
もんだいじこう	問題事項
もんだいしゅう	問題集
もんだいいぜん	問題以前
もんだいいしき	問題意識
もんだいいがい	問題以外
もんぜんばらい	門前払い
もんぜんちょう	門前町
もんじょぶくろ	文書袋
もんしんひょう	問診票
もんしろちょう	紋白蝶
もんしょうがく	紋章学
もんごるずもう	モンゴル相撲
もんこかいほう	門戸開放
もんかじちゅう	門下侍中
もるもんきょう	モルモン教
もりながせいか	森永製菓
もりながじけん	森永事件
もりとかいがん	森戸海岸
もりたかちさと	森高千里
もりぐちしかん	守口市間
もりおかちさい	盛岡地裁
もよおしじょう	催場
ももじりむすめ	桃尻娘
もはんかいとう	模範回答	模範解答
もはんえんそう	模範演奏
ものがたりてき	物語的
ものがたりせい	物語性
もどしこうはい	戻し交配
もとりようしゃ	元利用者
もとりじちょう	元理事長
もとほうしょう	元法相
もとはんきゅう	元阪急
もとにほんへい	元日本兵
もとどうりょう	元同僚
もととうきゅう	元東急
もとちゅうにち	元中日
もとしゅしょう	元首相
もとけいきゅう	元京急
もときじちゅう	元記事中
もっこうじゅつ	木工術
もっかんがっき	木管楽器
もっかつじばん	木活字版
もちづきでんき	望月電気
もちつもたれつ	持ちつ持たれつ
もちだせいやく	持田製薬
もじれつちょう	文字列長
もじれつちゅう	文字列中
もじれつそうさ	文字列操作
もじれつしょり	文字列処理
もじれつこうほ	文字列候補
もじめいじがた	文字明示型
もじにんしきや	文字認識屋
もじじょうほう	文字情報
もじしょうきょ	文字消去
もじしゅうとく	文字修得
もじしゅうごう	文字集合
もじこぶんしょ	文字古文書
もじきょうかい	文字境界
もけいひこうき	模型飛行機
もけいせいさく	模型製作
もけいこうさく	模型工作
もくまおうもく	モクマオウ目	Casuarinales
もくひょうぶつ	目標物
もくひょうかん	目標艦
もくてきふめい	目的不明
もくてきじたい	目的自体
もくてきしょく	目的食
もくてきげんご	目的言語
もくてきいしき	目的意識
もくてきいがい	目的以外
もくぞうかおく	木造家屋
もくしょうぜん	黙照禅
もくざいしげん	木材資源
もぎりょういき	模擬領域
もぎてきせかい	模擬的世界
もぎおんじょう	模擬音場
もがみよしみつ	最上義光
もおかてつどう	真岡鉄道
もうれんちゃん	猛連荘
もうれんしゅう	猛練習
もうりもとなり	毛利元就
もうりてるもと	毛利輝元
もうまくふしゅ	網膜浮腫
もうまくはくり	網膜剥離
もうまくじょう	網膜上
もうまくしょう	網膜症
もうぼさんせん	孟母三遷
もうちょうせん	盲腸線
もうちょうえん	盲腸炎
もうじんかしゅ	盲人歌手
もうじょうたい	網状態	毛状体
もうしわけない	申し訳ない
もうしたてにん	申立人
もうしたてしょ	申立書
もうしこみにん	申込人
もうしこみせい	申し込み制
もうしこみしょ	申込書
もうしこみしゃ	申込者
もうしこみさき	申し込み先	申込先
もうことういん	猛虎党員
もうきのふぼく	盲亀の浮木
もうかてつどう	真岡鉄道
めんばへんすう	メンバ変数
めんばかんすう	メンバ関数
めんでれびうむ	Md	Mendelevium
めんせつしけん	面接試験
めんせきじこう	免責事項
めんせきあたり	面積当たり
めんじょせいど	免除制度
めんしゅうごう	面集合
めんきょふよう	免許不要
めんきょせいど	免許制度
めんきょじょう	免許状
めんきょしょう	免許証
めんきょしかく	免許資格
めんきょこうふ	免許交付
めんかいじかん	面会時間
めんえきりょく	免疫力
めんえきふぜん	免疫不全
めんえききこう	免疫機構
めんあつぶんぷ	面厚分布
めもとくちもと	目元口元
めっしほうこう	滅私奉行	滅私奉公
めだまふうせん	目玉風船
めだませいひん	目玉製品
めじろがくえん	目白学園
めざましどけい	目覚まし時計	目覚し時計
めぐろほうめん	目黒方面
めぐろけいとう	目黒系統
めぐろがくえん	目黒学園
めくらめっぽう	盲滅法
めがみてんせい	女神転生
めおとまんざい	夫婦漫才
めおとぢゃわん	夫婦茶碗
めいわくりょう	迷惑料
めいわくやろう	迷惑野郎
めいわくでんわ	迷惑電話
めいわくこうい	迷惑行為
めいわくいがい	迷惑以外
めいれいひょう	命令表
めいれいついか	命令追加
めいれいちょう	命令長	命令調
めいりょうてい	名料亭
めいりょうせい	明瞭性
めいよめいじん	名誉名人
めいよばんかい	名誉挽回
めいよそうさい	名誉総裁
めいよかくめい	名誉革命
めいよかいふく	名誉回復
めいよかいいん	名誉会員
めいもくじょう	名目上
めいぼじゅんい	名簿順位
めいぼさくせい	名簿作成
めいぼうこうし	明眸皓歯
めいぶつおとこ	名物男
めいちんばめん	名珍場面
めいちゅうりつ	命中率
めいちゅうすう	命中数
めいだいろんり	命題論理
めいだいりこう	明大理工
めいだいぶぶん	命題部分
めいだいなかの	明大中野
めいだいでんき	名大電気
めいぜんりょう	明善寮
めいすうひょう	命数表
めいじょうせん	名城線
めいじゅんのう	明順応
めいじばんねん	明治晩年
めいじてんもん	明治天文
めいじてんのう	明治天皇
めいじっきょう	名実況
めいじだいがく	明治大学
めいじせいとう	明治製糖
めいじじんぐう	明治神宮
めいじきいこう	明治期以降
めいしょうせん	名松線
めいしょうあん	名称案
めいしこうかん	名刺交換
めいさくしゅう	名作集
めいさいひょう	明細表
めいさいとそう	迷彩塗装
めいさいしょく	迷彩色
めいげんしゅう	名言集
めいぎへんこう	名義変更
めいきょくどう	名曲堂
めいきゅういり	迷宮入り
めいえんそうか	名演奏家
めいえんしゅう	名演集
むろまちばくふ	室町幕府
むろまちじだい	室町時代
むろうさいせい	室生犀星
むりょうりよう	無料利用
むりょうふもん	無料不問
むりょうはいふ	無料配布
むりょうでんわ	無料電話
むりしんじゅう	無理心中
むりおうじょう	無理圧状
むらさきしきぶ	紫式部
むらかみりゅう	村上龍
むらかみはるき	村上春樹
むめんきょしゃ	無免許者
むめいへんすう	無名変数
むめいしょてん	無名書店
むむじゅんせい	無矛盾性
むひょうじょう	無表情
むはんどうほう	無反動砲
むはんしゃたん	無反射端
むのうりょくか	無能力化
むのうしゃいん	無能社員
むてきがったい	無敵合体
むてかつりゅう	無手勝流
むつうぶんべん	無痛分娩
むちんあつかい	無賃扱い
むちつじょせい	無秩序性
むちうちしょう	鞭打ち症
むだんへんそく	無段変速
むだんふくせい	無断複製
むだんてんさい	無断転載
むだんけっせき	無断欠席
むだんいんよう	無断引用
むたいざいさん	無体財産
むせんりょこう	無銭旅行
むせんゆうどう	無線誘導
むせんめんきょ	無線免許
むせんでんしん	無線電信
むせんつうしん	無線通信
むせんだんたい	無線団体
むせんこうがく	無線工学
むせんぎじゅつ	無線技術
むせんかんけい	無線関係
むせんうんよう	無線運用
むせいふしゅぎ	無政府主義
むせいししょう	無精子症
むすいちょうり	無水調理
むじんかいさつ	無人改札
むじょそうざい	無除草剤
むじゅんろんり	矛盾論理
むじゅうりょく	無重力
むじゅうりょう	無重量
むじこむいはん	無事故無違反
むしんろんしゃ	無神論者
むしょうはいふ	無償配布
むしょうたいよ	無償貸与
むしょうこうふ	無償交付
むしょうこうい	無償行為
むしゅうにゅう	無収入
むしゅうきょう	無宗教
むしゃのこうじ	武者小路
むざいほうめん	無罪放免
むざいはんけつ	無罪判決
むさべつきゅう	無差別級
むさしむらやま	武蔵村山
むさしなかはら	武蔵中原
むさしだいがく	武蔵大学
むさしこがねい	武蔵小金井
むさしこうだい	武蔵工業大学	武蔵工大
むごんのぎょう	無言の行
むこたとうるい	ムコ多糖類
むこくせきてき	無国籍的
むこがわだんち	武庫川団地
むこがわうがん	武庫川右岸
むこうめいれい	無効命令
むこうじまえき	向島駅
むげんせきにん	無限責任
むげんすうれつ	無限数列
むげんしんでん	夢幻神殿
むげんしょうか	無限小化
むげんきしゃく	無限希釈
むげんえんぽう	無限遠方
むげんえんてん	無限円点	無限遠点
むげいたしゅみ	無芸多趣味
むけつかくめい	無血革命
むぎわらぼうし	麦稈帽子	麦藁帽子
むぎくさとうげ	麦草峠
むきちょうえき	無期懲役
むきざいりょう	無機材料
むきかごうぶつ	無機化合物
むがくもんもう	無学文盲
むがくめんかぶ	無額面株
むかゆうきょう	無何有郷
みんようしゅう	民謡集
みんぽんしゅぎ	民本主義
みんぽうじょう	民法上
みんちょうたい	明朝体
みんたんしゅう	民譚集
みんぞくちょう	民族調
みんぞくじけつ	民族自決
みんぞくしゅぎ	民族主義
みんぞくこっか	民族国家
みんぞくがっき	民族楽器
みんぞくいどう	民族移動
みんせいようき	民生用機
みんせいいいん	民生委員
みんじそしょう	民事訴訟
みんじせきにん	民事責任
みんじしっこう	民事執行
みんじさいばん	民事裁判
みんじさいせい	民事再生
みんしゅせいど	民主制度
みんしゅせいじ	民主政治
みんしゅしゅぎ	民主主義
みんしゅこっか	民主国家
みんかんほりょ	民間捕虜
みんかんとばく	民間賭博
みんかんしせつ	民間施設
みんいけいせい	民意形成
みわだがくえん	三輪田学園
みらいよそうず	未来予想図
みらいしゃかい	未来社会
みらいしじょう	未来史上
みらいぎじゅつ	未来技術
みらいえいごう	未来永劫
みょうぎしょう	名義抄
みゅーりゅうし	μ粒子
みやもとむさし	宮本武蔵
みやじまこうろ	宮島航路
みやざわけんじ	宮沢賢治
みやざわきいち	宮沢喜一
みやざきはやお	宮崎駿
みやこのじょう	都城
みやげものてん	土産物店
みやけいっせい	三宅一生
みやぎこうせん	宮城高専
みやぎがくいん	宮城学院
みやきょうだい	宮教大	宮城教育大学
みやがわちょう	宮川町
みゃくらくまく	脈絡膜
みゃくはくすう	脈拍数
みもとほしょう	身元保証
みもとちょうさ	身元調査
みもとかくにん	身元確認
みほそうどうろ	未舗装道路
みほそうくかん	未舗装区間
みぶんそうおう	身分相応
みぶのただみね	壬生忠岑
みふねとしろう	三船敏郎
みのほどしらず	身の程知らず
みのべたつきち	美濃部達吉
みにゅうりょく	未入力
みなみりんかん	南林間
みなみよのえき	南与野駅
みなみゆふえき	南由布駅
みなみやましろ	南山城
みなみもりまち	南森町
みなみもとまち	南元町
みなみみやざき	南宮崎
みなみまつうら	南松浦
みなみぼうそう	南房総
みなみふなばし	南船橋
みなみふくおか	南福岡
みなみはんぶん	南半分
みなみのかわち	南河内
みなみのうおざ	南魚座
みなみとりしま	南鳥島
みなみとうほく	南東北
みなみだいとう	南大東
みなみたまえき	南多摩駅
みなみたかさき	南高崎
みなみしゃめん	南斜面
みなみしまばら	南島原
みなみしなかい	南支那海
みなみさいたま	南埼玉
みなみこいずみ	南小泉
みなみくしやま	南串山
みなみかんばら	南蒲原
みなみかんとう	南関東
みなみおぎしま	南荻島
みなみおおつか	南大塚
みなみおおさわ	南大沢
みなみうおぬま	南魚沼
みなみいばらき	南茨木
みなみあしがら	南足柄
みなみあおやま	南青山
みなまたびょう	水俣病
みなびょうどう	皆平等
みなとおおはし	港大橋
みなきょうだい	皆兄弟
みどりじゅうじ	ミドリ十字
みどくきじすう	未読記事数
みどうすじせん	御堂筋線
みどうかいかん	御堂会館
みとしょうけん	水戸証券
みとうわくせい	未踏惑星
みとうろくしゃ	未登録者
みていけいすう	未定係数
みていぎようご	未定義用語
みづきしょぼう	三月書房
みつりょうしゃ	密漁者	密猟者
みつぼしべると	三ツ星ベルト
みつびしでんき	三菱電機
みつびしそうこ	三菱倉庫
みつびしせきゆ	三菱石油
みつびしせいし	三菱製紙
みつびしじゅし	三菱樹脂
みつびしじしょ	三菱地所
みつびしかせい	三菱化成
みつびしかがく	三菱化学
みつびしうらわ	三菱浦和
みつひきりょう	三つ引き両
みつにゅうこく	密入国
みつどやくそう	密度躍層
みつどせいそう	密度成層
みつどかんすう	密度関数
みつぎょうれつ	密行列
みつがしわもく	ミツガシワ目	Menyanthales
みついぶっさん	三井物産
みついぞうせん	三井造船
みついせいとう	三井製糖
みついこうざん	三井鉱山
みついけんせつ	三井建設
みついぎんこう	三井銀行
みっぺいようき	密閉容器
みっぷうようき	密封容器
みっちゃくせい	密着性
みっしゅうたい	密集体
みっかびちょう	三ケ日町
みたらしだんご	御手洗団子
みたにほうしき	三谷方式
みたこうぎょう	三田工業
みたいしゅうか	未大衆化
みたいけんしゃ	未体験者
みせいねんしゃ	未成年者
みずのとひつじ	癸未
みずてきりょう	水適量
みずたまもよう	水玉模様
みずしょうばい	水商売
みずしましんじ	水島新司
みずさわほたる	水沢蛍
みずさわけいば	水沢競馬
みずぎたいかい	水着大会
みずいろじだい	水色時代
みしようくかん	未使用区間
みしょうりせん	未勝利戦
みしゅっそうば	未出走馬
みしまていしゃ	三島停車
みしまたいしゃ	三嶋大社
みこんじょせい	未婚女性
みこうかいかぶ	未公開株
みけいけんしゃ	未経験者
みくろぶんせき	ミクロ分析
みくろけいざい	ミクロ経済
みぎてなかゆび	右手中指
みぎてぜんぽう	右手前方
みぎておやゆび	右手親指
みぎちゅうだん	右中段
みぎかたさがり	右肩下がり
みぎかたあがり	右肩上がり
みきりはっしゃ	見切り発車
みがらそうけん	身柄送検
みかんせいひん	未完成品
みかんせいばん	未完成版
みかんさくひん	未完作品
みかたせんしゅ	味方選手
みかじめりょう	みかじめ料
みかさしょぼう	三笠書房
みかくていもじ	未確定文字
みかいしゃかい	未開社会
みかいけつてん	未解決点
みうらはんとう	三浦半島
みうらかいがん	三浦海岸
みあいれんあい	見合恋愛
みあいけっこん	見合結婚
まんようしゅう	万葉集
まんぷくほーる	満腹ホール
まんせいびょう	慢性病
まんじゅしゃげ	曼珠沙華
まんじゅうがに	饅頭蟹
まんしんそうい	満身創痍
まんしゅうぞく	満州族
まんしゅうじん	満州人
まんしゅうこく	満州国	滿洲國
まんざほうめん	万座方面
まんざおんせん	万座温泉
まんがんでんち	マンガン電池
まんがとくゆう	漫画特有
まんかんしょく	満艦飾
まるやまちょう	円山町	丸山町
まるひほうこく	丸秘報告
まるのうちせん	丸の内線
まるてんじょう	円天井	丸天井
まるつきすうじ	丸付数字
まるたまちせん	丸太町線
まるぜんせきゆ	丸善石油
まよなかいがい	真夜中以外
まよこほうこう	真横方向
まもうへんけい	摩耗変形
まめでんきゅう	豆電球
まみやりんぞう	間宮林蔵
ままこあつかい	継子扱い
まほうせんもん	魔法専門
まほうじゅうし	魔法重視
まほうぎじゅつ	魔法技術
まひじょうたい	麻痺状態
まつやまちはる	松山千春
まつやまじょう	松山城
まつやましょう	松山商
まつやましない	松山市内
まつもとれいじ	松本零士
まつもとしない	松本市内
まつびばんごう	末尾番号
まつとうやゆみ	松任谷由実
まつだゆうさく	松田優作
まつじつせいと	末日聖徒
まつしまちょう	松島町
まつしたれいき	松下冷機
まつしたでんし	松下電子
まつしたでんき	松下電器
まつしたぎけん	松下技研
まつざかしない	松阪市内
まつざかぎゅう	松坂牛
まつさかぎゅう	松坂牛
まつおばしょう	松尾芭蕉
まつおたいしゃ	松尾大社
まつえほうめん	松江方面
まつえほうこう	松江方向
まっぽうしそう	末法思想
まっぴらごめん	真平御免
まったんくかん	末端区間
まったんかかく	末端価格
まっしょうめん	真正面
まっしょうじき	真正直	真っ正直
まっしょうけつ	末梢血
まっしょうけい	末梢系
まっしそうぞく	末子相続
まっさいちゅう	真っ最中	真最中
まっこうくじら	抹香鯨
まっきかんじゃ	末期患者
まちだほうめん	町田方面
まちだがくえん	町田学園
まちだかいどう	町田街道
まちじょうたい	待ち状態
まちしゅうへん	町周辺
まちこうじょう	町工場
まちぎょうれつ	待ち行列	待行列
ますだきいとん	益田喜頓
まじょさいばん	魔女裁判
まさつていこう	摩擦抵抗
まさつげんかい	摩擦限界
まさつけいすう	摩擦係数
まけじだましい	負けじ魂
まくろぶんせき	マクロ分析
まくろけいざい	マクロ経済
まくらのそうし	枕草子
まくらざきせん	枕崎線
まくらげいしゃ	枕芸者
まくめいがっき	膜鳴楽器
まくしたじだい	幕下時代
まくうちりきし	幕内力士
まきそのちょう	牧園町
まおたいちゅー	茅台酒
まえわたしきん	前渡金
まえひょうばん	前評判
まえばらいきん	前払金
まえばししりつ	前橋市立
まえだとしいえ	前田利家
まえしょうとう	前照灯
まえさんしょう	前参照
まえこうじょう	前口上
まえがしらかい	前頭下位
まえかんじょう	前勘定
まえうりちゅう	前売中
まいにちりよう	毎日利用
まいにちごぜん	毎日午前
まいなすようそ	マイナス要素
まいなすしこう	マイナス思考
まいとねりうむ	Mt	Meitnerium
まいとしひとり	毎年一人
まいとしさんか	毎年参加
まいぞうりょう	埋蔵量
まいそうきろく	埋葬記録
まいしゅうまつ	毎週末
まいこかいがん	舞子海岸
まいきょかのう	枚挙可能
まいかいおうぼ	毎回応募
まあぼうどうふ	麻婆豆腐
まーぼーどうふ	麻婆豆腐
まーじゃんよう	麻雀用
もんぶきょうかん	文部教官
もんぶかんりょう	文部官僚
もんどうけいしき	問答形式
もんとくてんのう	文徳天皇
もんてつかんない	門鉄管内
もんてかるろほう	モンテカルロ法
もんだいようやく	問題要約
もんだいぶんせき	問題分析
もんだいはつげん	問題発言
もんだいはっせい	問題発生
もんだいはっけん	問題発見
もんだいとうこう	問題投稿
もんだいせってい	問題設定
もんだいけいしき	問題形式
もんだいくうかん	問題空間
もんだいきじゅつ	問題記述
もんだいかいけつ	問題解決
もんだいいっぱん	問題一般
もんぜんなかまち	門前仲町
もんぜんじゃくら	門前雀羅
もんがいふしゅつ	門外不出
もんかききょろう	門下起居郎
もりむらせいいち	森村誠一
ももぞのてんのう	桃園天皇
ももくりさんねん	桃栗三年
ももいろぞうさん	粉紅色仔象
もののべのもりや	物部守屋
ものがたりちゅう	物語中
ものがたりせかい	物語世界
ものがたりじょう	物語上
もとよししんのう	元良親王
もとやまきたまち	本山北町
もとめいこうだい	元名工大
もとかんじちょう	元幹事長
もとおりのりなが	本居宣長
もっかどこんすい	木火土金水
もちろんれいがい	勿論例外
もちかぶせいげん	持ち株制限	持株制限
もちかぶがいしゃ	持ち株会社	持株会社
もすきーときゅう	モスキート級
もじれつていすう	文字列定数
もじれつたんさく	文字列探索
もじれつこうもく	文字列項目
もじにゅうりょく	文字入力
もじすうせいげん	文字数制限
もじしゅつりょく	文字出力
もじしゅうしょく	文字修飾
もじざひょうけい	文字座標系
もさくじょうたい	模索状態
もけいせんもんし	模型専門誌
もけいぎょうかい	模型業界
もくてきせんよう	目的専用
もくてきせってい	目的設定
もくてきすいこう	目的遂行
もくてきしんごう	目的信号
もくてきかんすう	目的関数
もくせいかんそく	木星観測
もくげきほうこく	目撃報告
もうれつふきょう	猛烈不況
もうれつきょじん	猛烈巨人
もうもんせんこう	網紋穿孔
もうまくとうえい	網膜投影
もうひつしょたい	毛筆書体
もうそうがっこう	妄想学校
もうじんしょかん	盲人書簡
もうじょうみゃく	網状脈
もうじゅうつかい	猛獣使い
もうしこみようし	申込用紙
もうしこみひょう	申込票
もうしこみちゅう	申込中
もうしこみたすう	申込多数
もうしこみじょう	申込状
もうしこみきげん	申込期限
もうしこみきかん	申込期間
もうさいけっかん	網細血管	毛細血管
もーせのじっかい	モーセの十戒	モーセの十誡
めんぼくやくじょ	面目躍如
めんぜいひんてん	免税品店
めんじょしんせい	免除申請
めんじょうりょう	免状料
めんきょほじしゃ	免許保持者
めんきょふしょじ	免許不所持
めんきょばんごう	免許番号
めんきょとりけし	免許取消
めんきょしんせい	免許申請
めんきょしゅとく	免許取得
めんきょしっこう	免許失効
めんきょこうふじ	免許交付時
めんきょこうしん	免許更新
めんきょかいでん	免許皆伝
めんきょかいせい	免許改正
めんかいしゃぜつ	面会謝絶
めんえきかんけい	免疫関係
めだましょうひん	目玉商品
めすうまげんてい	牝馬限定
めぐろとうきゅう	目黒東急
めいわくせんまん	迷惑千万
めいわくせんばん	迷惑千万
めいろうかいけい	明朗会計
めいれいはっこう	命令発行
めいれいでんたつ	命令伝達
めいれいじっこう	命令実行
めいれいごじゅん	命令語順
めいれいくちょう	命令口調
めいよきょうじゅ	名誉教授
めいよきそんざい	名誉毀損罪
めいよかいちょう	名誉会長
めいめいはくはく	明々白々	明明白白
めいほかんきのう	名補完機能
めいぶつりょうり	名物料理
めいばめんしゅう	名場面集
めいはんこくどう	名阪国道
めいてつせんない	名鉄線内
めいてつせとせん	名鉄瀬戸線
めいちゅうせいど	命中精度
めいだいへんすう	命題変数
めいだいとうけつ	命題凍結
めいだいていすう	命題定数
めいだいせいけい	明大政経
めいだいすいろん	命題推論
めいだいこうがく	名大工学
めいだいけいさん	命題計算
めいだいかんすう	命題関数
めいそうしんけい	迷走神経
めいせいだいがく	明星大学
めいせいこうこう	明星高校
めいじんだっしゅ	名人奪取
めいじじょうほう	明治情報
めいじしんせいふ	明治新政府
めいじきねんかん	明治記念館
めいしんこうそく	名神高速
めいしょうふめい	名称不明
めいしょうこうほ	名称候補
めいさいずしゅう	明細図集
めいきょくしゅう	名曲集
めいきょうしすい	明鏡止水
むりょうほうそう	無料放送
むりょうはいそう	無料配送
むりょうだいすう	無量大数
むりょうたいすう	無量大数
むりょうそうだん	無料相談
むりょうそうげい	無料送迎
むりょうしんだん	無料診断
むりょうしゅうり	無料修理
むりょうこうかん	無料交換
むりょうこうえん	無料公演
むらさきつゆくさ	紫露草
むらさききゃべつ	紫キャベツ
むらかみてんのう	村上天皇
むようちょうぶつ	無用長物
むみょうじょうや	無明長夜
むほうじょうたい	無法状態
むほうしきしゅぎ	無方式主義
むふかでんりゅう	無負荷電流
むふかじょうたい	無負荷状態
むびょうそくさい	無病息災
むのうりょくしゃ	無能力者
むのうやくやさい	無農薬野菜
むてきしょうぐん	無敵将軍
むていけいたんそ	無定形炭素
むていけいけいそ	無定形珪素
むていけいいおう	無定形硫黄
むていぎがいねん	無定義概念
むちんじょうしゃ	無賃乗車
むだんへんそくき	無段変速機
むだんはいしゃく	無断拝借
むだんちゅうしゃ	無断駐車
むだんしようしゃ	無断使用者
むだんがいしゅつ	無断外出
むせんでんぱほう	無線電波法
むせきにんやろう	無責任野郎
むせきにんおとこ	無責任男
むせいせいしょく	無性生殖
むせいげんはいふ	無制限配布
むすいなべしよう	無水鍋使用
むじんえいぎょう	無人営業
むじょうじんそく	無常迅速
むじゅんめいだい	矛盾命題
むしょくとうめい	無色透明
むしょうしゅうり	無償修理
むしょうこうかん	無償交換
むしょうこうかい	無償公開
むしゃしゅぎょう	武者修業	武者修行
むさんかいきゅう	無産階級
むさべつばくげき	無差別爆撃
むさべつこうげき	無差別攻撃
むさしのなんせん	武蔵野南線
むさしのてつどう	武蔵野鉄道
むさしのこうこう	武蔵野高校
むさしのぎんこう	武蔵野銀行
むさしのかいそく	武蔵野快速
むさしのおんだい	武蔵野音大
むさししんじょう	武蔵新城
むさしいつかいち	武蔵五日市
むさいしょくこう	無採色光
むこうとうひょう	無効投票
むこうでんりょく	無効電力
むこうじょうめん	向正面
むげんれんさこう	無限連鎖講
むげんぞうしょく	無限増殖
むげんしょうすう	無限小数
むげんしゅうごう	無限集合
むげんきゅうすう	無限級数
むげいたいしょく	無芸大食
むけいぶんかざい	無形文化財
むきめいさいけん	無記名債権
むきめいかぶけん	無記名株券
むきげんゆうこう	無期限有効
むきげんきんしん	無期限謹慎
むかしつせきにん	無過失責任
みんめいしょぼう	民明書房
みんぽうかいせい	民法改正
みんてつかくしゃ	民鉄各社
みんていけんぽう	民定憲法
みんぞくぜんたい	民族全体
みんぞくせいしん	民族精神
みんぞくじょうか	民族浄化
みんぞくこんこう	民族混交
みんぞくおんがく	民族音楽
みんぞくいしょう	民族衣装
みんせいようきき	民生用機器
みんせいどうめい	民青同盟
みんせいしじょう	民生市場
みんじばいしょう	民事賠償
みんじちょうてい	民事調停
みんしゅてきじち	民主的自治
みんかんちりょう	民間治療
みんかんだんたい	民間団体
みんかんしんこう	民間信仰
みんかんしゅどう	民間主導
みんかんきぎょう	民間企業
みんかんがいしゃ	民間会社
みんかんかんきん	民間換金
みんおんかいかん	民音会館
みんえいかとうじ	民営化当時
みらくるがーるず	ミラクル☆ガールズ
みらいしょうねん	未来少年
みらいかんりょう	未来完了
みょうれんじえき	妙蓮寺駅
みょうもんりよう	名聞利養
みょうおんどおり	妙音通
みやふくてつどう	宮福鉄道
みやたけがいこつ	宮武外骨
みやしたこうえん	宮下公園
みやざわせいけん	宮沢政権
みやざきだいがく	宮崎大学
みやざきけんみん	宮崎県民
みやざきくうこう	宮崎空港
みみもちしだぞく	ミミモチシダ属	Acrostichum
みぶんふそうおう	身分不相応
みぶんしょうめい	身分証明
みぶんしょうごう	身分照合
みなもとよりよし	源頼義
みなもとよしつね	源義経
みなみわっかない	南稚内
みなみほんちょう	南本町
みなみほんしゅく	南本宿
みなみひろしまし	南広島市
みなみはんきゅう	南半球
みなみはっこうだ	南八甲田
みなみとうきょう	南東京
みなみちょうせん	南朝鮮
みなみじゅうじざ	南十字座
みなみかるいざわ	南軽井沢
みなみあるぷすし	南アルプス市
みなみあしがらし	南足柄市
みなとみなみぐち	港南口
みなかみおんせん	水上温泉
みなかたくまぐす	南方熊楠
みどりのまどぐち	緑の窓口
みとうりょういき	未踏領域
みていぎめいれい	未定義命令
みていぎへんすう	未定義変数
みつびしれいよん	三菱レイヨン
みつびしそうけん	三菱総研
みつびしせいこう	三菱製鋼
みつびししょうじ	三菱商事
みつびしぎんこう	三菱銀行
みつびしきんぞく	三菱金属
みつびしかこうき	三菱化工機
みつびしえんぴつ	三菱鉛筆
みつこしまええき	三越前駅
みつこしほんてん	三越本店
みつこしほんかん	三越本館
みつこしべっかん	三越別館
みつけつごうがた	密結合型
みついふどうさん	三井不動産
みっぷうほうそう	密封包装
みっしつさつじん	密室殺人
みっしつけんてい	密室検定
みっきょうじてん	密教辞典
みちゃくようしゃ	未着用者
みちにゅうりょく	未知入力
みたいおうきのう	未対応機能
みせいねんじだい	未成年時代
みせいじゅくらん	未成熟卵
みずさきあんない	水先案内
みしようへんすう	未使用変数
みしようしんぴん	未使用新品
みしゅうろくぶん	未収録分
みしまふつかまち	三島二日町
みしまひろこうじ	三島広小路
みこうかいきょく	未公開曲
みけつこうりゅう	未決勾留
みくにれんたろう	三國連太郎
みぎがわつうこう	右側通行
みかんりょうかこ	未完了過去
みかわたはらえき	三河田原駅
みかわあんじょう	三河安城
みかくしょうがい	味覚障害
みかいつうぶぶん	未開通部分
みいけこうぎょう	三池工業
まんにょうしゅう	万葉集
まんてつせんない	満鉄線内
まんちょうぜんご	満潮前後
まんじょういっち	満場一致
まんじゅうやぼん	饅頭屋本
まんしょくがぞう	万色画像
まんしゅうじへん	満州事変	滿洲事變
まんがぶんこばん	漫画文庫版
まんがどうじんし	漫画同人誌
まんがくかいとう	満額回答
まんがきょうしつ	漫画教室
まんかんぜんせき	満漢全席
まんいんでんしゃ	満員電車
まんいんおんれい	満員御礼
まるやまおうきょ	円山応挙
まるまどでんしゃ	丸窓電車
まるひじょうほう	丸秘情報
まるぬまこうげん	丸沼高原
まるちしょうほう	マルチ商法
まるがめこうこう	丸亀高校
まやくちゅうどく	麻薬中毒
まやくたんちけん	麻薬探知犬
まみやかいきょう	間宮海峡
まほうしょうじょ	魔法少女
まどぐちぎょうむ	窓口業務
まつやまほうめん	松山方面
まつやまだいがく	松山大学
まつもとほうめん	松本方面
まつもとでんてつ	松本電鉄
まつもとたいかい	松本大会
まつもとくうこう	松本空港
まつむらしょてん	松村書店
まつびさんしょう	末尾参照
まつしたでんこう	松下電工
まつしたつうしん	松下通信
まつしたせいこう	松下精工
まつかたまさよし	松方正義
まつうらてつどう	松浦鉄道
まったんかいいん	末端会員
まっしょうとうき	抹消登記
まっさつそうどう	抹殺騒動
まちだおだきゅう	町田小田急
またぐらごうやく	股座膏薬
ますみだじんじゃ	真清田神社
ますとみおんせん	増富温泉
まくはりほんごう	幕張本郷
まくしたこうかく	幕下降格
まくうちじょうい	幕内上位
まきょうでんせつ	魔境伝説
まきのとみたろう	牧野富太郎
まえばりおおくち	前張大口
まえのりょうたく	前野良沢
まえこうかしょり	前効果処理
まえうりかいしび	前売開始日
まいばらていしゃ	米原停車
まいねんかいさい	毎年開催
まいにちほうそう	毎日放送
まいにちつうきん	毎日通勤
まいにちしんぶん	毎日新聞
まいにちおうかん	毎日王冠
まいにちうんてん	毎日運転
まいにちいっかい	毎日一回
まいなすよういん	マイナス要因
まいなすあるふぁ	マイナスα
まいとしほうそう	毎年放送
まいとしはっこう	毎年発行
まいとしこうれい	毎年恒例
まいとしこうしん	毎年更新
まいとしけいぞく	毎年継続
まいとしいっかい	毎年一回
まいづるこうこう	舞鶴高校
まいつきはっこう	毎月発行
まいつきなんにち	毎月何日
まいしゅうひとり	毎週一人
まいしゅうどよう	毎週土曜
まいかいまいかい	毎回毎回
まいかいとくてん	毎回得点
まいかいそくてい	毎回測定
まあじゃんまんが	麻雀漫画
まあじゃんげきが	麻雀劇画
もんぶかがくしょう	文部科学省
もんだいりょういき	問題領域
もんだいひょうげん	問題表現
もんだいていきしゃ	問題提起者
もんだいたいしょう	問題対象
もんぜんなかちょう	門前仲町
もんせきけつぎあん	問責決議案
もりぐちしていしゃ	守口市停車
もりきたしゅっぱん	森北出版
ももたろうでんてつ	桃太郎電鉄
ももたろうでんせつ	桃太郎伝説
ももたろうざむらい	桃太郎侍
ももたろうかつげき	桃太郎活劇
もはんてきえんそう	模範的演奏
もとまくうちりきし	元幕内力士
もとにほんこうくう	元日本航空
もとにほんぐんじん	元日本軍人
もとていとでんてつ	元帝都電鉄
もとだいとうりょう	元大統領
もとかわさきしみん	元川崎市民
もっかんがっきよう	木管楽器用
もじれつへんしゅう	文字列編集
もじれつしょうごう	文字列照合
もじにゅうりょくじ	文字入力時
もじたんまつじょう	文字端末上
もくひょうまいすう	目標枚数
もくひょうほうこう	目標方向
もくてきちほうこう	目的地方向
もくてきがいしよう	目的外使用
もくぞうじゅうたく	木造住宅
もうじょうせんこう	網状せん孔	網状穿孔
もうじゅうおうこく	猛獣王国
もうしこみほうほう	申込方法
もうしこみしょにち	申込初日
もうしこみしめきり	申込締切
もうかんじゅうそう	盲管銃創
めんじゅうふくはい	面従腹背
めんきょこうしんじ	免許更新時
めんきょぎょうせい	免許行政
めんえきりょうほう	免疫療法
めまんべつくうこう	女満別空港
めでゅさんどらもく	Medusandrales	メデュサンドラ目
めかませんでんしゃ	目蒲線電車
めうまげんていしば	牝馬限定芝
めいわくちゅうしゃ	迷惑駐車
めいりょうどしけん	明瞭度試験
めいはんとっきゅう	名阪特急
めいとうさんぎょう	明糖産業
めいでんしゃぬまづ	明電舎沼津
めいてつひろみせん	名鉄広見線
めいてつとっきゅう	名鉄特急
めいだいろんりしき	命題論理式
めいだいこうがくぶ	名大工学部
めいすいひゃくせん	名水百選
めいじょうだいがく	名城大学
めいじにゅうぎょう	明治乳業
めいじがくいんだい	明治学院大
めいじいしんいぜん	明治維新以前
めいしょうへんこう	名称変更
めいしょうてんのう	明正天皇
めいしょうけってい	名称決定
めいさくげきじょう	名作劇場
めいこうだいちのう	名工大知能
めいきゅうぶっけん	迷宮物件
めいおうせいきどう	冥王星軌道
めいあんじゅんのう	明暗順応
むれんそうへんかん	無連想変換
むりょうちゅうしゃ	無料駐車
むりょうしんりょう	無料診療
むりょうしゅくはく	無料宿泊
むらたせいさくじょ	村田製作所
むらたせいさくしょ	村田製作所
むらさきすいしょう	紫水晶
むらさきうまごやし	紫馬肥
むめんきょうんてん	無免許運転
むぼうびじょうたい	無防備状態
むほけんしんりょう	無保険診療
むふかかいてんすう	無負荷回転数
むにんかほいくしょ	無認可保育所
むなつきはっちょう	胸突き八丁
むてきひっさつわざ	無敵必殺技
むていでんでんげん	無停電電源
むていけいぶっしつ	無定形物質
むだんかいへんそく	無段階変速
むたいざいさんけん	無体財産権
むせんじゅうじしゃ	無線従事者
むせんしゅうはすう	無線周波数
むせんきょくけんさ	無線局検査
むせんかいぜんたい	無線界全体
むせきにんりょこう	無責任旅行
むせきにんどくほん	無責任読本
むせいふじょうたい	無政府状態
むせいふしゅぎてき	無政府主義的
むせいふしゅぎしゃ	無政府主義者
むすいちょうりよう	無水調理用
むすいありゅうさん	無水亜硫酸
むじるしりょうひん	無印良品
むじょうけんぶんき	無条件分岐
むじょうけんひてい	無条件否定
むじゅんじょうほう	矛盾情報
むじゅうりょくけい	無重力系
むしょうていきょう	無償提供
むしょうざんぎょう	無償残業
むしゅうはいきょく	無集配局
むしきゅうかんぷう	無四球完封
むさんそじょうたい	無酸素状態
むさべつばくげきか	無差別爆撃下
むさしぼうべんけい	武蔵坊弁慶
むさしのせんくかん	武蔵野線区間
むさしなかはらえき	武蔵中原駅
むさしこがねいかん	武蔵小金井間
むこようしえんぐみ	婿養子縁組
むこうかんさくせん	無交換作戦
むこうかようきゅう	無効化要求
むげんぞうばいりつ	無限増倍率	k$_\{inf\}$
むげんかいほうけい	無限解放系
むげんあつせんすい	無減圧潜水
むけいこていしさん	無形固定資産
むきょくせいぶんし	無極性分子
むきょうじょうたい	無響状態
むきめいとうひょう	無記名投票
むきはつばいえんき	無期発売延期
むきじょうでんしゃ	無軌条電車
みんぞくだいいどう	民族大移動
みんぞくじけつけん	民族自決権
みんぞくごひょうき	民族語表記
みんぞくきょういく	民族教育
みんじふかいにゅう	民事不介入
みんじそしょうほう	民事訴訟法
みんじしっこうほう	民事執行法
みんじさいせいほう	民事再生法
みんしゅしゅぎてき	民主主義的
みんしゅしゅぎしゃ	民主主義者
みんしゅしゅぎこく	民主主義国
みんしゅしゅぎかん	民主主義観
みんしゅかせいさく	民主化政策
みんしゃとういがい	民社党以外
みんかんりょうほう	民間療法
みんかんびょういん	民間病院
みんかんでんしょう	民間伝承
みんかんこうじょう	民間工場
みんかんかつりょく	民間活力
みりおんしゅっぱん	ミリオン出版
みょうせんじしょう	名詮自性
みょうこうざんいき	妙高山域
みょうこうこうげん	妙高高原
みょうこうあかくら	妙高赤倉
みやぢてっこうしょ	宮地鐵工所
みやぎのかもつせん	宮城野貨物線
みやぎがくいんだい	宮城学院大
みもとほしょうきん	身元保証金
みもとひきうけにん	身元引受人
みはらいかんじょう	未払勘定
みはっぴょうきょく	未発表曲
みなもとのよりとも	源頼朝
みなもとのよしつね	源義経
みなもとのしげゆき	源重之
みなもとのかねまさ	源兼昌
みなみみやざきかん	南宮崎間
みなみほっかいどう	南北海道
みなみのさんかくざ	南の三角座
みなみのかんむりざ	南冠座
みなみちょうせんご	南朝鮮語
みなみだいとうじま	南大東島
みなみたまほうめん	南多摩方面
みなみたいへいよう	南太平洋
みなみじゅうじせい	南十字星
みなみごてんばえき	南御殿場駅
みなみぐちほうめん	南口方面
みなみきゅうしゅう	南九州
みなみかんのんざん	南観音山
みなみかんとうべん	南関東弁
みなみかんとうぜい	南関東勢
みなみおおさわえき	南大沢駅
みなみおおさかせん	南大阪線
みなみあべかわばし	南安倍川橋
みなとがわこうえん	湊川公園
みどりやまこうこう	緑山高校
みどくにゅうりょく	未読入力
みどうすじほんまち	御堂筋本町
みとげいじゅつかん	水戸芸術館
みていけいすうほう	未定係数法
みつびしじゅうこう	三菱重工
みつびしじみずしま	三菱自水島
みつびしじどうしゃ	三菱自動車
みつびしじかわさき	三菱自川崎
みついせきゆかがく	三井石油化学
みっぺいじょうたい	密閉状態
みっちゃくけいしき	密着形式
みっしつせいじてき	密室政治的
みちばろくさぶろう	道場六三郎
みたさいぜんやさい	三田祭前夜祭
みずほせいさくしょ	瑞穂製作所
みしようりょういき	未使用領域
みしゅうろくきょく	未収録曲
みしゅうけいひょう	未集計票
みかたきょうぎしゃ	味方競技者
みかくていもじれつ	未確定文字列
みかくていぶんせつ	未確定文節
みかいぎょうくかん	未開業区間
まんるいほんるいだ	満塁本塁打
まんせきじょうたい	満席状態
まんせいちゅうどく	慢性中毒
まんせいじゅうたい	慢性渋滞
まんしゅうけんこく	満州建国
まんげつじょうたい	満月状態
まんがんかんでんち	マンガン乾電池
まんがめいさくかん	漫画名作館
まんがひょうろんか	漫画評論家
まんがたんこうぼん	漫画単行本
まんいんじょうたい	満員状態
まるだいしょくひん	丸大食品
まやくせんしんこく	麻薬先進国
まほうだいさくせん	魔法大作戦
まどぐちしょくいん	窓口職員
まつもとせいちょう	松本清張
まつもとこうしろう	松本幸四郎
まつだいらただてる	松平忠輝
まつしたなごやけん	松下名古屋研
まつしたちゅうけん	松下中研
まつしたじょうほう	松下情報
まっしょうしんけい	末梢神経
まっしょうけっかん	末梢血管
まっきしょうじょう	末期症状
まちかねやまちょう	待兼山町
まくはりでんしゃく	幕張電車区
まくうちりきしめい	幕内力士名
まきょうものがたり	魔境物語
まえがしらひっとう	前頭筆頭
まえがしらじょうい	前頭上位
まいどようびしんや	毎土曜日深夜
まいしゅうまいつき	毎週毎月
まいしゅうほうそう	毎週放送
まいしゅうはっこう	毎週発行
まいしゅうにちよう	毎週日曜
まいしゅうどようび	毎週土曜日
まいしゅうかようび	毎週火曜日
まいきょかのうせい	枚挙可能性
まいかいはっぴょう	毎回発表
まあじゃんたいかい	麻雀大会
もんぶしょうけんてい	文部省検定
もんぶしょうかんかつ	文部省管轄
もんだいかいけつほう	問題解決法
もりおかだいさんこう	盛岡第三高
もりおかだいいちこう	盛岡第一高
もりおかけいばじょう	盛岡競馬場
ものがたりぶんしょう	物語文章
もとへんしゅうちょう	元編集長
もとどれいしょうにん	元奴隷商人
もとだいにしょうたい	元第二小隊
もとたからずかしみん	元宝塚市民
もとしずおかけんみん	元静岡県民
もとこくむちょうかん	元国務長官
もとこくたいせんしゅ	元国体選手
もとこうこうきょうし	元高校教師
もときじとうこうしゃ	元記事投稿者
もっかんごじゅうそう	木管五重奏
もじれつにゅうりょく	文字列入力
もじれつがたへんすう	文字列型変数
もじにんしきぎじゅつ	文字認識技術
もじたじゅうほうそう	文字多重放送
もくまおうもくあぐん	モクマオウ目亜群
もくぞうけんちくぶつ	木造建築物
もくせいきどうじょう	木星軌道上
もくじさくせいきのう	目次作成機能
もうしこみしゃたすう	申込者多数
もうしこみしゃしめい	申込者氏名
めんきょしゅとくしゃ	免許取得者
めんえきよくせいざい	免疫抑制剤
めそぽたみあぶんめい	メソポタミア文明
めぐろせいびがくえん	目黒星美学園
めかませんぬまべえき	目蒲線沼部駅
めいりんどうしょてん	明倫堂書店
めいへんしゅうちょう	名編集長
めいてつとこなめせん	名鉄常滑線
めいだいがくりがくぶ	名大学理学部
めいじんけいけんしゃ	名人経験者
めいじだいがくいくた	明治大学生田
めいこうだいてっけん	名工大鉄研
めいきゅうものがたり	迷宮物語
むりょうしじょうかい	無料試乗会
むりょうごしょうたい	無料御招待
むりょうこうくうけん	無料航空券
むりょうおうふくけん	無料往復券
むちつじょじょうたい	無秩序状態
むだんかいちょうせい	無段階調整
むせんでんわつうしん	無線電話通信
むせんぎょうむにっし	無線業務日誌
むじょうけんひじゅん	無条件批准
むじょうけんこうふく	無条件降伏
むじょうけんかいきん	無条件解禁
むしんさつしんりょう	無診察診療
むしょうろうどうしゃ	無償労働者
むしゃのこうじせんけ	武者小路千家
むさしのせんほうめん	武蔵野線方面
むさしのせんでんしゃ	武蔵野線電車
むさしのじょがくいん	武蔵野女学院
むさくいちゅうしゅつ	無作為抽出
むこくせきじょうたい	無国籍状態
むこうでんりょくぶん	無効電力分
むこうがおかゆうえん	向ヶ丘遊園
むげんれんさはんばい	無限連鎖販売
むげんしょうけいさん	無限小計算
みんちょうたいかつじ	明朝体活字
みんじちょうていほう	民事調停法
みんしゅてきほうほう	民主的方法
みんしゅてききじゅん	民主的基準
みんしゅしゅぎこっか	民主主義国家
みんしゅしゃかいとう	民主社会党
みんしゅかようきゅう	民主化要求
みんかんかんきんごや	民間換金小屋
みやざきくうこうえき	宮崎空港駅
みやぎだいいちじょし	宮城第一女子
みやぎきょういくだい	宮城教育大
みほんいちかいじょう	見本市会場
みぶんしょうめいしょ	身分証明書
みはっぴょうしゃしん	未発表写真
みはっぴょうさくひん	未発表作品
みなみはんきゅうぜい	南半球勢
みなみとうほくちほう	南東北地方
みなみくしやまちょう	南串山町
みついとうあつかがく	三井東圧化学
みっちゃくれんけつき	密着連結器
みっきょうだいじてん	密教大辞典
みっきょうきょうてん	密教経典
みたかしやくしょまえ	三鷹市役所前
みずほきょうぎじょう	瑞穂競技場
みずほきゅうぎじょう	瑞穂球技場
みずのみびゃくしょう	水呑み百姓
みずさわけいばじょう	水沢競馬場
みしょうだくこうこく	未承諾広告
みしゅうろくさくひん	未収録作品
みしまひろこうじえき	三島広小路駅
みけいかほけんりょう	未経過保険料
みかくにんじょうほう	見確認情報	未確認情報
みかくていせんきょく	未確定選挙区
まんもくしょうじょう	満目蕭条
まんしゅうせんりょう	満州占領
まるやまおんがくどう	丸山音楽堂
まるしょうしょくひん	丸正食品
まやくきんしほうりつ	麻薬禁止法律
まばらぶんさんきおく	まばら分散記憶
まどようだんねつざい	窓用断熱材
まちだしたいいくかん	町田市体育館
まくはりほんごうえき	幕張本郷駅
まいとしなんがつごろ	毎年何月頃
まいしゅうはっぴょう	毎週発表
まいしゅうにちようび	毎週日曜日
まいしゅうなんようび	毎週何曜日
まいしゅうすいようび	毎週水曜日
まいしゅうきんようび	毎週金曜日
まあじゃんほうろうき	麻雀放浪記
まーじゃんきょうしつ	麻雀教室
もんだいかいけつりょく	問題解決力
もとすみよしでんしゃく	元住吉電車区
もとじゅうぐんいあんふ	元従軍慰安婦
もっかんがっきいっぱん	木管楽器一般
もじにんしきしょうがい	文字認識障害
もじにゅうりょくちゅう	文字入力中
もくぶうんぱんさいぼう	木部運搬細胞
もくてきじょうひつよう	目的上必要
もくてきじょうせいとう	目的上正当
もうしこみたんとうしゃ	申込担当者
もうさいかんげんしょう	毛細管現象
めんきょしんせいふよう	免許申請不要
めいれいじっこうかのう	命令実行可能
めいだいどうてきろんり	命題動的論理
むりょうきゅうけいじょ	無料休憩所
むへんかんにゅうりょく	無変換入力
むたいざいさんけんほう	無体財産権法
むせんつうしんぎじゅつ	無線通信技術
むせきにんとうこうしゃ	無責任投稿者
むじょうけんさんせいは	無条件賛成派
むじゅうりょくたいけん	無重力体験
むしょうほしょうきかん	無償保証期間
むしゃのこうじさねあつ	武者小路実篤
むさしのじょしがくいん	武蔵野女子学院
むさしだいがくほうめん	武蔵大学方面
むげんとうひきゅうすう	無限等比級数
むきんせいずいまくえん	無菌性髄膜炎
むいしきてきりょういき	無意識的領域
みんしゅてきとうひょう	民主的投票
みんしゅしゅぎせいりつ	民主主義成立
みんしゅしゅぎしゃかい	民主主義社会
みんしゅしゅぎけんぽう	民主主義憲法
みんげいひんじょうほう	民芸品情報
みんかんけんこうほけん	民間健康保険
みんかんかんきんばしょ	民間換金場所
みんかんかんきんじょう	民間換金場
みょうじょうしょくひん	明星食品
みやざきじどうしゃどう	宮崎自動車道
みやざきしゅっしんしゃ	宮崎出身者
みやぎけんみんかいかん	宮城県民会館
みぶんしょうめいしょう	身分証明証
みなみほんじゅくでぐち	南本宿出口
みなみふなばしのりかえ	南船橋乗換
みなみくまもとえきまえ	南熊本駅前
みなみかんとうほうげん	南関東方言
みなみおおつかこうえん	南大塚公園
みつびしでんきさんけん	三菱電機産研
みつびしじこうきょうと	三菱自工京都
みついすみともぎんこう	三井住友銀行
みずさきにんじょうせん	水先人乗船
まんしゅうこくけんこく	満州国建国
まんしゅうかいたくみん	満州開拓民
まんがじょうほうざっし	漫画情報雑誌
まやくじょうしゅうしゃ	麻薬常習者
まつしたせいけいじゅく	松下政経塾
まつきがわきょうりょう	松木川橋梁
まっきしょうじょうてき	末期症状的
まいにちほうそうきょく	毎日放送局
もんだいてんほうこくしょ	問題点報告書
もんだいかいけつこうりつ	問題解決効率
もうしこみうけつけじゅん	申込受付順
めんきょじょうそうふよう	免許状送付用
めんえきていかじょうたい	免疫低下状態
めいりょうどしけんけっか	明瞭度試験結果
めいばめんしゃしんしゅう	名場面写真集
めいだいなかのはちおうじ	明大中野八王子
めいじたいしょうしょうわ	明治大正昭和
めいきょくだいぜんしゅう	名曲大全集
むりょうちゅうしゃじょう	無料駐車場
むらたじょししょうぎょう	村田女子商業
むむじゅんせいしょうめい	無矛盾性証明
むせんしんこうきょうかい	無線振興協会
むじんとうひょうりゅうき	無人島漂流記
むじゅうりょくじょうたい	無重力状態
むじゅうりょうじょうたい	無重量状態
むさしこうぎょうだいがく	武蔵工業大学
むこうかくにんとうひょう	無効確認投票
みんぞくおんがくかんけい	民族音楽関係
みんしゅしゅうちゅうせい	民主集中性
みみにゅうりょくしんごう	耳入力信号
みなみまんしゅうてつどう	南満州鉄道
みつびしでんきさんぎょう	三菱電機産業
みつびしじゅうこうぎょう	三菱重工業
みついじょうほうかいはつ	三井情報開発
みかくにんひこうぶったい	未確認飛行物体
まんるいそうしゃいっそう	満塁走者一掃
まやくてきしゅうかんせい	麻薬的習慣性
まやくちゅうどくかんじゃ	麻薬中毒患者
まつしたでんしこうぎょう	松下電子工業
まつしたでんきじょうほう	松下電器情報
まつしたでんきさんぎょう	松下電器産業
まいにちしんぶんしゃまえ	毎日新聞社前
めいだいにんげんじょうほう	名大人間情報
むこうさんげんりょうどなり	向こう三軒両隣
みんぞくおんがくかんしょう	民族音楽鑑賞
みなみおおゆうばりてつどう	南大夕張鉄道
まつしたつうしんこうぎょう	松下通信工業
まっしょうもうさいけっかん	末梢毛細血管
まいしゅうしゅうけいけっか	毎週集計結果
めいだいなかのはちおうじこうこう	明大中野八王子高校
