
ろ	滷	櫚	艫	驢	路	鷺	盧	轤	櫓	露	呂	廬	鹵	輅	枦	臚	瀘	艪	賂	絽	蕗	櫨	魯	爐	髏	炉	顱	蘆
る	璢	陋	瑠	留	婁	褸	畄	流	縷	琉	屡	鏤
り	莉	里	籬	浬	罹	悧	詈	梨	哩	李	驪	利	漓	莅	俚	俐	裏	釐	痢	理	璃	裡	履	吏	離
ら	良	騾	螺	拉	蘿	邏	鑼	等	羅	裸	們
ろん	栄	堽	崙	侖	論	崘
ろみ	路美
ろひ	路費
ろば	驢馬
ろじ	路地	露地	路次
ろし	ろ紙	濾紙
ろざ	露座	露坐	炉座
ろご	露語
ろこ	路子
ろく	勒	麓	轆	録	緑	鹿	禄	六	戮	祿	６	漉	肋	碌	淕
ろか	芦花	蘆花	濾過
ろう	廊	浪	琅	篭	聾	薐	勞	撈	瓏	朧	陋	僂	壟	粮	槞	臈	實	糧	楼	露	牢	哢	隴	樓	螻	螂	朖	焜	婁	褸	瑯	漏	蝋	狼	老	咾	弄	縷	鑞	柆	簍	瘻	榔	潦	朗	臘	癆	籠	滝	労	郎	蘢
ろー	ρ
れん	連	戀	奩	恋	濂	斂	煉	匳	鏈	漣	練	聯	聨	憐	臠	輦	廉	嗹	錬	簾	縺	鎌	攣	蓮	瀲
れみ	礼美
れな	玲奈
れつ	烈	列	洌	劣	裂	冽
れっ	列
れち	裂
れき	轢	瀝	鬲	歴	暦	靂	櫪	檪	轣	礫	癧
れい	隷	犂	霊	齢	囹	癘	蠡	祈	黎	冷	茘	羚	令	齡	例	麗	犁	礼	澪	〇	驪	勵	怜	唳	苓	砺	蛉	零	儷	綟	伶	醴	糲	励	嶺	隸	鈴	玲	戻	禮	櫺	靈	蛎	聆	鴒
るん	♪
るる	縷々	縷縷
るり	瑠璃
るみ	流美	瑠美	留美	留実
るふ	流布
るす	留守
るか	流花
るい	縲	瑠偉	壘	類	瘰	羸	誄	涙	累	塁	留衣	泪	瑠維
りん	臨	躙	廩	稟	菻	醂	燐	倫	隣	棆	鄰	吝	藺	林	淪	霖	琳	躪	凜	懍	P	麟	凛	Phosphorus	輪	鈴	鱗	綸	悋	厘	禀	痳	淋
りろ	理路
りり	凛々	律々	凛凛
りょ	膂	梠	旅	閭	踉	呂	絽	慮	虜	侶
りむ	吏務
りみ	梨美
りほ	里穂	理保	理穂
りふ	利府
りひ	理非
りの	梨乃
りに	理２
りな	ＲＩＮＡ	梨名	莉菜	理奈	利奈	梨菜	里奈	里菜	梨奈
りづ	理詰
りつ	栗	率	律	利付	慄	立	葎
りっ	律
りち	理智	理知	律	篥
りた	利他
りす	栗鼠
りじ	理事
りし	李四	利子	李斯
りさ	利下	里紗	理佐	理沙	里沙	梨沙
りご	俚語
りこ	利己
りぐ	利食
りく	勠	戮	陸	淕
りき	篥	利器	力	理器
りか	理化	理科	梨加	里歌	梨香	利香	里花	梨果	理加	李下	利佳	里香	梨花	里佳	理香
りお	理音	利落
りえ	利恵	莉英	理恵	リエ	理央	里枝	里絵	里恵	利栄	利枝	理絵
りあ	利上	里亜
りー	李
らん	纜	嬾	嵐	蘭	巒	襤	卵	籃	檻	欖	繿	爛	婪	懶	襴	濫	欒	瀾	欄	覽	臠	乱	藍	覧	攬	儖	闌	亂	鸞
らふ	裸婦
らば	騾馬
らつ	拉	溂	喇	辣	剌
らっ	拉
らち	埒	埓	拉致
らじ	裸耳
らし	裸子	螺子
らく	絡	犖	酪	洛	楽	落	烙	珞	樂	駱
らお	羅宇
らう	羅宇	労
らい	籟	磊	耒	來	来	雷	儡	擂	礼	櫑	癩	罍	莱	頼	莢	醴	賚	蕾	徠
ろんり	論理
ろんぱ	論破
ろんし	論旨
ろんご	論語
ろんげ	ロン毛
ろんぎ	論議
ろれつ	呂律
ろよう	路用
ろゆう	芦有
ろもう	路網
ろめん	路面
ろめい	露命
ろまん	浪漫
ろぼう	路傍
ろほう	濾胞
ろへん	炉辺
ろぶん	露文
ろぶつ	炉物
ろばん	露盤	路盤
ろばた	炉端	爐端
ろはん	露伴
ろはば	路幅
ろねつ	炉熱
ろない	炉内
ろどん	魯鈍
ろとう	路頭	露頭
ろてん	露店	露天	露点
ろてき	蘆荻
ろてい	路程	露呈
ろっぷ	六腑
ろっく	六区
ろっき	六輝
ろっか	六花
ろだい	露台
ろせん	路線
ろすい	呂翠
ろじん	魯迅
ろしん	炉心
ろしあ	露西亜
ろざん	廬山
ろこつ	露骨
ろこう	炉工	露光
ろけん	路肩	露見
ろけい	炉型
ろくろ	轆轤
ろくや	六哉
ろくぶ	六部
ろくば	六馬
ろくに	碌に	陸に
ろくじ	6時	六時	録事
ろくぎ	六義
ろくが	録画
ろくい	禄位
ろぎん	路銀
ろかた	路肩
ろかく	鹵獲
ろかき	濾過器
ろかい	蘆薈	櫓櫂
ろえい	露営
ろうわ	朗話
ろうや	老爺	牢屋
ろうめ	浪目
ろうむ	労務
ろうぼ	老母
ろうふ	老婦	老父	老夫
ろうひ	浪費
ろうば	老馬	老婆
ろうと	漏斗
ろうそ	労組
ろうし	老師	浪死	浪士	牢死	老死	労資	労使	老子
ろうご	老後
ろうこ	牢固	牢乎
ろうく	労苦	老躯
ろうき	牢記
ろうか	老化	蝋花	廊下
ろうあ	聾唖
ろいろ	蝋色
ろあく	露悪
ろーま	羅馬
れんり	連理
れんや	連夜
れんま	練磨	錬磨
れんぽ	蓮歩
れんぼ	恋慕
れんぷ	連符
れんぶ	練武
れんぴ	連比
れんぱ	連覇	連破
れんど	練度
れんち	廉恥
れんだ	連打
れんじ	蓮司	櫺子	櫺
れんし	連枝
れんざ	連坐	連座
れんさ	連鎖
れんご	連碁	連語
れんこ	連呼
れんげ	蓮華
れんく	連句
れんぎ	連木
れんき	練気	連記
れんが	煉瓦	連歌
れんか	連歌	廉価	恋歌	連枷	簾価
れもん	檸檬
れぶん	礼文
れてん	レ点
れつめ	列目
れつざ	列座
れつご	劣後
れつい	列位	劣位
れっぷ	烈婦	烈夫
れっぱ	裂破
れっし	烈士	列子
れっき	列記
れっか	烈火	劣化	列火
れきぶ	暦部
れきど	礫土
れきじ	歴事
れきし	歴史	轢死
れおな	玲於奈	玲央名
れいわ	例話
れいり	伶俐
れいや	麗也
れいむ	霊夢
れいみ	麗美
れいば	冷罵
れいの	例の
れいな	麗奈	伶奈	玲奈
れいど	零度
れいっ	\(_o_\)
れいち	霊地
れいず	例図
れいじ	零次	怜二	禮二	玲二	玲司	礼仁	零士	例示	零時
れいし	令嗣	霊視	麗姿	令旨	霊芝	令姉
れいこ	怜子	令子	玲子	礼子	麗子	玲香	祈子
れいく	麗句
れいぎ	礼儀
れいき	冷気	癘気	例規	霊鬼	霊気	励起	冷機
れいか	玲花	冷夏	霊化	隷下	麗華	麗香	零下	冷菓
れいう	冷雨
るろう	流浪
るりこ	るり子	留理子	ルリ子	瑠璃子
るもい	留萌
るみこ	留美子	るみ子
るべつ	留別
るにん	流人
るでん	流伝
るてん	流転
るつぼ	坩堝
るつこ	路津子
るたく	流謫
るそん	呂宋
るせつ	流説	縷説
るすつ	留寿都
るすい	留守居
るざん	流竄
るざい	流罪
るこつ	鏤骨
るこく	鏤刻
るけい	流刑
るいわ	累和
るいひ	類比
るいじ	累次	類字	類似
るいご	類語
るいこ	ルイ子
るいく	類句
るいぎ	類義
るいか	類火	累加	ルイ華
るーと	√
りんり	倫理	淋漓
りんや	林野
りんむ	林務
りんぶ	輪舞
りんぴ	燐肥
りんぱ	琳派
りんば	臨場
りんね	輪廻
りんと	凛と
りんち	隣地	林地
りんず	綾子	綸子
りんじ	臨時
りんし	臨死
りんご	林檎
りんこ	凛乎
りんぎ	稟議	禀議
りんき	悋気	臨機
りんが	鱗芽	臨画
りんか	燐火	輪禍	隣家
りんう	霖雨
りろん	理論
りれき	履歴
りるい	離塁
りりつ	利率
りりこ	梨々子
りりく	離陸
りよん	里昴
りよこ	理代子
りよく	利欲
りよう	里謡	利用	俚謡	理容
りょふ	呂布
りょひ	旅費
りょじ	旅次
りょく	仂	緑	力
りょう	凌	凉	霊	輌	喨	陵	粱	鷯	蓼	料	兩	領	良	令	廖	粮	繆	聊	療	僚	糧	涼	倆	暸	怜	楞	寥	諒	瞭	量	獵	撩	嶺	燎	輛	鬣	崚	菱	遼	了	寮	魎	両	綾	靈	亮	椋	鐐	梁	漁	猟	裲	繚	稜
りゆう	理由
りゅう	瘤	澑	竜	嶐	瑠	笠	霤	榴	硫	留	粒	苙	柳	瀏	溜	畄	旒	隆	劉	立	餾	流	龍	窿	鉚	琉	鏐	嚠
りやく	利益	理薬
りゃく	畧	擽	掠	\(中略\)	略
りめん	裡面	裏面
りまわ	利回
りほこ	理保子
りほう	李鵬	理法
りべん	利便	離弁
りべつ	離別
りべい	離米
りへい	利平
りぶん	利分
りぶつ	理物
りふだ	利札
りばら	利払
りばけ	理化
りはん	離反	離叛
りはば	利幅
りはつ	理髪	利発
りはく	李白	理博
りはい	離背
りのう	離農
りねん	理念
りにん	離任
りにち	離日
りどん	利鈍
りどう	里道
りとく	利得
りとう	離党	利刀	離島
りてん	利点
りてき	利敵	理的
りてい	里程
りづめ	理詰	理詰め
りつご	律語
りつこ	りつ子	利津子	里葎子	律子	理津子
りつき	利付き
りつい	立位
りっぱ	立派
りっち	立地
りっし	立志	律師	律詩
りっか	立夏
りちぎ	律儀	律義
りだん	離断
りだつ	離脱
りだす	利助
りたつ	利達
りたい	履帯
りそん	離村
りそく	利足	利息
りそう	理想
りせん	利銭	離船	離仙
りせつ	理説
りせき	離席	離籍
りせい	理性	離生
りすけ	理介
りすう	理数
りすい	理水	利水	離水
りじん	利刃
りじつ	離日
りしん	離心
りしり	利尻
りしゅ	理趣
りざや	利鞘
りざい	理財
りさん	理III	離散
りさつ	利札
りさこ	りさ子
りさげ	利下げ
りさい	り災	罹災
りごう	離合
りこん	離婚	利根
りこう	理工	利口	履行	利巧	利光
りげん	俚言	俚諺	理元
りけん	利権	理研	利剣
りけい	理経	理系
りぐい	利食い
りくろ	陸路
りくの	陸野
りくな	陸名
りくつ	理屈
りくち	陸地
りくじ	陸自
りくし	陸士
りくさ	陸佐
りくぎ	六義
りくか	六花
りくお	陸男
りくう	陸羽
りくい	陸尉
りくあ	陸揚
りぎょ	李漁	鯉魚
りきん	利金
りきや	力也	力哉
りきば	力場	力馬
りきち	利吉
りきし	力士
りきお	力雄	理紀夫	力男
りがん	離岸
りがく	理学
りがい	理外	利害
りかん	罹患	離間
りかこ	里加子	里佳子	理香子	りか子
りかく	離角	離隔
りかい	理解	理会
りおな	里緒菜
りおち	利落ち
りえん	梨園	離縁
りえこ	利江子	理恵子
りえき	利益
りいん	吏員
りいち	理一	利一	理１
りあげ	利上げ
りーち	立直
らんる	襤褸	藍縷
らんま	乱麻	欄間	乱馬
らんぽ	乱歩
らんぶ	乱舞
らんぴ	乱費	濫費
らんだ	乱打	懶惰
らんそ	濫訴
らんし	乱視	卵子
らんご	蘭語
らんこ	蘭子
らんぎ	乱切
らんき	嵐気
らんか	爛柯
られつ	羅列
らもん	羅門
らむだ	λ	Λ
らへん	ラ変
らどん	Rn	Radon
らでん	螺鈿
らっぱ	喇叭
らっか	落下	落果	落花
らたい	裸体
らぞう	裸像
らそく	裸足
らせん	螺線	ら旋	螺旋
らせつ	羅刹	羅切
らしん	羅針	裸身
らくび	楽日
らくば	落馬
らくど	楽土
らくだ	駱駝
らくさ	落差
らくご	落伍	落後	落語
らがん	裸眼
らかん	羅漢
らおん	ラ音
らおご	ラオ語
らうす	羅臼
らいん	莱因
らいむ	来夢
らいた	雷太
らいせ	来世
らいじ	来示
らいき	来期	礼記	来季
らいが	雷牙	来駕
らいか	来夏	雷火
らいう	雷雨
らいい	来意
らーゆ	辣油
ろんりわ	論理和
ろんりち	論理値
ろんりか	論理化
ろんぽう	論鋒	論法
ろんべん	論弁
ろんぶん	論文
ろんばく	論駁
ろんなん	論難
ろんどん	倫敦
ろんてん	論点
ろんてき	論敵	論的
ろんてい	論定
ろんだん	論断	論壇	論談
ろんだい	論題
ろんそう	論争	論爭
ろんせん	論戦
ろんせつ	論説
ろんじん	論陣
ろんじゃ	論者
ろんしゃ	論者
ろんさん	論纂
ろんさく	論策
ろんこく	論告
ろんこう	論考	論攷	論功
ろんけつ	論決	論結
ろんきょ	論拠
ろんきつ	論詰
ろんがい	論外
ろんかく	論客
ろまんは	ロマン派
ろぶつり	炉物理
ろふさぎ	炉塞ぎ
ろびらき	炉開き
ろひょう	路標
ろっぽん	六本
ろっぽう	六方	六法
ろっぺい	六平
ろっぴき	六匹
ろっぱく	六白
ろっこん	六根
ろっこつ	肋骨
ろっこう	六甲	六興
ろっけつ	六穴
ろっかん	六巻	肋間
ろっかく	六角
ろちょう	顱頂	路長
ろちゅう	路駐
ろだたみ	炉畳
ろせんず	路線図
ろせんか	路線価
ろじょう	路上
ろじうら	路地裏
ろじうむ	Rhodium	Rh
ろしょう	路床
ろしゅつ	露出
ろしあご	ロシア語
ろこうき	露光機
ろくろく	碌々
ろくろう	六郎
ろくれん	６連
ろくよう	六曜	六葉
ろくめい	六名
ろくまく	肋膜
ろくぼく	肋木
ろくべえ	六兵衛
ろくばん	六番
ろくはら	六波羅
ろくのへ	六戸
ろくねん	六年
ろくにん	六人
ろくどう	六道
ろくとく	六徳
ろくてん	六天
ろくだん	六段
ろくだか	禄高
ろくたま	六玉
ろくぞう	六蔵
ろくせい	鹿西
ろくすけ	六輔
ろくしゅ	六種
ろくざい	肋材
ろくさわ	六沢
ろくさい	録再
ろくごう	六合	麓郷	六郷
ろくがぶ	録画部
ろくがど	録画撮
ろくがつ	水無月	6月	６月	六月
ろくおん	鹿苑	録音
ろくえふ	六衛府
ろくいん	勒韻
ろおわん	六萬
ろうをお	労を惜
ろうわん	六萬
ろうろう	朗々	朗朗
ろうれん	老練	労連
ろうれつ	陋劣
ろうれい	老齢
ろうるい	蝋涙
ろうらく	籠絡	篭絡
ろうよう	老幼
ろうゆう	老優	老友	老雄
ろうもん	楼門
ろうもう	老耄
ろうむひ	労務費
ろうまん	浪漫
ろうぼく	老木	老僕
ろうほう	朗報
ろうへい	老兵
ろうばん	牢番
ろうばい	老梅	狼狽
ろうはい	老廃	老輩
ろうのう	老農	労農
ろうねん	老年
ろうにん	浪人
ろうどく	朗読
ろうどう	労働	労動
ろうとう	郎党	郎等	蝋灯
ろうでん	漏電	楼殿
ろうちん	労賃
ろうだん	壟断
ろうたい	老体
ろうぞめ	蝋染
ろうそく	蝋燭
ろうそう	老僧	老荘
ろうぜき	狼藉
ろうせつ	漏洩	漏泄
ろうせき	蝋石
ろうせい	老成	労政	老生
ろうすい	老衰	漏水
ろうじん	老人
ろうじょ	老女
ろうじゅ	老樹
ろうじつ	老実
ろうしん	老身	老臣
ろうしゅ	老酒	蝋珠
ろうしゃ	聾者
ろうしつ	狼疾
ろうざん	老残
ろうさん	老杉
ろうさく	労作
ろうさい	労災	老妻
ろうごく	牢獄
ろうこつ	老骨
ろうこく	鏤刻
ろうこう	漏光	陋巷	老公	老巧	瘻孔
ろうげつ	朗月
ろうけん	老健	老犬
ろうけつ	蝋纈
ろうけい	老兄
ろうくん	郎君	老君
ろうくみ	労組
ろうぎん	労銀	朗吟
ろうきん	労金
ろうきょ	籠居	蝋炬
ろうがん	蝋丸	老眼
ろうがい	労咳	老害
ろうかん	蝋管
ろうかく	楼閣
ろうかい	老獪
ろうおん	漏音
ろうおく	陋屋
ろうおう	老翁
ろうえん	狼煙
ろうえき	労役
ろうえい	漏洩	朗詠
ろういろ	蝋色
ろーるし	ロール紙
ろーまじ	ローマ字
ろーとる	老頭児
れんれん	恋々	恋恋	攣攣
れんるい	連累
れんりつ	連立	聯立
れんらく	聯絡	連絡
れんよう	連用
れんめん	連綿
れんめい	聯盟	連名	連盟
れんぽう	連峰	連邦	聯邦
れんぼう	連坊
れんほう	蓮舫	連舫
れんぺい	錬兵	練兵
れんふく	連複
れんびん	憐愍	憐憫
れんぱん	連判
れんぱつ	連発
れんぱく	連泊	練帛
れんぱい	連敗	連俳
れんばん	連番	連判
れんばく	恋縛
れんばい	廉売
れんねん	連年
れんにょ	蓮如
れんどら	連ドラ
れんどう	連動
れんとう	連騰	連投	連闘	連祷
れんてつ	錬鉄
れんだん	連弾
れんだく	連濁
れんだい	蓮台
れんたん	連担	連単	練炭	煉炭
れんたつ	練達
れんたい	聯隊	聨隊	連隊	連体	連帯	連対
れんぞく	連續	連続
れんそう	聯想	連想	連装	連奏
れんせん	連戦
れんせつ	連接	廉節
れんせい	連成	連製	連星	錬成
れんじょ	連署
れんじゅ	連珠
れんじつ	連日
れんじく	連軸
れんしょ	連署
れんしゅ	連取
れんしゃ	連射	連写
れんざん	連産	連山
れんさつ	憐察
れんさく	連作
れんさい	連載
れんごく	煉獄
れんごう	連合	聯合
れんこん	蓮根
れんこう	簾鉤	連行	攣拘	連衡
れんげん	∧	連言
れんけつ	連結	廉潔
れんけい	連携	聯係	連繋	連系	連係
れんぐん	連軍
れんぎん	連吟
れんきん	錬金
れんきょ	蓮炬
れんがし	連歌師
れんかん	聯関	連関	連環
れんあい	恋愛
れぶぇる	レヴェル
れにうむ	Rhenium	Re
れつれつ	冽々	冽冽
れつりつ	列立
れつなみ	列並
れつでん	列伝
れつだい	列代
れつじょ	烈女
れつじつ	烈日
れつあく	劣悪
れっぺん	裂片
れっぷう	烈風
れっぴん	列品
れっぱん	列藩
れっぱく	裂帛
れっぱい	劣敗
れっとう	列島	劣等
れっせき	列席
れっせい	列聖	劣性	冽清	劣勢
れっしん	烈震
れっしゃ	列車
れっこく	列国
れっこう	列侯
れっきょ	列挙
れっきと	歴と
れっかい	裂開
れきれき	歴々
れきゆう	歴遊
れきもと	暦本
れきほん	暦本
れきほう	歴訪	暦法
れきはく	歴博
れきねん	歴年	暦年
れきにん	歴任
れきてい	歴程
れきだん	轢断
れきだい	歴代
れきぜん	歴然
れきせん	歴戦
れきせい	歴世	瀝青
れきじつ	暦日
れきしか	歴史家
れきさつ	轢殺
れきげつ	暦月
れきがん	礫岩
れいろう	玲瓏
れいれい	麗々
れいらく	零落
れいよう	羚羊	麗容
れいやく	霊薬
れいもつ	礼物
れいめん	冷麺
れいめい	黎明	令名
れいまい	令妹
れいぼく	霊木	零墨
れいぼう	麗貌	礼帽	冷房
れいほん	零本
れいほう	礼法	霊峰	礼砲	霊宝
れいへい	例幣
れいぶん	礼文	例文	令聞	麗文
れいふく	礼服
れいふう	冷風
れいひつ	麗筆
れいばい	冷媒	霊媒
れいはい	礼拝	零敗	霊牌
れいのう	霊能
れいねん	例年
れいねつ	冷熱
れいにく	冷肉
れいとう	冷凍
れいてん	冷点	零点	礼典
れいてつ	冷徹
れいてき	霊的
れいてい	令弟
れいちゃ	冷茶
れいだん	冷暖
れいだい	例題
れいたん	冷淡
れいたつ	令達
れいたい	霊体	冷帯
れいぞく	隸屬	隷属
れいぞう	冷蔵
れいそん	令孫
れいそく	令息
れいそう	礼装
れいぜん	霊前	冷然
れいぜい	冷泉
れいせん	冷泉	零戦	零戰	霊泉	冷戦
れいせつ	例説	礼節
れいせい	冷静	励声	令婿	霊性	冷製
れいすい	霊水	冷水
れいじん	霊神	伶人	麗人
れいじつ	例日
れいじか	例示化
れいしん	励振
れいしょ	令書	隷書
れいしゅ	冷酒
れいしゃ	礼者
れいしつ	麗質	令室
れいしき	礼式	零式
れいざん	霊山
れいさい	例祭	零細
れいこん	霊魂
れいこく	例刻	冷酷
れいこう	霊光	励行
れいげん	例言	冷厳	霊験	霊言	冷源
れいげつ	例月
れいけん	霊験
れいけつ	冷血
れいけい	令閨	令兄
れいぐう	冷遇	礼遇
れいきん	礼金
れいがん	冷眼
れいがい	例外	冷害
れいかん	冷感	冷寒	霊感	冷汗
れいかく	冷覚
れいかい	冷灰	例会	霊界	例解
れいえん	霊園
れいえき	霊液
れいうん	嶺雲
れいいち	鈴一
れいいき	霊域
るりいろ	瑠璃色
るべしべ	留辺蕊
るふぼん	流布本
るすろく	留守録
るすばん	留守番
るすでん	留守電
るすたく	留守宅
るけいち	流刑地
るいれき	瘰癧
るいれい	類例
るいるい	累累	累々
るいらん	累卵
るいべつ	類別
るいへき	塁壁
るいはん	累犯	類板
るいのう	涙嚢
るいねん	累年
るいどう	類同
るいとも	類友
るいだい	類題	累代
るいぞく	類族
るいぞう	累増
るいせん	涙腺
るいせき	累積
るいせい	累世
るいすい	類推
るいじど	類似度
るいじつ	累日
るいじご	類似語
るいしん	累進	塁審
るいしょ	類書
るいざん	累算
るいさん	累算	類纂
るいげん	累減
るいげつ	累月
るいけい	累計	類型	類形
るいぎご	類義語
るいえん	類縁	類苑
りんれつ	凛冽	凛烈
りんりん	凛々	凛凛
りんりつ	林立
りんらく	淪落
りんもう	鱗毛	厘毛
りんぽん	臨本
りんぽう	隣邦
りんぺん	鱗片
りんぷん	鱗粉
りんぶん	林分
りんばん	輪番
りんばつ	輪伐
りんない	林内
りんどく	輪読
りんどう	林道	竜胆
りんてん	輪転
りんたく	輪タク
りんたい	輪帯
りんそん	隣村
りんぜん	凛然
りんせん	林泉	臨戦
りんせつ	鱗屑	隣接
りんせき	隣席	臨席
りんせい	輪生	林政	稟請
りんじん	隣人
りんしん	稟申	禀申	凛森
りんしょ	臨書
りんしゃ	臨写	倫社
りんしつ	隣室
りんざい	臨済	林材	臨在
りんさん	リン酸	林産	燐酸
りんさく	輪作
りんごす	林檎酢
りんごく	隣国
りんこう	輪講	隣好	燐鉱	臨港	輪行	燐光	臨幸	林光
りんげん	綸言
りんげつ	臨月
りんけん	臨検
りんけい	鱗形	鱗茎	輪形
りんくう	臨空
りんぎょ	臨御
りんがく	林学
りんかん	輪奐	林間	輪姦
りんかく	輪郭	輪廓
りんかい	臨界	臨海
りんえん	林苑
りんうん	鱗雲
りんいち	倫一
りんあん	燐安
りろんや	理論屋
りろんぶ	理論部
りろんは	理論派
りろんち	理論値
りろんし	理論誌
りろんか	理論家
りりょく	理力
りりょう	李陵
りりくじ	離陸時
りりくご	離陸後
りようび	利用日
りようど	利用度
りようじ	利用時
りようし	理容師
りようか	利用可
りょりつ	呂律
りょふい	呂不韋
りょのう	旅嚢
りょてん	旅店
りょてつ	旅鉄
りょてい	旅程	旅亭
りょっか	緑化
りょだん	旅団
りょそう	旅装
りょこう	旅行
りょけん	旅券
りょくや	緑野
りょくひ	緑肥
りょくど	緑土
りょくち	緑地
りょくか	緑化
りょくう	緑雨
りょぎん	旅銀
りょがい	慮外
りょかん	旅館
りょかく	旅客
りょうり	料理
りょうや	⇔	領野	涼夜	良夜
りょうめ	量目	竜馬	両目
りょうむ	寮務
りょうみ	涼味
りょうま	龍馬	竜馬	遼麻
りょうぼ	寮母	陵墓
りょうほ	稜堡
りょうぶ	両部
りょうふ	両夫
りょうび	綾美	両備
りょうひ	良否	寮費
りょうば	両馬	良馬	両刃	猟場	漁場
りょうは	両派
りょうの	稜野
りょうど	領土	両度
りょうと	良図
りょうて	両手
りょうつ	両津
りょうち	了知	領置	料地	良知	領地
りょうた	良太	亮太
りょうず	両図
りょうじ	亮治	良至	領事	良治	亮二	両次	両耳	良二	療治	良知	良司
りょうし	良師	遼史	両誌	両氏	猟師	良之	両市	漁師	量子	料紙
りょうご	良吾
りょうこ	涼子	遼子	了子	凌子	良子	領子	僚子	亮子	寮子	量子
りょうげ	令外
りょうけ	両家	領家	良家
りょうぐ	猟具
りょうぎ	両義
りょうき	涼気	僚機	漁期	猟奇	両機	量器	猟期
りょうが	凌駕
りょうか	良過	良家	寮歌	涼香	良化	量化	良貨
りょうう	涼雨
りょうい	霊異	稜威	良医	良為
りゅうろ	流路	流露
りゅうり	流離
りゅうめ	竜馬
りゅうま	竜馬
りゅうほ	留保
りゅうび	劉備	柳眉
りゅうは	流派
りゅうど	粒度
りゅうち	留置
りゅうた	竜太	隆太
りゅうず	竜頭
りゅうじ	隆治	隆史	竜二	龍二	隆二	隆司
りゅうし	粒子
りゅうざ	竜座
りゅうさ	流砂
りゅうご	龍五	隆吾
りゅうこ	竜子	隆子	竜虎	龍虎
りゅうぎ	流儀
りゅうき	隆起	劉貴
りゅうか	硫化	流下	琉歌
りゅうい	留意
りゃっき	略記
りゃくふ	略譜
りゃくず	略図
りゃくじ	略字
りゃくご	略語
りゃくげ	略解
りゃくぎ	略儀
りゃくき	略記
りゃくが	略画
りめんし	裏面史
りまわり	利回り
りべんか	離弁花
りふじん	理不尽
りびょう	痢病	罹病
りばらい	利払い
りはつし	理髪師
りにんち	離任地
りにょう	利尿
りにゅう	離乳
りつろん	立論
りつれつ	慄冽
りつれい	立礼	律令
りつりん	栗林
りつりつ	慄慄	栗栗
りつめい	立命
りつどう	律動
りつだい	立大
りつぞう	立像
りつぜん	慄然
りつげん	立言
りつがん	立願
りつあん	立案
りっぽう	立法	立方	律法
りっぷく	立腹
りっとく	六徳
りっとう	立東	立党	立冬	栗東
りったい	立体
りっそく	律速
りっせき	立席
りっすい	立錐	立推
りっしん	立身
りっこく	立国
りっこう	立項	立后
りっけん	立憲	立件
りっかん	律管
りちょう	李朝
りちてき	理知的
りちうむ	Li	Lithium
りたてき	利他的
りそうは	理想派
りそうち	理想値
りそうか	理想化
りすうか	理数科
りじょく	詈辱
りじょう	鯉城
りじゅん	利潤
りじこく	理事国
りじかい	理事会
りしょく	離職	利殖
りしょう	離礁	離昇	離床
りしゅう	履修	離愁
りさんち	離散値
りさんか	離散化
りこてき	利己的
りこせい	利己性
りこしん	利己心
りこうか	理工科
りくれん	陸連
りくよう	陸用
りくやね	陸屋根
りくぼつ	戮没
りくべつ	陸別
りくへい	陸兵
りくふう	陸風
りくどう	六道
りくとく	六徳
りくとう	陸稲
りくつや	理屈屋
りくつづ	陸続
りくだな	陸棚
りくたん	陸単
りくたい	六体
りくぞく	陸続
りくそう	陸送	陸曹
りくぜん	陸前
りくせん	陸戦
りくせい	陸棲	陸生
りくしょ	六書
りくしき	陸式
りくぐん	陸軍
りくがん	陸岸
りくがわ	陸側
りくかわ	陸川
りくかぜ	陸風
りくかい	陸海
りくえふ	六衛府
りくえい	陸影
りくうん	陸運
りくあげ	陸揚	陸揚げ
りきりつ	力率
りきょう	離郷	離京
りきゅう	利休	離宮
りきとう	力闘	力投
りきてん	力点
りきたけ	力武
りきぞう	力蔵
りきそう	力漕	力走
りきせん	力戦	力線
りきせつ	力説
りきせき	力積
りきしゃ	力車
りきさく	力作
りきがく	力学
りきかん	力感
りきかく	力覚
りきえん	力演
りきえい	力泳
りきいし	力石
りがっか	理学科
りがくぶ	理学部
りかてき	理科的
りかだい	理科大
りかしつ	理科室
りかけい	理科系
りかがく	理化学
りかいど	理解度
らんりん	乱倫
らんりつ	乱立
らんらん	爛々	爛爛
らんよう	濫用	乱用
らんもく	Gynandrae	Microspermae	Orchidales	ラン目
らんまん	爛縵	爛漫
らんまる	蘭丸
らんまく	卵膜
らんぽん	藍本
らんぽう	卵胞	蘭方
らんぼう	乱暴
らんぶん	乱文
らんぴつ	乱筆
らんぱつ	乱発
らんぱく	卵白
らんばつ	濫伐	乱伐
らんばい	乱売
らんない	欄内
らんどり	乱取り
らんどく	濫讀	乱読	濫読
らんとう	卵塔	乱闘
らんでん	藍田
らんでい	蘭泥
らんでぃ	蘭泥
らんちき	乱痴気
らんたん	Lanthanum	La
らんぞう	乱造	濫造
らんそう	卵巣	乱奏	藍藻
らんぜん	爛然
らんせん	乱戦
らんせい	乱世	卵生
らんすう	乱数
らんすい	乱酔
らんじゅ	藍綬
らんしん	乱心	乱臣
らんしょ	蘭書
らんしゅ	乱酒
らんしゃ	乱射
らんしま	蘭島
らんざん	嵐山
らんざつ	乱雑
らんごく	乱国
らんこん	乱婚
らんこし	蘭越
らんこう	乱交	乱行
らんげき	乱撃
らんけい	卵形
らんぐん	乱軍
らんぎり	乱切り
らんぎく	乱菊
らんがく	蘭学	乱学
らんがい	欄外
らんかん	藍関	欄干	卵管
らんかつ	卵割
らんかく	卵殻	濫獲	乱獲	卵核
らんおう	卵黄
らんうん	乱雲
らむにく	ラム肉
らむしゅ	ラム酒
らてんご	ラテン語
らつわん	辣腕
らっかん	楽観	落款
らちがい	埒外
らじうむ	Radium	Ra
らしんぎ	羅針儀
らしゅつ	裸出
らくるい	落涙
らくらく	楽々
らくらい	落雷
らくよう	落陽	洛陽	落葉
らくやき	楽焼き	楽焼
らくめい	落命
らくほく	洛北
らくひつ	落筆
らくばん	落磐	落盤
らくばく	落莫
らくばい	落梅
らくはつ	落髪
らくはく	落剥	落魄
らくのう	酪農
らくとう	洛東
らくてん	楽天
らくてつ	落鉄
らくちん	楽珍
らくだい	落第
らくたん	落胆
らくたい	落体
らくせん	落選
らくせつ	落雪	落屑
らくせき	落籍	落石
らくせい	落成
らくじつ	落日
らくしょ	落書
らくしゅ	落首	落手
らくしゃ	落車
らくさつ	落札
らくごか	落語家
らくがん	落雁
らくがき	落書	落書き
らくがい	洛外
らくかん	楽観
らくえん	楽園
らくいん	烙印	落胤
らぎょう	ら行	裸形	ラ行
らかんか	羅漢果
らいれき	来歴
らいりん	来臨
らいらく	磊落
らいらい	来々	磊々
らいゆう	来由	来遊
らいめい	雷鳴	雷名
らいむぎ	ライ麦
らいほう	来報	来訪
らいひん	来賓
らいはん	来阪
らいはる	来春
らいはい	礼拝
らいねん	来年
らいにん	来任
らいにち	来日
らいなつ	来夏
らいどう	雷同
らいでん	来電	雷電
らいてん	来店
らいてい	雷霆	雷帝
らいだん	来談
らいたく	来宅
らいぞう	頼三
らいせん	来仙
らいじん	雷神
らいじゅ	頼樹
らいしん	来診	来信
らいしょ	来書	来所
らいしゃ	来車	来社
らいしつ	来室
らいさん	礼賛	礼讃
らいごう	来降	来迎
らいこう	雷公	来光	来寇	来校	来貢	来航	雷光
らいげん	来源
らいげつ	来月
らいげき	雷撃
らいけん	来県
らいぎょ	雷魚
らいがく	来学
らいかん	雷管	来観	来館
らいかい	来会
らいおう	来往
らいえん	来演	来援
らいうん	雷雲
らいいん	来院
らーめん	拉麺
ろんりめい	論理名
ろんりてき	論理的
ろんりそし	論理素子
ろんりせき	論理積
ろんりせい	論理性
ろんりしき	論理式
ろんりけい	論理系
ろんりがた	論理型
ろんりがく	論理学
ろんりかん	論理感
ろんほうら	栄和了
ろんぶんし	論文誌
ろんぶんか	論文化
ろんぴょう	論評
ろんひょう	論評
ろんちょう	論調
ろんそうし	論争史
ろんじゅつ	論述
ろんしょう	論証
ろんしゅう	論集
ろんきゅう	論究	論及
ろんきゃく	論客
ろめんよう	路面用
ろてんぼり	露天掘り
ろてんぶろ	露天風呂
ろっぽんぎ	六本木
ろっきゃく	六脚
ろっきとう	六気筒
ろっかせん	六歌仙
ろっかくや	六角家
ろそくたい	路側帯
ろせんもう	路線網
ろせんめい	路線名
ろせんばす	路線バス
ろせんしゃ	路線車
ろしゅつど	露出度
ろしゅつち	露出値
ろしあもじ	ロシア文字
ろしあじん	ロシア人
ろさんじん	魯山人
ろこうまど	露光窓
ろくろくび	轆轤首
ろくぶんぎ	六分儀
ろくばんめ	六番目
ろくたんだ	六反田
ろくたろう	六太郎
ろくじょう	六畳	六条
ろくじゅう	六十
ろくじぞう	六地蔵
ろくしょう	六章	緑青
ろくしゃく	六尺
ろくがりつ	録画率
ろくがもの	録画物
ろくがどり	録画撮り
ろくがずみ	録画済み
ろくおんじ	録音時	鹿苑寺
ろくおんき	録音機
ろかたはば	路肩幅
ろかそうち	濾過装置
ろうれいか	老齢化
ろうりょく	労力
ろうやぶり	牢破り
ろうやしき	牢屋敷
ろうむしゃ	労務者
ろうふじん	老婦人
ろうふうふ	老夫婦
ろうびょう	老病	老猫
ろうばしん	老婆心
ろうばいか	ロウバイ科	Calycanthaceae
ろうねんき	老年期
ろうにゃく	老若
ろうなぬし	牢名主
ろうどうび	労働日
ろうどうか	労働歌
ろうたいか	老大家
ろうせいぶ	労政部
ろうすいし	老衰死
ろうじんご	老人語
ろうじょう	篭城	籠城	楼上	老嬢
ろうじゅく	老熟
ろうじゅう	老中
ろうじゃく	老弱	老若
ろうしんし	老紳士
ろうしょう	労相	老将	朗唱	朗笑
ろうしゅん	老春
ろうしゅつ	漏出
ろうしゅう	老醜	陋習
ろうしかん	労使間
ろうざいく	蝋細工
ろうきょく	浪曲
ろうきょう	老境	労協
ろうきゅう	籠球	老朽	篭球
ろうきほう	労基法
ろうかがわ	廊下側
れんらくじ	連絡時
れんらくさ	連絡差
れんにゅう	練乳	煉乳
れんちょく	廉直
れんちょう	連長
れんちゅう	連中
れんちゃん	連荘	連チャン
れんちゃく	恋着
れんたいし	連体詞
れんたいき	連隊旗
れんぞくち	連続値
れんぞくだ	連続打
れんぞくし	連続紙
れんぞくこ	連続弧
れんせつぶ	連接部
れんせつし	連接子
れんずぐも	レンズ雲
れんすうじ	連数字
れんじょう	連声	恋情	連城
れんじゅく	練熟
れんじゅう	連中
れんじゃく	連尺	連雀
れんしょう	連勝
れんしゅく	攣縮
れんしゅう	練習
れんざせい	連座制
れんさてき	連鎖的
れんさすう	連鎖数
れんさいじ	連載時
れんさいし	連載誌
れんごうや	連合野
れんげんし	連言肢
れんげそう	蓮華草
れんけつし	連結子
れんけつき	連結器	連結機
れんけいじ	連係時
れんきゅう	連休
れんかばん	廉価盤	廉価版
れもんすい	レモン水
れもんじる	レモン汁
れもんいろ	レモン色
れぶんとう	礼文島
れつりろん	列理論
れつたんい	列単位
れつじょう	劣情
れつじゃく	劣弱
れつごさい	劣後債
れっちゅう	列柱
れっしょう	裂傷
れっきょう	列強
れっかいか	裂開果
れちくるざ	レチクル座
れこーどや	レコード屋
れきひょう	暦表
れきちょう	歴朝
れきしもの	歴史物
れきしてき	歴史的
れきしたい	轢死体
れきししょ	歴史書
れきしがく	歴史学
れきしかん	歴史館	歴史観
れいりょく	霊力
れいりょう	冷涼
れいめいき	黎明期
れいまいり	礼参り
れいぼうか	冷房化
れいふじん	令夫人
れいふうき	冷風機
れいびょう	霊廟
れいひょう	冷評
れいはいび	礼拝日
れいはいじ	礼拝時
れいにゅう	戻入
れいとうご	冷凍後
れいとうこ	冷凍庫
れいとうき	冷凍機
れいちょう	霊長
れいぞうこ	冷蔵庫	冷藏庫
れいせんご	冷戦後
れいせんか	冷戦下
れいすいき	冷水器	冷水機
れいじろう	令二朗	礼二郎	霊次郎
れいじょう	礼譲	令嬢	令状	霊場	礼状
れいじゅう	隷従	霊獣
れいしょく	令色	冷色
れいしょう	冷笑	例証	冷床	醴漿
れいしっぷ	冷湿布
れいぎただ	礼儀正
れいきゅう	霊柩
れいきゃく	冷却
れいかいご	例会後
れーざこう	レーザ光
るりびたき	瑠璃鶲
るびじうむ	Rubidium	Rb
るてにうむ	Ru	Ruthenium
るてちうむ	Lu	Lutetium
るすろくが	留守録画
るすちゅう	留守中
るけいせつ	流刑説
るいだすう	塁打数
るいじれい	類似例
るいじょう	累乗	塁上
るいじゅう	類従	類聚
るいじめい	類似名
るいじほう	類似法
るいじぶつ	類似物
るいじひん	類似品
るいじてん	類似点
るいじせい	類似性
るいしょう	類焼	類症
るいざんき	累算器
るいごめい	類語名
るいけいか	類形化	類型化
るーんもじ	ルーン文字
るーまにあ	羅馬尼
りんわしつ	輪話室
りんりめん	倫理面
りんりてき	倫理的
りんりがく	倫理学
りんりかん	倫理観	倫理感
りんびょう	淋病
りんぱせん	リンパ腺
りんぱせつ	リンパ節
りんぱえき	リンパ液
りんばかん	臨場感
りんどうか	リンドウ科
りんてんき	輪転機
りんちょう	臨調
りんせんじ	林泉寺
りんせつち	隣接地
りんじょう	鱗状	臨場	輪状
りんじゅう	臨終
りんじびん	臨時便
りんじてき	臨時的
りんじかい	臨時会
りんじえき	臨時駅
りんじいん	臨時員
りんしょく	吝嗇
りんしょう	臨牀	臨床	輪唱
りんしゅつ	臨出
りんしゅう	凛秋
りんしゃん	嶺上
りんしもく	鱗翅目
りんししつ	燐脂質
りんごしゅ	林檎酒
りんくもと	リンク元
りんくさき	リンク先
りんぎょう	林業
りんぎしょ	稟議書	禀議書
りんがっか	林学科
りんかいぶ	臨海部
りんかいち	臨界値
りろんてき	理論的
りろんじく	理論軸
りろんしょ	理論書
りろんしき	理論式
りろんけん	理論研
りろんかい	理論解
りれきしょ	履歴書
りりくまえ	離陸前
りようれき	利用歴
りようれい	利用例
りようりつ	利用率
りようほう	利用法
りようふか	利用不可
りようてん	理容店
りようしゃ	利用者
りようしつ	理容室
りようけん	利用券	利用研	利用権
りようくだ	利用下
りようがく	利用学	利用額
りようかち	利用価値
りようかく	利用角
りようえき	利用駅
りょりょく	膂力
りょちょう	旅鳥
りょじょう	旅情
りょじゅん	旅順
りょしゅく	旅宿
りょしゅう	旅愁	虜囚
りょこうじ	旅行時
りょこうき	旅行紀	旅行記
りょけんか	旅券課
りょくりん	緑林
りょくもん	緑門
りょくべん	緑便
りょくふう	緑風
りょくはつ	緑髪
りょくとう	緑豆
りょくちゃ	緑茶
りょくちく	緑竹
りょくそう	緑草
りょくすい	緑水
りょくじゅ	緑樹
りょくがん	緑眼
りょくいん	緑陰
りょきゃく	旅客
りょかっき	旅客機
りょかくき	旅客機
りょうわん	両腕
りょうわき	両脇
りょうろん	両論
りょうれん	寮連
りょうりん	両輪
りょうりや	料理屋
りょうりつ	両立	料率
りょうらん	撩乱	繚乱
りょうよく	両翼
りょうよう	療養	両様	両用
りょうゆう	僚友	良友	領有	両雄
りょうやく	良薬
りょうもん	良問
りょうもう	両毛
りょうめん	両面
りょうめい	両名
りょうみん	領民	良民
りょうみみ	両耳
りょうまつ	糧秣
りょうまえ	両前
りょうまい	糧米
りょうほう	療法	両方	良法
りょうへん	両辺
りょうへき	両壁
りょうへい	良平
りょうぶん	領文	両分	領分
りょうふう	涼風	良風
りょうびら	両開
りょうひん	良品
りょうひら	両開
りょうひざ	両膝
りょうばば	良馬場
りょうはん	量販
りょうはじ	両端
りょうはし	両端
りょうはい	両肺
りょうのう	両脳
りょうねん	両年
りょうねい	遼寧
りょうにん	良人	両人
りょうなん	綾南
りょうない	寮内	領内
りょうどう	両道	糧道
りょうとし	両都市
りょうとく	両得	領得
りょうとう	両党	両刀	竜頭	両統	遼東	両頭
りょうでん	菱電
りょうてき	量的
りょうてい	量定	料亭
りょうちく	両地区
りょうだん	両断
りょうだめ	両為
りょうだて	両建て
りょうたん	両端
りょうぞく	良俗
りょうぞう	良三
りょうそで	両袖
りょうそく	寮則	両側
りょうぜん	瞭然	霊山	両全
りょうぜつ	両舌
りょうせん	両川	両線	両船	稜線	僚船
りょうせつ	両説
りょうせい	寮生	両棲	両性	両生	良性
りょうすけ	亮介	良介	遼右	領介	了介	良助	良祐
りょうすう	両数	輛数
りょうすい	量水	領水
りょうじん	良人	梁塵	猟人
りょうじょ	諒恕	梁書
りょうじつ	両日
りょうじさ	両耳差
りょうじく	両軸
りょうしん	良心	両親	両身
りょうしょ	良書	両書	両所
りょうしゅ	料酒	領取	領主	良種
りょうしゃ	両社	両者
りょうしば	量子場
りょうしつ	良質
りょうしき	両式	良識
りょうしか	量子化
りょうざい	良剤	梁材	良材
りょうさん	量産
りょうさつ	了察
りょうさく	良作	良策
りょうさい	寮祭	良妻
りょうごく	領国	両国
りょうこく	両国
りょうこう	良工	両校	良港	良好
りょうげん	両舷	燎原
りょうけん	了見	料簡	両県	了簡	良兼	猟犬
りょうけつ	良血
りょうけい	量刑	両系	良計	菱形	良形
りょうぐん	両群	両軍
りょうくん	両君
りょうくう	領空
りょうぎり	両切り
りょうぎし	両岸
りょうきん	料金
りょうきち	良吉	亮吉
りょうきき	両利き
りょうがん	両眼	両岸
りょうがわ	両側
りょうがえ	両替
りょうかん	涼感	寮管	僚艦	良寛	両艦	寮監	猟官	量感
りょうかみ	両神
りょうかた	両方	両肩
りょうかし	量化子
りょうかく	稜角
りょうかい	了解	諒解	領会	領海
りょうえん	遼遠	良縁
りょうえき	両駅
りょううん	凌雲
りょううで	両腕
りょういん	両院
りょういち	領一	凌一	亮一	龍一	良一	遼一	竜一
りょういき	領域
りょうあん	良案	両案
りょうあて	寮宛
りょうあし	両脚	両足
りゆうづけ	理由付け	理由付
りゆうしょ	理由書
りゅうれん	流連
りゅうれい	流麗
りゅうよう	竜洋	柳腰	流用
りゅうもん	竜門
りゅうみん	流民
りゅうぼく	立木	流木
りゅうぼう	流亡
りゅうほく	竜北
りゅうほう	劉邦	龍鳳	隆法
りゅうべん	流眄
りゅうべつ	留別
りゅうべい	立米
りゅうへい	龍平	流弊
りゅうねん	留年
りゅうにん	留任
りゅうにち	留日
りゅうどう	竜堂	流動	竜童
りゅうとう	竜党	竜頭
りゅうでん	流伝	流電
りゅうてき	竜笛
りゅうてい	流涕
りゅうつぼ	立坪
りゅうつう	流通
りゅうだん	榴弾	榴彈	流弾
りゅうだい	龍大	琉大
りゅうたく	流謫
りゅうたい	隆替	流体
りゅうぞく	流俗
りゅうぞう	竜三	立像	隆三	龍蔵
りゅうそく	流速	流束
りゅうぜん	流涎
りゅうせん	隆線	流線	流涎
りゅうせつ	流説
りゅうせい	流星	隆盛
りゅうすけ	竜介	龍輔	龍介	隆介	竜助
りゅうすう	留数
りゅうすい	流水
りゅうじん	龍神	竜神
りゅうじゅ	竜樹	龍樹
りゅうしゃ	竜車
りゅうしつ	流失
りゅうしち	流質
りゅうざん	流産	竜山	流竄
りゅうざき	竜崎
りゅうさん	硫酸
りゅうこつ	竜骨
りゅうこく	龍谷	竜谷
りゅうこう	龍宏	流行
りゅうげん	流言
りゅうけん	竜権
りゅうけつ	流血
りゅうけい	流刑
りゅうぐう	竜宮	龍宮	流寓
りゅうきん	琉金
りゅうきし	竜騎士
りゅうがん	龍眼	竜顔	竜眼
りゅうがく	留学
りゅうかん	流感	流汗
りゅうかい	流会
りゅうおん	流音
りゅうおう	竜王	龍王
りゅううん	隆運
りゅういん	溜飲
りゅういち	龍一	隆一	竜一
りゅういき	流域
りゅうあん	劉安	硫安
りゃんそう	二索
りゃっかい	略解
りゃくれき	略歴
りゃくめい	略名
りゃくほん	略本
りゃくふく	略服
りゃくひつ	略筆
りゃくでん	略伝
りゃくちず	略地図
りゃくだつ	略奪	掠奪
りゃくたい	略体
りゃくそう	略装
りゃくせつ	略説
りゃくじょ	略叙
りゃくじゅ	略綬
りゃくしゅ	略取
りゃくしき	略式
りゃくごう	略号
りゃくこう	略光
りゃくげん	略言
りゃくかい	略解
りゃくおう	暦応
りべんせい	履便性	利便性
りふとけん	リフト券
りはびりか	リハビリ科
りはつりく	離発陸
りはつてん	理髪店
りねんしつ	リネン室
りつりょう	律令
りつめんず	立面図
りつじゅん	率順
りつきょう	立教
りっぽうふ	立法府
りったいし	立太子	立体視
りったいか	立体化
りっしょく	立食
りっしょう	立正	立証
りっしゅん	立春
りっしゅう	立秋	律宗
りっしでん	立志伝
りっこくし	六国史
りっこうほ	立候補
りっきょう	陸橋	立教
りっきゃく	立脚	立客
りたしゅぎ	利他主義
りぞーとち	リゾート地
りそくぶん	利息分
りそうろん	理想論
りそうてき	理想的
りそうぞう	理想像
りそうけい	理想系	理想形
りせいろん	理性論
りせいてき	理性的
りずむかん	リズム感
りすうけい	理数系
りじちょう	理事長
りしんろん	理神論
りしんりつ	離心率
りしりとう	利尻島
りしゅたい	利主体
りさんてき	離散的
りさんせい	離散性
りさんけい	離散系
りさぶろう	利三郎
りこんれき	離婚歴
りこんりつ	離婚率
りこしゅぎ	利己主義
りこうけい	理工系
りこうがく	理工学
りけいてき	理系的
りくりょく	戮力
りくつどお	理屈通
りくつづき	陸続き
りくつぜめ	理屈責め
りくちょう	六朝
りくちゅう	陸中
りくじょく	戮辱
りくじょう	陸上
りくしょう	戮笑	陸相	陸将
りくしゅつ	六出
りくぎえん	六義園
りくきょう	陸橋
りきりょう	力量
りがくてき	理学的
りがくけい	理学系
りかんりつ	罹患率
りかにるい	理科二類
りかききや	理科機器屋
りかいしゃ	理解者
りえきりつ	利益率
りえきぞう	利益増
りうまちか	リウマチ科
りいちろう	理一郎
らんりゅう	乱流
らんみゃく	乱脈
らんぽうい	蘭方医
らんにゅう	乱入	闌入
らんとうば	卵塔場
らんちょう	鸞鳥	乱調	乱丁
らんだせん	乱打戦
らんたろう	乱太郎
らんすうち	乱数値
らんすうか	乱数化
らんじゅく	爛熟
らんしょう	濫觴
らんしゅう	蘭州
らんこうげ	乱高下
らんぎょく	藍玉
らんぎょう	乱行
らんきゅう	卵丘
らっしゅじ	ラッシュ時
らっきょう	楽境	薤	辣韭
らっきゅう	落球
らっかんし	楽観視
らっかぶつ	落下物
らっかてん	落下点
らっかせい	落花生
らっかさん	落下傘
らしんばん	羅針盤
らくのうか	酪農家
らくてんし	楽天使
らくてんか	楽天家
らくちょう	落潮	落丁
らくちゅう	洛中
らくちゃく	落着
らくだいろ	駱駝色
らくたろう	楽太郎
らくじょう	落城
らくしょく	落飾
らくしょう	酪漿	落掌	楽勝
らくごしゃ	落後者
らおちゅー	老酒
らいんすう	ライン数
らいりゅう	雷竜
らいびょう	癩病
らいばしょ	來場所	来場所
らいねんど	来年度
らいにちじ	来日時
らいちょう	来朝	来聴	雷鳥
らいちゃく	来着
らいせいき	来世紀
らいじょう	来場	来状
らいしんし	頼信紙
らいしょう	来生
らいしゅん	来春
らいしゅう	来襲	来秋	来集	来週
らいごうず	来迎図
らいげつど	来月度
らいげきき	雷撃機
らいきゃく	来客
らいがっき	来学期
らーめんや	ラーメン屋
ろんりそうち	論理装置
ろんりそうさ	論理操作
ろんりじょう	論理上
ろんりじかん	論理時間
ろんりしゅぎ	論理主義
ろんりきばん	論理機番
ろんりきのう	論理機能
ろんりきごう	論理記号
ろんりがめん	論理画面
ろんりかいろ	論理回路
ろんりかいぎ	論理会議
ろんぶんめい	論文名
ろんぶんなど	論文等
ろんぶんすう	論文数
ろんせつぶん	論説文
ろめんぶぶん	路面部分
ろめんおんど	路面温度
ろまんひこう	浪漫飛行
ろまんしゅぎ	浪漫主義	ロマン主義
ろへんだんわ	炉辺談話
ろばんこうじ	路盤工事
ろてんしょう	露天商
ろっぽんまつ	六本松
ろっこうみち	六甲道
ろっこうだい	六甲台
ろっこうさん	六甲山
ろっかっけい	六角形
ろっかくばし	六角橋
ろたんちょう	ロ短調
ろせんはんい	路線範囲
ろせんせいび	路線整備
ろせんずしき	路線図式
ろせんいがい	路線以外
ろじさいばい	露地栽培
ろしゅつけい	露出系	露出計
ろしゅつかた	露出過多
ろこうりょう	露光量
ろこうじかん	露光時間
ろこうきょう	盧溝橋
ろけっとほう	ロケット砲
ろけっとだん	ロケット弾
ろぐいんめい	ログイン名
ろくよくてん	六欲天
ろくもんせん	六文銭
ろくめんたい	六面体	６面体
ろくめいかん	鹿鳴館
ろくまくえん	肋膜炎
ろくぼうせい	六芒星
ろくぶんぎざ	六分儀座
ろくびょうし	六拍子
ろくちょうし	六調子
ろくだんぐみ	六段組
ろくだいがく	六大学
ろくせんまい	六千枚
ろくじっぴき	六十匹
ろくじっさい	六十歳
ろくしんたい	六神体
ろくしんがん	六神丸
ろくさんせい	六三制
ろくさぶろう	六三郎
ろくさいせい	録再生
ろくごうせん	六号線
ろくがよやく	録画予約
ろくがちゅう	録画中
ろくがじてん	録画時点
ろくがじかん	録画時間
ろくがきのう	録画機能
ろくおんよう	録音用
ろくおんもの	録音物
ろくおんもと	録音元
ろくおんばん	録音盤
ろくおんねん	録音年
ろくおんずみ	録音済
ろくおんがわ	録音側
ろかこうえん	芦花公園
ろうれいしゃ	老齢者
ろうらんどう	楼蘭堂
ろうめいじん	老名人
ろうはいぶつ	老廃物
ろうにんせい	浪人生
ろうどうほう	労働法
ろうどうとう	労働党
ろうどうしゃ	労働者
ろうどうけん	労働権
ろうとじょう	漏斗状
ろうていとく	老提督
ろうたいこく	老大国
ろうじんはん	老人斑
ろうじんせい	老人性
ろうじんかい	老人会
ろうきゅうか	老朽化
ろうがっこう	聾学校
ろいろうるし	蝋色漆
ろーますうじ	ローマ数字
ろーましんわ	ローマ神話
ろーかるせん	ローカル線
れんらくらん	連絡欄
れんらくよう	連絡用
れんらくもう	連絡網
れんらくどう	連絡道
れんらくせん	連絡船	連絡線
れんらくずみ	連絡済み
れんらくじょ	連絡所
れんらくしょ	連絡書	連絡所
れんらくしゃ	連絡者
れんらくさき	連絡先
れんらくぐち	連絡口
れんらくかい	連絡会
れんらくえき	連絡駅
れんらくいん	連絡員
れんらくいた	連絡致
れんようけい	連用形
れんめいしゃ	連名者
れんぽうぐん	連邦軍
れんぽうがわ	連邦側
れんぶんせつ	連文節
れんぶんすう	連分数
れんふくしき	連複式
れんぱちゅう	連覇中
れんどうしき	連動式
れんたんせい	連担性
れんたいりつ	連対率	連体率
れんたいけい	連体形
れんたいきぼ	連隊規模
れんたいかん	連帯感
れんぞくわざ	連続技
れんぞくもの	連続もの
れんぞくふか	連続負荷
れんぞくてき	連続的
れんぞくだん	連続弾
れんぞくたい	連続体
れんぞくそく	連続束
れんぞくせい	連続性
れんぞくしき	連続式
れんぞくけい	連続系
れんそうらむ	連想ＲＡＭ
れんそうほう	連装砲
れんそうてき	連想的
れんそうしき	連想式
れんせつしゃ	連接車
れんせいけい	連成系	連星系
れんしょうご	連勝後
れんしゅうび	練習日
れんしゅうじ	練習時
れんしゅうき	練習機
れんしゃしき	連射式
れんしゃおん	連射音
れんざぶろう	錬三郎
れんさけいろ	連鎖経路
れんさいきじ	連載記事
れんごうてき	連合的
れんごうたい	連合体
れんごうこく	連合国
れんごうぐん	連合軍
れんごうかい	連合会
れんこうあし	練行足
れんげんけい	連言形
れんけつめん	連結面
れんけつせい	連結性
れんけついち	連結位置
れんけいわざ	連携技
れんきゅうあ	連休明
れんがづくり	煉瓦造り
れんあいろん	恋愛論
れんあいべた	恋愛下手
れんあいかん	恋愛観
れんあいうん	恋愛運
れつべくとる	列ベクトル
れつばんごう	列番号
れつくうかん	列空間
れつあくしゃ	劣悪者
れっぴんかん	列品館
れっとうせい	劣等生
れっとうざい	劣等財
れっとうかん	劣等感
れっせきしゃ	列席者
れっしゃめい	列車名
れっしゃほう	列車砲
れっしゃない	列車内
れっしゃぐん	列車群
れっきょがた	列挙型
れすちおもく	Restionales	レスチオ目
れこーどてん	レコード店
れきひょうじ	暦表時
れきねんれい	暦年齢
れきしりかい	歴史理解
れきしすいり	歴史推理
れきしじょう	歴史上
れきしじだい	歴史時代
れきしがっか	歴史学科
れいようしゅ	冷用酒
れいゆうかい	霊友会
れいぼうりつ	冷房率
れいぼうよう	冷房用
れいぼうしゃ	冷房車
れいぼうこう	礼奉公
れいふうせん	冷風扇
れいはいどう	礼拝堂
れいのうしゃ	霊能者
れいとうもの	冷凍物
れいとうひん	冷凍品
れいとうしつ	冷凍室
れいだんぼう	冷暖房
れいだいよう	例題用
れいたいさい	例大祭
れいぞくてき	隷属的
れいぞうしつ	冷蔵室
れいすいよう	冷水用
れいじんそう	伶人草
れいしょたい	隷書体
れいけつかん	冷血漢
れいぎさほう	礼儀作法
れいきゃくぶ	冷却部
れいきゃくき	冷却器
れいがいてん	例外点
れいがいてき	例外的
れいおんたい	冷温帯
れいあんじょ	冷暗所
れいあんしょ	冷暗所
れいあんしつ	霊安室
るろうのたみ	流浪の民
るしゃなぶつ	盧遮那仏	盧舎那仏
るいたいろん	類体論
るいじんえん	類人猿
るいじぶぶん	類似部分
るいじきかん	類似機関
るいじかもく	類似科目
るいしんりつ	累進率
るいしんぜい	累進税
るいしんせい	累進性
るいごじてん	類語辞典
るいげんぜい	累減税
るいけいろん	類型論
るいけいてき	類型的
るいがいねん	類概念
りんりじょう	倫理上
りんりきてい	倫理規定
りんりきせい	倫理規制
りんやちょう	林野庁
りんばんせい	輪番制
りんどうもく	Gentianales	リンドウ目
りんどうめい	林道名
りんどうぐん	林道群
りんたいさく	倫対策
りんせつせき	隣接席
りんせつえき	隣接駅
りんせいもく	Verticillatae	輪生目
りんじんたち	隣人達
りんじんあい	隣人愛
りんじぶもん	臨時部門
りんじけんさ	臨時検査
りんしょうか	臨床家
りんしょうい	臨床医
りんさんぶつ	林産物
りんさいぼう	林災防
りんごばたけ	林檎畑
りんこうせん	臨港線
りんこうしゃ	輪行車
りんこうしつ	輪講室
りんこうぐん	燐光群
りんこうかい	輪講会
りんくしゅう	リンク集
りんぎょうか	林業家
りんがっかい	林学会
りんかくせん	輪郭線
りんかいてん	臨界点
りんかいかく	臨界角
りんいちろう	倫一郎
りろんりがく	理論理学
りろんぶつり	理論物理
りろんぶそう	理論武装
りろんじょう	理論上
りろんしゅぎ	理論主義
りろんかがく	理論化学
りろせいぜん	理路整然
りれきちかん	履歴置換
りりくふのう	離陸不能
りりくそくど	離陸速度
りりくじかん	離陸時間
りようりょう	利用料
りようよてい	利用予定
りようよそく	利用予測
りようぶんや	利用分野
りようひんど	利用頻度
りようはんい	利用範囲
りようちゅう	利用中
りようじょう	利用上
りようじかん	利用時間
りようしょう	利用証
りようしかく	利用資格
りようげんど	利用限度
りようくかん	利用区間
りようきょり	利用距離
りようきゃく	利用客
りようきぼう	利用希望
りようきてい	利用規程
りようきげん	利用期限
りようきかん	利用期間
りようきかい	利用機会
りようがかり	利用掛
りようかのう	利用可能
りようかいし	利用開始
りよういがい	利用以外
りょこうまえ	旅行前
りょこうぼう	旅行帽
りょこうだん	旅行団
りょこうだい	旅行代
りょこうずき	旅行好き
りょこうしゃ	旅行社	旅行者
りょこうさき	旅行先
りょこうけん	旅行券
りょこうかい	旅行会
りょくでんか	緑電化
りょくちたい	緑地帯
りょくしょく	緑色
りょくぎょく	緑玉
りょきゃっき	旅客機
りょきゃくき	旅客機
りょきゃくか	旅客化
りょかんなみ	旅館並み
りょかんがい	旅館街
りょうりよう	料理用
りょうりょう	寥寥	了々	両々	稜稜	了了	稜々	喨々	寥々	喨喨	両両
りょうりめい	料理名
りょうりほう	料理法
りょうりばん	料理番
りょうりにん	料理人
りょうりてん	料理店
りょうりしゅ	料理酒
りょうりがく	料理学
りょうりかい	料理会	料理界
りょうようひ	療養費
りょうようき	両用機
りょうめじり	両目尻
りょうほぞん	量保存
りょうほうと	両方取
りょうへいか	両陛下
りょうぶんや	両分野
りょうぶもん	両部門
りょうびらき	両開き
りょうびょう	療病
りょうどなり	両隣
りょうどない	領土内
りょうてなべ	両手鍋
りょうちょう	猟鳥	寮長
りょうたろう	亮太郎	遼太郎	良太郎
りょうそしき	両組織
りょうせいか	両性花
りょうすいき	量水器
りょうじょく	凌辱	陵辱
りょうじょう	梁上
りょうじゅう	猟銃
りょうじかん	両時間	両耳間	領事館
りょうじいち	両耳位置
りょうしろん	量子論
りょうしょく	寮食	糧食
りょうしょう	了承	諒承
りょうしゅう	涼秋	領袖	領収
りょうしてき	量子的
りょうしきか	良識家
りょうしあい	両試合
りょうさんき	量産機
りょうさんか	量産化
りょうこうり	両公理
りょうこうほ	両候補
りょうげんご	両言語
りょうけんざ	猟犬座
りょうけつば	良血馬
りょうぎせい	両義性
りょうぎいん	両議院
りょうきんさ	料金差
りょうきんか	料金課
りょうきょく	両極
りょうきゃく	両脚
りょうきてき	猟奇的
りょうきごう	量記号
りょうきおう	猟奇王
りょうがんし	両眼視
りょうがえや	両替屋
りょうがえき	両替機
りょうかがた	良化型
りょうかいど	了解度
りょうおもい	両思い	両想い
りょうえんこ	両円弧
りょううわて	両上手
りょういきか	領域化
りょうあんじ	竜安寺
りゅうりょう	流量
りゅうりゅう	隆々
りゅうようか	流用化
りゅうひょう	流氷
りゅうのすけ	龍之介	竜之介
りゅうにゅう	流入
りゅうどうか	流動化
りゅうちよう	留置用
りゅうちょう	流暢	留鳥
りゅうちぶつ	留置物
りゅうちばり	留置針
りゅうちせん	留置線
りゅうちじょ	留置所
りゅうちけん	留置権
りゅうたろう	竜太郎	龍太郎
りゅうぞうじ	龍造寺
りゅうせいう	流星雨
りゅうじょう	粒状
りゅうしょく	粒食
りゅうしょう	隆昌
りゅうしゅつ	流出
りゅうしそく	粒子束
りゅうしせん	粒子線
りゅうしせい	粒子性
りゅうしすう	粒子数
りゅうさんし	硫酸紙
りゅうこつざ	竜骨座
りゅうこうご	流行語
りゅうこうか	流行歌
りゅうきょく	流局
りゅうきゅう	琉球
りゅうきへい	竜騎兵
りゅうきこう	硫気孔
りゅうがだけ	竜ヶ岳
りゅうがさき	竜ケ崎	竜崎	龍崎	竜ヶ崎
りゅういてん	留意点
りゅうあんじ	竜安寺
りゅーふぁー	緑発
りゃっきほう	略記法
りゃくひょう	略表
りゃくじゅつ	略述
りゃくしょう	略章	略称
りゃくきほう	略記法
りぼかくさん	リボ核酸
りべんかるい	離弁花類	Choripetalae	Apopetalae
りはっちゃく	離発着
りのーるさん	リノール酸
りつめいだい	立命大
りつめいせん	立命戦
りつめいがわ	立命側
りつめいかん	立命館
りつどうてき	律動的
りつけいさん	率計算
りっぽうたい	立方体
りっぽうこん	立方根
りっぽうけん	立法権
りっぽうがそ	立方画素
りっぽういん	立法院
りっとうしゃ	立東社
りったいぶつ	立体物
りったいばん	立体版
りったいてき	立体的
りったいぞう	立体像
りったいかん	立体感
りったいかく	立体角
りっすいのち	立錐之地	立錐の地
りっしゃくじ	立石寺
りちゃくりく	離着陸
りたこうどう	利他行動
りそうせかい	理想世界
りそうじょう	理想上
りそうしゅぎ	理想主義
りそうげんご	理想言語
りそうきょう	理想郷	理想境
りそうきたい	理想気体
りせいしんぴ	離生心皮
りじんしょう	離人症
りじかいしつ	理事会室
りしょうばん	李承晩
りしゅきょう	理趣経
りしゅうしゃ	履修者
りしほきゅう	利子補給
りさんじかん	離散時間
りさんきんじ	離散近似
りさんかごさ	離散化誤差
りさんいそう	離散位相
りこんとどけ	離婚届
りこうふのう	履行不能
りこうちたい	履行遅滞
りこうがくぶ	理工学部
りけんがらみ	利権絡み
りくふうがた	陸封型
りくせんたい	陸戦隊
りくせいそう	陸成層
りくじょうぶ	陸上部
りくじょうき	陸上機
りくしゅつか	六出花
りくぐんしき	陸軍式
りくかいぐん	陸海軍
りくかいくう	陸海空
りきゅういろ	利休色
りきどうざん	力道山
りきどうかん	力動感
りきがくてき	力学的
りきがくけい	力学系
りがんりゅう	離岸流
りがくはくし	理学博士
りがくはかせ	理学博士
りかだいがく	理科大学
りかいりょく	理解力
りかいぶそく	理解不足
りかいふのう	理解不能
りかいかてい	理解過程
りえんじょう	離縁状
りーすりょう	リース料
らんぽしょう	乱歩賞
らんぼうもの	乱暴者
らんぶんかつ	卵分割
らんはんしゃ	乱反射
らんちょうし	乱調子
らんたいせい	卵胎生
らんそうがん	卵巣癌
らんそううん	乱層雲
らんすうれつ	乱数列
らんさいぼう	卵細胞
らんきりゅう	乱気流
らんかんさい	卵管采
らんおうまく	卵黄膜
らんおうのう	卵黄嚢
らまーずほう	ラマーズ法
らっせるしゃ	ラッセル車
らっかんてき	楽観的
らっかちゅう	落下中
らっかちてん	落下地点
らせんじょう	螺旋状
らじょうもん	羅城門
らしんばんざ	羅針盤座
らしょうもん	羅生門
らくようじゅ	落葉樹
らくてんてき	楽天的
らくぢゃわん	楽茶碗
らくちゃわん	楽茶碗
らくせんしゃ	落選者
らくせいしき	落成式
らくさつしゃ	落札者
らくかんてき	楽観的
らくいんきょ	楽隠居
らかんちゅう	羅貫中
らいらいねん	来々年
らいほうしゃ	来訪者
らいひんせき	来賓席
らいはいどう	礼拝堂
らいねんまつ	来年末
らいねんはる	来年春
らいねんなつ	来年夏
らいねんごろ	来年頃
らいねんあき	来年秋
らいにちまえ	来日前
らいときゅう	ライト級
らいじんおう	雷神王
らいしーずん	来シーズン
らいさんよう	頼山陽
らいげつぶん	来月分
らいげつごう	来月号
らいがくねん	来学年
らーめんてん	ラーメン店
ろんりゆうせん	論理優先
ろんりめいだい	論理命題
ろんりむじゅん	論理矛盾
ろんりへんすう	論理変数
ろんりてんかい	論理展開
ろんりていすう	論理定数
ろんりだんかい	論理段階
ろんりたいけい	論理体系
ろんりせっけい	論理設計
ろんりじゅうし	論理重視
ろんりざひょう	論理座標
ろんりごうせい	論理合成
ろんりこうぞう	論理構造
ろんりけいさん	論理計算
ろんりがくてき	論理学的
ろんりがくしゃ	論理学者
ろんりかんすう	論理関数
ろんりかいろず	論理回路図
ろんりかいそう	論理階層
ろんりえんざん	論理演算
ろんぶんようし	論文要旨
ろんぶんはくし	論文博士
ろんぶんはかせ	論文博士
ろんぶんちょう	論文調
ろんぶんちゅう	論文中
ろんぶんしんさ	論文審査
ろんぶんしょう	論文賞
ろんぶんしゅう	論文集
ろんぶんしどう	論文指導
ろんそうちゅう	論争中
ろんそうかてい	論争過程
ろんそうあいて	論争相手
ろんせついいん	論説委員
ろんしいっかん	論旨一貫
ろめんでんしゃ	路面電車
ろびーかつどう	ロビー活動
ろっこうおろし	六甲颪
ろっかしょむら	六ヶ所村
ろちょうちょう	ロ長調
ろせんへんこう	路線変更
ろせんばんごう	路線番号
ろせんげんてい	路線限定
ろせんかくにん	路線確認
ろしんけいさん	炉心計算
ろしゅつほせい	露出補正
ろしゅつぶそく	露出不足
ろしゅつじかん	露出時間
ろしゅつしょう	露出症
ろしゅつきょう	露出狂
ろくばんちょう	六番町
ろくどうりんね	六道輪廻
ろくだいしゅう	六大州
ろくじゅっぴき	六十匹
ろくじゅっさい	六十歳
ろくじゅうそう	六重奏
ろくがほうしき	録画方式
ろくがふかのう	録画不可能
ろくがしっぱい	録画失敗
ろくがさいせい	録画再生
ろくがぎじゅつ	録画技術
ろくおんひょう	録音評
ろくおんてーぷ	録音テープ
ろくおんちゅう	録音中
ろくおんきのう	録音機能
ろくおんきざい	録音機材
ろくおんかのう	録音可能
ろかたそうこう	路肩走行
ろうりょくてき	労力的
ろうにんちゅう	浪人中
ろうにんじだい	浪人時代
ろうにんぎょう	蝋人形
ろうどうりんり	労働倫理
ろうどうりょく	労働力
ろうどうりょう	労働量
ろうどうそうぎ	労働争議
ろうどうじょう	労働上
ろうどうじかん	労働時間
ろうどうしょう	労働省
ろうどういよく	労働意欲
ろうちょうほう	労調法
ろうそうしそう	老荘思想
ろうじんほけん	老人保健
ろうじんほーむ	老人ホーム
ろうじんびょう	老人病
ろうじんしせつ	老人施設
ろうじんえいが	老人映画
ろうしふんそう	労使紛争
ろうさいほけん	労災保険
ろうきょうじゅ	老教授
ろうがんきょう	老眼鏡
ろうえきじょう	労役場
ろうえいでんぱ	漏洩電波
ろうあがっこう	聾唖学校
ろーれんしうむ	Lawrencium	Lr
ろーまほうおう	ローマ法王
ろーとせいやく	ロート製薬
ろーかるしょく	ローカル色
ろーかるきょく	ローカル局
れんらくひょう	連絡票
れんらくつうろ	連絡通路
れんらくちょう	連絡帳
れんらくじこう	連絡事項
れんらくきょう	連絡橋
れんらくきっぷ	連絡切符
れんらくがかり	連絡係
れんらくかのう	連絡可能
れんらくかいぎ	連絡会議
れんらくいただ	連絡頂
れんらくいいん	連絡委員
れんぽうせいふ	連邦政府
れんぽうこっか	連邦国家
れんぽうかいぎ	連邦会議
れんぼうこうじ	連坊小路
れんぱんじょう	連判状
れんぱたっせい	連覇達成
れんぱいちゅう	連敗中
れんぱいきろく	連敗記録
れんばんじょう	連判状
れんどうかのう	連動可能
れんちゅうたち	連中達
れんたるりょう	レンタル料
れんたいちょう	連隊長
れんたいさいむ	連帯債務
れんたいきろく	連対記録
れんぞくりょう	連続量
れんぞくようし	連続用紙
れんぞくゆうぎ	連続遊技
れんぞくどうさ	連続動作
れんぞくがぞう	連続画像
れんぞくおうて	連続王手
れんそうりょく	連想力
れんそうじしょ	連想辞書
れんそうしゅぎ	連想主義
れんそうきおく	連想記憶
れんぜんあしげ	連銭葦毛
れんせんちゅう	連戦中
れんしょうしき	連勝式
れんしゅうよう	練習用
れんしゅうまえ	練習前
れんしゅうほう	練習法
れんしゅうだい	練習台
れんしゅうせん	練習船
れんしゅうせい	練習生
れんしゅうじょ	練習所
れんしゅうしゃ	練習車
れんしゅうかん	練習艦
れんしゅうかい	練習会
れんしゃりょく	連射力
れんさはんばい	連鎖販売
れんさはんのう	連鎖反応
れんさくしゅう	連作集
れんさいまんが	連載漫画
れんさいちゅう	連載中
れんさいさっか	連載作家
れんさいかいし	連載開始
れんごうこっか	連合国家
れんごうきこう	連合機構
れんげおんせん	蓮華温泉
れんけつぶぶん	連結部分
れんけつかのう	連結可能
れんけいぷれー	連携プレー
れんきんじゅつ	錬金術
れんきゅうまえ	連休前
れんきゅうあけ	連休明け	連休明
れんあいまんが	恋愛漫画
れんあいばなし	恋愛話
れんあいえいが	恋愛映画
れつかほうてき	劣加法的
れつかほうせい	劣加法性
れっせいいでん	劣性遺伝
れっしゃむせん	列車無線
れっしゃみつど	列車密度
れっしゃいどう	列車移動
れっしゃいがい	列車以外
れきだいせいふ	歴代政府
れきしもんだい	歴史問題
れきしはっけん	歴史発見
れきしはいけい	歴史背景
れきしにんしき	歴史認識
れきしどくほん	歴史読本
れきしてきかち	歴史的価値
れきしてきいみ	歴史的意味
れきしてきいち	歴史的位置
れきしじんぶつ	歴史人物
れいぼうちゅう	冷房中
れいぼうせつび	冷房設備
れいぼうきかん	冷房期間
れいぼうかりつ	冷房化率
れいぶんしゅう	例文集
れいはいちゅう	礼拝中
れいのうりょく	霊能力
れいとうほぞん	冷凍保存
れいちょうるい	霊長類
れいちょうけん	霊長研
れいだんぼうひ	冷暖房費
れいだいていど	例題程度
れいぞうこよう	冷蔵庫用
れいせんじだい	冷戦時代
れいしんりょく	励振力
れいげんどうし	霊幻道士
れいげんしゅう	霊言集
れいきゅうしゃ	霊柩車
れいきゃくよう	冷却用
れいきゃくほう	冷却法
れいきゃくふう	冷却風
れいきゃくすい	冷却水
れいきゃくざい	冷却材
れいきゃくえき	冷却液
れいきゃくいき	冷却域
れいきはちょう	励起波長
れいがいちゅう	例外中
れいがいじこう	例外事項
れいがいしょり	例外処理
れいがいきてい	例外規定
れいがいきそく	例外規則
れいがいきこう	例外機構
れいかんしょう	冷感症
れいかんさんと	冷汗三斗
れいおんていし	冷温停止
るすろくきのう	留守録機能
るすばんろくが	留守番録画
るすばんでんわ	留守番電話
るすばんそうち	留守番装置
るいせきぶんぷ	累積分布
るいせきさいむ	累積債務
るいすいかのう	類推可能
るいじょうこん	累乗根
るいしんかぜい	累進課税
るいぎごじてん	類義語辞典
りんりどうとく	倫理道徳
りんりしゃかい	倫理社会
りんねてんせい	輪廻転生
りんせんじばん	臨川寺版
りんせいじょう	輪生状
りんじれっしゃ	臨時列車
りんじょうかん	臨場感
りんじへんせい	臨時編成
りんじばんごう	臨時番号
りんじばんぐみ	臨時番組
りんじはつばい	臨時発売
りんじでんしゃ	臨時電車
りんじていしゃ	臨時停車
りんじぞうかん	臨時増刊
りんじそうかい	臨時総会
りんじこっかい	臨時国会
りんじかいそく	臨時快速
りんじかいいん	臨時会員
りんしょうれい	臨床例
りんしょうてき	臨床的
りんしょうけん	臨床研
りんしたいけん	臨死体験
りんざいしゅう	臨済宗
りんこうじゅん	輪講順
りんけいきょう	林経協
りんぎょうよう	林業用
りんきょうしん	臨教審
りんきおうへん	臨機応変
りんかいりょう	臨界量
りろんめいだい	理論命題
りろんてんかい	理論展開
りろんたいけい	理論体系
りろんせんせん	理論戦線
りろんすうがく	理論数学
りろんこうちく	理論構築
りろんこうせい	理論構成
りろんげんかい	理論限界
りろんけいさん	理論計算
りろんかいせき	理論解析
りりくちゅうし	離陸中止
りようようにん	利用容認
りようもくてき	利用目的
りようめいさい	利用明細
りようほうほう	利用方法
りようふかのう	利用不可能
りようとうろく	利用登録
りようとうけい	利用統計
りようぜんぱん	利用全般
りようせいげん	利用制限
りようじっせき	利用実績
りようしんせい	利用申請
りようしゅだん	利用手段
りようしゃめい	利用者名
りようしゃそう	利用者層
りようしゃすう	利用者数
りようしゃごと	利用者毎
りようしゃがわ	利用者側
りようこうりつ	利用効率
りようこうせい	利用厚生
りようけんげん	利用権限
りようけいたい	利用形態
りようけいけん	利用経験
りようけいかく	利用計画
りようぎじゅつ	利用技術
りようきんがく	利用金額
りようかくだい	利用拡大
りようあんない	利用案内
りょていひょう	旅程表
りょこうほけん	旅行保険
りょこうひよう	旅行費用
りょこうちゅう	旅行中
りょこうじゅつ	旅行術
りょこうざっし	旅行雑誌
りょこうぎょう	旅行業
りょこうきぶん	旅行気分
りょこうかばん	旅行鞄
りょこうかかく	旅行価格
りょこううかが	旅行伺
りょくのうきん	緑膿菌
りょくそうるい	緑藻類
りょくすいてい	緑水亭
りょくしきもう	緑色盲
りょくかききん	緑化基金
りょくえんとし	緑園都市
りょきゃくよう	旅客用
りょきゃくにん	旅客人
りょきゃくせん	旅客線
りょきゃくしゃ	旅客車
りょきゃくえき	旅客駅
りょうりどうぐ	料理道具
りょうりちょう	料理長
りょうりちゅう	料理中
りょうりざっし	料理雑誌
りょうりいぜん	料理以前
りょうようてき	療養的
りょうようじょ	療養所
りょうよういん	療養院
りょうゆうけん	領有権
りょうもうせん	両毛線
りょうむいいん	寮務委員
りょうみみかん	両耳間
りょうほんごく	両本国
りょうほうほう	両方法
りょうほうとも	両方共
りょうほうしき	両方式
りょうほうこう	両方向
りょうはんてん	量販店
りょうどほぜん	領土保全
りょうどうたい	良導体
りょうてんびん	両天秤
りょうてんさい	両天才
りょうだんたい	両団体
りょうだいがく	両大学
りょうたんてん	両端点
りょうたいすう	両対数
りょうたいおう	両対応
りょうぞくせい	両属性
りょうそくめん	両側面
りょうせんれつ	稜線列
りょうせんせい	両先生
りょうせんしゅ	両選手
りょうせいるい	両棲類	両生類
りょうせいばい	両成敗
りょうせいかつ	寮生活
りょうじんえい	両陣営
りょうじちょう	両耳聴
りょうじちかい	寮自治会
りょうじこうか	両耳効果
りょうじかんさ	両耳間差
りょうしんとも	両親共
りょうしんてき	良心的
りょうしんせい	両新製
りょうしゅほう	両手法
りょうしゅだい	両主題
りょうしゅけん	領主権
りょうしゃかん	両者間
りょうしぶつり	量子物理
りょうしでんし	量子電子
りょうしこうか	量子効果
りょうしきてき	良識的
りょうしきじん	良識人
りょうしかがく	量子化学
りょうざんぱく	梁山泊
りょうざぶろう	量三朗
りょうさんしゃ	量産車
りょうさんけい	量産形
りょうさんがた	量産型
りょうさくひん	両作品
りょうさいしい	聊斎志異
りょうごくばし	両国橋
りょうこくかん	両国間
りょうけいとう	両系統
りょうくうけん	領空権
りょうくうかん	両空間
りょうきんばこ	料金箱
りょうきんてき	料金的
りょうきんじょ	料金所
りょうきんしょ	料金所
りょうきんけん	料金券
りょうがんしさ	両眼視差
りょうがえじょ	両替所
りょうがいじん	両外人
りょうかんせい	猟官制
りょうかきごう	量化記号
りょうかいほう	領海法
りょうかいない	領海内
りょうかいせん	領海線
りょうかいせい	了解性
りょうかいずみ	了解済み
りょうおんせい	両音声
りょうおやゆび	両親指
りょうえきかん	両駅間
りょううんしゃ	両運車
りょういちろう	良一郎	良一朗
りょういきろん	領域論
りょういきない	領域内
りょういききぼ	領域規模
りょういきがい	領域外
りゆうせつめい	理由説明
りゅうようほう	流用法
りゅうようひん	流用品
りゅうびじゅつ	隆鼻術
りゅうねんせい	留年生
りゅうどうぶつ	流動物
りゅうどうてき	流動的
りゅうどうたい	流動体
りゅうどうせい	流動性
りゅうとうだび	竜頭蛇尾
りゅうつうまい	流通米
りゅうつうせい	流通性
りゅうちじょう	留置場
りゅうちしゅう	笠智衆
りゅうだんほう	榴弾砲
りゅうたいけん	流体科学研究所	流体研
りゅうそうざん	流早産
りゅうぜんこう	竜涎香
りゅうぜつらん	龍舌蘭
りゅうせんけい	流線形	流線型
りゅうせんかく	竜泉閣
りゅうせいじん	流星塵
りゅうせいぐん	流星群
りゅうしそくど	粒子速度
りゅうさんどう	硫酸銅
りゅうこくだい	龍谷大
りゅうこうせい	流行性
りゅうこうおく	流行遅
りゅうげんひご	流言蜚語	流言飛語
りゅうきゅうご	琉球語
りゅうきゅうこ	琉球弧
りゅうがくびざ	留学ビザ
りゅうがくせい	留学生
りゅうかくさん	龍角散
りゅうおうせん	竜王戦
りゅういちろう	竜一郎	隆一郎
りゅういじこう	留意事項
りゅういいそう	緑一色
りゅーいーそー	緑一色
りゃくれきしょ	略歴書
りゃくれいふく	略礼服
りゃくごしゅう	略語集
りねんそんざい	理念存在
りにゅうしょく	離乳食
りてきそくめん	理的側面
りつりょうせい	律令制
りつめいじじん	立命自陣
りっぽうこうし	立方格子
りっぽうきかん	立法機関
りっとうちょう	栗東町
りったいこうさ	立体交差
りったいきょう	立体鏡
りったいがぞう	立体画像
りっこうほしゃ	立候補者
りっけんせいじ	立憲政治
りっきょうだい	立教大
りっきょうせん	立教戦
りっきゃくてん	立脚点
りっきゃくしき	立脚式
りちゃくりくじ	離着陸時
りだつれいこん	離脱霊魂
りそなぎんこう	りそな銀行
りそくそうとう	利息相当
りそうしゃかい	理想社会
りしょくひょう	離職票
りしゅうちゅう	履修中
りしゅうかもく	履修科目
りさんすうがく	離散数学
りさんじしょう	離散事象
りこんけいけん	離婚経験
りこしゅぎしゃ	利己主義者
りこうがくよう	理工学用
りこうがくけん	理工学研
りけんこうぞう	利権構造
りけいにんげん	理系人間
りけいしんがく	理系進学
りけいがくせい	理系学生
りくはんきゅう	陸半球
りくぜんたかた	陸前高田
りくせんきそく	陸戦規則
りくぐんしょう	陸軍省
りくうんぎょう	陸運業
りくうんきょく	陸運局
りくうとうせん	陸羽東線
りくうさいせん	陸羽西線
りきりょうてき	力量的
りきゅうねずみ	利休鼠
りがくぶぶつり	理学部物理
りがくぶちょう	理学部長
りがくしゅうし	理学修士
りがいとくしつ	利害得失
りがいかんけい	利害関係
りかねんぴょう	理科年表
りかじょしだい	梨花女子大
りかがくじてん	理科学辞典
りかいふかのう	理解不可能
りえきゆうどう	利益誘導
りえきゆうせん	利益優先
りえきぶんぱい	利益分配
りえきふりえき	利益不利益
りえきはいぶん	利益配分
りえきはいとう	利益配当
りえきかんげん	利益還元
りえきかんかく	利益感覚
らんりゅうろん	乱流論
らんにゅうしゃ	乱入者
らんとうちゅう	乱闘中
らんとうじけん	乱闘事件
らんちきさわぎ	乱痴気騒ぎ
らんすうひょう	乱数表
らんしんぞくし	乱臣賊子
らっかろうぜき	落花狼藉
らっかぶったい	落下物体
らっかかんせい	落下慣性
らっかうんどう	落下運動
らせんかいだん	螺旋階段
らじおほうそう	ラジオ放送
らじおばんぐみ	ラジオ番組
らじおたいそう	ラジオ体操
らししょくぶつ	裸子植物
らざほーじうむ	Rf	Rutherfordium
らくのうぎょう	酪農業
らくだいせいど	落第制度
らくせいけんさ	落成検査
らくさつかかく	落札価格
らくごばんぐみ	落語番組
らくがきちょう	らく書き帳	落書帳
らがんしりょく	裸眼視力
らいむぎばたけ	ライ麦畑
らいふるじゅう	ライフル銃
らいねんどまつ	来年度末
らいねんいこう	来年以降
らいにちちゅう	来日中
らいにちこくち	来日告知
らいちょうさわ	雷鳥沢
らいじょうしゃ	来場者
らいしゅうまつ	来週末
らいしゅうぶん	来週分
らいげつちゅう	来月中
らいきゃくよう	来客用
ろんりてきりかい	論理的理解
ろんりてきそしき	論理的組織
ろんりてきしょり	論理的処理
ろんりてきしこう	論理的思考
ろんりてきこうり	論理的公理
ろんりてききのう	論理的機能
ろんりてききごう	論理的記号
ろんりてききけつ	論理的帰結
ろんりてきかてい	論理的過程
ろんりそうちめい	論理装置名
ろんりしきちゅう	論理式中
ろんりけつごうし	論理結合子
ろんりがたげんご	論理型言語
ろんりえんざんし	論理演算子
ろんぶんぼしゅう	論文募集
ろんぶんひっしゃ	論文筆者
ろんぶんとうこう	論文投稿
ろんぶんだいめい	論文題名
ろんぶんしゅたい	論文主体
ろんぶんしっぴつ	論文執筆
ろんぶんさくせい	論文作成
ろんぶんこうえん	論文講演
ろんぶんげんこう	論文原稿
ろんぶんけいしき	論文形式
ろんしょうしえん	論証支援
ろんしょうかのう	論証可能
ろめんじょうたい	路面状態
ろっぽうぜんしょ	六法全書
ろっこうさんけい	六甲山系
ろせんめいしょう	路線名称
ろじょうはんばい	路上販売
ろじょうかんさつ	路上観察
ろしゅつれんどう	露出連動
ろしゅつばいすう	露出倍数
ろしゅつせってい	露出設定
ろしゅつかんけい	露出関係
ろこうびょうすう	露光秒数
ろくはらたんだい	六波羅探題
ろくしんがったい	六神合体
ろくさいどくりつ	録再独立
ろくがちゅうけい	録画中継
ろくがたいしょう	録画対象
ろくがじょうほう	録画情報
ろくおんないよう	録音内容
ろくおんさいせい	録音再生
ろくおんぎじゅつ	録音技術
ろくいのくろうど	六位の蔵人
ろくいちぎんこう	六一銀行
ろかたちゅうしゃ	路肩駐車
ろうにんせいかつ	浪人生活
ろうどうだいじん	労働大臣
ろうどうしじょう	労働市場
ろうどうさんぽう	労働三法
ろうどうさんけん	労働三権
ろうどうさいがい	労働災害
ろうどうけいやく	労働契約
ろうどうくみあい	労働組合
ろうどうきょうか	労働強化
ろうどううんどう	労働運動
ろうじんせんよう	老人専用
ろうじんいりょう	老人医療
ろうこうたいさく	漏光対策
ろうかげんしょう	老化現象
ろーまきょうこう	ローマ教皇
れんりつせいけん	連立政権
れんらくほうほう	連絡方法
れんらくぶんしょ	連絡文書
れんらくてつどう	連絡鉄道
れんらくしゅだん	連絡手段
れんらくしゃめい	連絡者名
れんぽうけいさつ	連邦警察
れんたいほしょう	連帯保証
れんたいせきにん	連帯責任
れんたいじっせき	連対実績
れんぞくばんぐみ	連続番組
れんぞくはっこう	連続発行
れんぞくとくてん	連続得点
れんぞくていしゃ	連続停車
れんぞくそうしん	連続送信
れんぞくしゅうり	連続修理
れんぞくしゃぞう	連続写像
れんぞくしゃしん	連続写真
れんぞくしゃげき	連続射撃
れんぞくさんしん	連続三振
れんぞくさつじん	連続殺人
れんぞくさつえい	連続撮影
れんぞくさいせい	連続再生
れんぞくこうげき	連続攻撃
れんぞくけいさい	連続掲載
れんぞくくうかん	連続空間
れんぞくかんぷう	連続完封
れんぞくかんすう	連続函数	連続関数
れんぞくかいほう	連続解放
れんぞくかいてん	連続回転
れんぞくかいさい	連続開催
れんぞくおんせい	連続音声
れんぞくうんてん	連続運転
れんそうはいれつ	連想配列
れんせんれんぱい	連戦連敗
れんじつほうそう	連日放送
れんしょうちゅう	連勝中
れんしょうきろく	連勝記録
れんしょうきねん	連勝記念
れんしゅうりょう	練習量
れんしゅうようぐ	練習用具
れんしゅうぶそく	練習不足
れんしゅうばしょ	練習場所
れんしゅうなかま	練習仲間
れんしゅうちょう	練習帳
れんしゅうちゅう	練習中
れんしゅうじょう	練習場
れんしゅうじかん	練習時間
れんしゅうじあい	練習試合
れんしゅうしだい	練習次第
れんしゅうきょく	練習曲
れんしゅうきかん	練習期間
れんしゅうかだい	練習課題
れんしゅうあいて	練習相手
れんしゃたいおう	連写対応
れんさくたんぺん	連作短編	連作短篇
れんさくかきょく	連作歌曲
れんさいとちゅう	連載途中
れんさいとうしょ	連載当初
れんさいちゅうし	連載中止
れんさいだんねん	連載断念
れんさいさくひん	連載作品
れんさいさいかい	連載再開
れんさいけいしき	連載形式
れんさいきゅうし	連載休止
れんさいかいすう	連載回数
れんさいかいしじ	連載開始時
れんごうさくひん	連合作品
れんごうこくがわ	連合国側
れんごうかんたい	聯合艦隊	連合艦隊
れんごうおうこく	連合王国
れんげおうじょう	蓮華往生
れんけつせいぶん	連結成分
れんけつさぎょう	連結作業
れんけつけっさん	連結決算
れんけいこうげき	連係攻撃
れんきんじゅつし	錬金術師
れんきゅうちゅう	連休中
れんきゅうきかん	連休期間
れんおんほうそく	連音法則
れんあいけっこん	恋愛結婚
れんあいかんけい	恋愛関係
れつけっていけい	劣決定系
れっせいいでんし	劣性遺伝子
れっしゃほんすう	列車本数
れっしゃへんせい	列車編成
れっしゃばんごう	列車番号
れっしゃどうよう	列車同様
れっしゃせっきん	列車接近
れっしゃしゅべつ	列車種別
れっしゃしゅたい	列車主体
れっしゃしゃしん	列車写真
れっしゃかんかく	列車間隔
れっしゃうんこう	列車運行
れきだいよこづな	歴代横綱
れきしてきりゆう	歴史的理由
れきしてきめいば	歴史的名馬
れきしてきつづり	歴史的綴	歴史的綴り
れきしてきちしき	歴史的知識
れきしてきじじつ	歴史的事実
れきしてきじけん	歴史的事件
れきしてきけんち	歴史的見地
れきしてきけいい	歴史的経緯
れきしてきかてい	歴史的過程
れきししょうせつ	歴史小説
れいぼうそうさき	冷房操作器
れいぼうじゅよう	冷房需要
れいぼうかいぞう	冷房改造
れいねんいじょう	例年以上
れいとねりあもく	レイトネリア目	Leitneriales
れいとうぎょうざ	冷凍餃子
れいぜいてんのう	冷泉天皇
れいしきゆそうき	零式輸送機
れいさいけいえい	零細経営
れいさいきぎょう	零細企業
れいげんてんのう	霊元天皇
れいけつどうぶつ	冷血動物
れいきゃくぶぶん	冷却部分
れいきゃくこうか	冷却効果
れいきゃくきかん	冷却期間
れいきゃくおんど	冷却温度
れいきじょうたい	励起状態
れいがいきじゅつ	例外記述
れいかんあつえん	冷間圧延
るすばんでんわき	留守番電話器	留守番電話機
るいせききよりつ	累積寄与率
るいすいしゅほう	類推手法
るいしんぜいりつ	累進税率
るいけいろんてき	類型論的
りんねてんしょう	輪廻転生
りんせつかんけい	隣接関係
りんじとっきゅう	臨時特急
りんじきゅうこう	臨時急行	臨時休講
りんしょうちけん	臨床治験
りんしょうしんり	臨床心理
りんしょうしけん	臨床試験
りんしょうけんさ	臨床検査
りんしょういがく	臨床医学
りんかんがっこう	林間学校
りんかいたいいき	臨界帯域
りんかいがっこう	臨海学校
りんかいあんぜん	臨界安全
りろんぶつりがく	理論物理学
りろんてきはしら	理論的柱
りろんてきぎろん	理論的議論
りろんきょくせん	理論曲線
りようりょうきん	利用料金
りようふたんきん	利用負担金
りようじょうほう	利用情報
りようじょうけん	利用条件
りようしゃじしょ	利用者辞書
りようしゃかんり	利用者管理
りようしゃかくい	利用者各位
りようしゃいがい	利用者以外
りようげんどがく	利用限度額
りようかんきょう	利用環境
りようかのうせい	利用可能性
りょこうもくてき	旅行目的
りょこうにってい	旅行日程
りょこうちょきん	旅行貯金
りょこうちゅうし	旅行中止
りょこうしゃあん	旅行社案
りょこうさくせん	旅行作戦
りょこうけいかく	旅行計画
りょこうがいしゃ	旅行会社
りょこうかんけい	旅行関係
りょこううかがい	旅行伺
りょけんばんごう	旅券番号
りょけんじむしょ	旅券事務所
りょくないしょう	緑内障
りょくちゅうせき	緑柱石
りょくおうやさい	緑黄野菜
りょくおうしょく	緑黄色
りょきゃくゆそう	旅客輸送
りょきゃくかんり	旅客管理
りょうりょういき	両領域
りょうりめいじん	料理名人
りょうりほうほう	料理方法
りょうりばんぐみ	料理番組
りょうりてじゅん	料理手順
りょうりじょうず	料理上手
りょうりがっこう	料理学校
りょうようちゅう	療養中
りょうめんきばん	両面基板
りょうほうどうじ	両方同時
りょうほうそうび	両方装備
りょうぶしんとう	両部神道
りょうびげっぽう	綾美月報
りょうばんこきょ	竜蟠虎踞
りょうばばしこう	良馬場志向
りょうはんきゅう	両半球
りょうどもんだい	領土問題
りょうどかくだい	領土拡大
りょうとうづかい	両刀遣い
りょうでんしゃく	両電車区
りょうせんじょう	稜線上
りょうせいしょく	寮生食
りょうせいぐゆう	両性具有
りょうじゆうごう	両耳融合
りょうじつさんか	両日参加
りょうじそうよう	両耳装用
りょうじおんあつ	両耳音圧
りょうしりきがく	量子力学
りょうしょくどう	寮食堂
りょうしょうくだ	了承下
りょうしゅうずみ	領収済
りょうしゅうしょ	領収書
りょうしゅうがく	領収額
りょうしゅういん	領収印
りょうしとうけい	量子統計
りょうしざつおん	量子雑音
りょうしこうりつ	量子効率
りょうしこうぞう	量子構造
りょうしこうがく	量子工学	量子光学
りょうしかせいど	量子化精度
りょうしうちゅう	量子宇宙
りょうさんちゅう	量産中
りょうさんこうか	量産効果
りょうさいけんぼ	良妻賢母
りょうきんふよう	料金不要
りょうきんふたん	料金負担
りょうきんひょう	料金表
りょうきんねさげ	料金値下	料金値下げ
りょうきんかくさ	料金格差
りょうきょくたん	両極端
りょうがんしほう	両眼視法
りょうがえしょう	両替商
りょうかいじこう	了解事項
りょういきりろん	領域理論
りょういきしてい	領域指定
りょういきかくほ	領域確保
りゅうるいしょう	流涙症
りゅうばんこきょ	竜蟠虎踞
りゅうどうふさい	流動負債
りゅうどうひりつ	流動比率
りゅうどうしょく	流動食
りゅうどうしさん	流動資産
りゅうつうりょう	流通量
りゅうつうじょう	流通上
りゅうつうけいろ	流通経路
りゅうつうけいひ	流通経費
りゅうつうぎょう	流通業
りゅうつうきこう	流通機構
りゅうつうかてい	流通過程
りゅうつうかかく	流通価格
りゅうたいぶつり	流体物理
りゅうじょうせい	粒状性
りゅうじょうこし	竜驤虎視
りゅうしゅつすい	流出水
りゅうしけいそく	粒子計測
りゅうこうびょう	流行病
りゅうこうしょく	流行色
りゅうぐうじょう	竜宮城	龍宮城
りゅうきゅうだい	琉球大
りゅうきゅうじん	琉球人
りゅうがくちゅう	留学中
りゅうがくせいか	留学生課
りゅうあんかめい	柳暗花明
りゃんはんしばり	二翻縛
りゃくねんぴょう	略年表
りひきょくちょく	理非曲直
りつめいかんだい	立命館大
りっちじょうけん	立地条件
りったいしゃしん	立体写真
りったいしちゅう	立体視中
りったいしたんし	立体視端子
りったいしがぞう	立体視画像
りったいこうぞう	立体構造
りったいえいぞう	立体映像
りったいうちゅう	立体宇宙
りっそくだんかい	律速段階
りっしんしゅっせ	立身出世
りっしょうちゅう	立証中
りっけんくんしゅ	立憲君主
りちゅうてんのう	履中天皇
りそうじょうたい	理想状態
りそうしゅぎてき	理想主義的
りそうしゅぎしゃ	理想主義者
りそうきゅうめん	理想球面
りじゅんもくてき	利潤目的
りしそうとうがく	利子相当額
りさいしょうめい	り災証明
りごうしゅうさん	離合集散
りこてきいでんし	利己的遺伝子
りげんしゅうらん	俚言集覧
りくぜんさんのう	陸前山王
りくじょうぶたい	陸上部隊
りくじょうたはつ	陸上多発
りくぐんだいじん	陸軍大臣
りくぐんぐんいぶ	陸軍軍医部
りくくういったい	陸空一体
りくかいくうぐん	陸海空軍
りくうんじむしょ	陸運事務所
りくうんしきょく	陸運支局
りきがくかんけい	力学関係
りきがくえねるぎ	力学エネルギ
りがくりょうほう	理学療法
りがくぶけいとう	理学部系統
りがくぶかがっか	理学部化学科
りかけいにんげん	理科系人間
りかいのうりょく	理解能力
りかいじょうたい	理解状態
りえきついきゅう	利益追求
りえきしゃふたん	利益者負担
らんぼうろうぜき	乱暴狼藉
らんぴつらんぶん	乱筆乱文
らんすうはっせい	乱数発生
らんすうせいせい	乱数生成
らんすうけいれつ	乱数系列
らっかりゅうすい	落花流水
らくようじゅりん	落葉樹林
らくほくこうこう	洛北高校
らくせんうんどう	落選運動
らがんりったいし	裸眼立体視
らいぶちゅうけい	ライブ中継
らいねんどちゅう	来年度中
らいねんじょばん	来年序盤
らいねんかいさい	来年開催
らいねんいっぱい	来年一杯
らいにちちゅうし	来日中止
らいにちこうえん	来日公演
らいにちけってい	来日決定
らいせんすりょう	ライセンス料
らいしゅうよこく	来週予告
らいしゅうちゅう	来週中
らいしゅうかよう	来週火曜
らいしゅうあたま	来週頭
らいげつぼうじつ	来月某日
らいげつさいしょ	来月最初
らいきゃくちゅう	来客中
らーめんこうぞう	ラーメン構造
ろんりてきむじゅん	論理的矛盾
ろんりてきはんだん	論理的判断
ろんりてきこんきょ	論理的根拠
ろんりてきけってん	論理的欠点
ろんりせいじゅうし	論理性重視
ろんぶんはっぴょう	論文発表
ろんぶんていしゅつ	論文提出
ろんぶんせんしゅう	論文選集
ろんぶんしょうかい	論文紹介
ろんしょうもんだい	論証問題
ろんこうこうしょう	論功行賞
ろめんひょうじよう	路面表示用
ろめんでんしゃよう	路面電車用
ろめんじょうきょう	路面状況
ろっぽんぎほうめん	六本木方面
ろっぽんぎこうえん	六本木公演
ろっこうさんじょう	六甲山上
ろそくたいそうこう	路側帯走行
ろせんしようりょう	路線使用料
ろじょうれんしゅう	路上練習
ろじょうちゅうしゃ	路上駐車
ろしゅつきょようど	露出許容度
ろこうきょうじけん	盧溝橋事件
ろくりょうへんせい	六両編成
ろくじょうてんのう	六条天皇
ろくがかいしじこく	録画開始時刻
ろくおんじょうたい	録音状態
ろうにんせいじだい	浪人生時代
ろうにゃくなんにょ	老若男女
ろうどうほうしょう	労働報償
ろうどうじょうけん	労働条件
ろうどうきょうやく	労働協約
ろうどうきほんけん	労働基本権
ろうどうかんきょう	労働環境
ろうどういいんかい	労働委員会
ろうじんほけんほう	老人保健法
ろうじんふくしほう	老人福祉法
ろうじんいりょうひ	老人医療費
ろうじゃくだんじょ	老若男女
ろうしょうふじょう	老少不定
れんらくようむせん	連絡用無線
れんらくさきめいき	連絡先明記
れんらくきゅうこう	連絡急行
れんばんしていせき	連番指定席
れんばんさんしょう	連番参照
れんぞくりょういき	連続領域
れんぞくゆうしょう	連続優勝
れんぞくたいかせつ	連続体仮説
れんぞくじゅうでん	連続充電
れんぞくじっすうち	連続実数値
れんそうしゅぎしゃ	連想主義者
れんそうがくしゅう	連想学習
れんせんれんしょう	連戦連勝
れんしょうふくしき	連勝複式
れんしょうたんしき	連勝単式
れんしゅうもんだい	練習問題
れんしゅうほうほう	練習方法
れんしゅうふうけい	練習風景
れんしゅうばんごう	練習番号
れんしゅうたいせい	練習体制
れんしゅうそうこう	練習走行
れんしゅうしゃめん	練習斜面
れんしゅうこうかい	練習航海
れんしゅうかいすう	練習回数
れんざせいきょうか	連座制強化
れんさいちゅうだん	連載中断
れんさいけいさいじ	連載掲載時
れんさいかいしまえ	連載開始前
れんきゅうこうはん	連休後半
れんかばんおんげん	廉価版音源
れんあいたいしょう	恋愛対象
れんあいじょうたい	恋愛状態
れんあいしょうせつ	恋愛小説
れんあいげきじょう	恋愛劇場
れんあいかんじょう	恋愛感情
れとるとしょくひん	レトルト食品
れっとうてんびょう	列島点描
れっとうじゅうだん	列島縦断
れっせいぎゃくてん	劣勢逆転
れっしゃりょうきん	列車料金
れっしゃしょくどう	列車食堂
れっしゃあいしょう	列車愛称
れきしてきへんせん	歴史的変遷
れきしてきぶんけん	歴史的文献
れきしてきはってん	歴史的発展
れきしてきはいけい	歴史的背景
れきしてきできごと	歴史的出来事
れきしてきせいやく	歴史的制約
れきしてきじじょう	歴史的事情
れきしてきこんきょ	歴史的根拠
れきしてきこうさつ	歴史的考察
れきしてきげんかい	歴史的限界
れきしきょうかしょ	歴史教科書
れいぼうのうりょく	冷房能力
れいふうのうりょく	冷風能力
れいのうりょくしゃ	霊能力者
れいとうれいぞうこ	冷凍冷蔵庫
れいとうしょくひん	冷凍食品
れいとうかいじゅう	冷凍怪獣
れいぞうのうりょく	冷蔵能力
れいせんしゅうけつ	冷戦終結
れいせいちんちゃく	冷静沈着
れいしきせんとうき	零式戦闘機
れいきょりしゃげき	零距離射撃
れいきゃくほうほう	冷却方法
れいきゃくたいさく	冷却対策
れいきゃくせいのう	冷却性能
れいきゃくしゅだん	冷却手段
れいきゃくぎじゅつ	冷却技術
れいかんしょうほう	霊感商法
るそんすけざえもん	呂宋助左衛門
るいせきとうひょう	累積投票
るいせきせんりょう	累積線量
るいせききのうほう	累積帰納法
るいすいかいしゃく	類推解釈
りんりどうとくかん	倫理道徳観
りんりてきもんだい	倫理的問題
りんどうしゅうてん	林道終点
りんせつぎょうれつ	隣接行列
りんじぞうかんごう	臨時増刊号
りんじきゅうぎょう	臨時休業
りんじかいさつぐち	臨時改札口
りんしょうじっけん	臨床実験
りんしょうしんりし	臨床心理士
りんしゃんかいほう	嶺上開花
りんしゃんかいほー	嶺上開花
りんさんかごうぶつ	リン酸化合物
りんかいふくとしん	臨海副都心
りんかいじょうたい	臨界状態
りんかいげんしょう	臨界現象
りろんてきぶんるい	理論的分類
りろんてきてんぼう	理論的展望
りろんてきそくめん	理論的側面
りろんてきせいしつ	理論的性質
りろんてきすうがく	理論的数学
りろんてきこんきょ	理論的根拠
りろんてきげんかい	理論的限界
りろんせいぶつがく	理論生物学
りろんじょうかのう	理論上可能
りろんけいざいがく	理論経済学
りようじょうきょう	利用状況
りようしんせいしょ	利用申請書
りようしゅうはすう	利用周波数
りようしゃばんごう	利用者番号
りようしゃとくてん	利用者特典
りようしゃとうろく	利用者登録
りようしゃぜんたい	利用者全体
りようしゃじゅえき	利用者受益
りようしゃげんてい	利用者限定
りようけいやくしゃ	利用契約者
りょひしゅくはくひ	旅費宿泊費
りょこうだいりてん	旅行代理店
りょこうじょうほう	旅行情報
りょこうしゃかかく	旅行者価格
りょこうぎょうほう	旅行業法
りょこうぎょうしゃ	旅行業者
りょこうかんりょう	旅行完了
りょこうかんきょう	旅行環境
りょくせいしきもう	緑青色盲
りょきゃくれっしゃ	旅客列車
りょきゃくひこうき	旅客飛行機
りょきゃくせんがわ	旅客線側
りょきゃくうんちん	旅客運賃
りょきゃくあんない	旅客案内
りょきゃくあつかい	旅客扱い
りょうりごうかばん	料理豪華版
りょうりきょうしつ	料理教室
りょうようせいかつ	療養生活
りょうもうせんない	両毛線内
りょうめんさいせい	両面再生
りょうめんいんさつ	両面印刷
りょうほうたいおう	両方対応
りょうほうさいよう	両方採用
りょうほうかくにん	両方確認
りょうほういっしょ	両方一緒
りょうとうろんぽう	両刀論法
りょうてりょうあし	両手両足
りょうてきもんだい	量的問題
りょうせいたいかい	寮生大会
りょうしりきがくや	量子力学屋
りょうしゅうしょう	領収証
りょうしゃはんそく	両者反則
りょうしぶつりがく	量子物理学
りょうしかがくてき	量子化学的
りょうさんおんがく	量産音楽
りょうごくよびこう	両国予備校
りょうごくほうめん	両国方面
りょうごくたいかい	両国大会
りょうごくけっせん	両国決戦
りょうぐんせんしゅ	両軍選手
りょうくうしんぱん	領空侵犯
りょうきんたいけい	料金体系
りょうきんせってい	料金設定
りょうきんけいさん	料金計算
りょうきんかいてい	料金改定
りょうきんあんない	料金案内
りょうきょくしゅう	両曲集
りょうがわぶんかい	両側分解
りょうかいどしけん	了解度試験
りょうかいしんぱん	領海侵犯
りょううんてんだい	両運転台
りょういきぶんかつ	領域分割
りょういきせきぶん	領域積分
りょういきかいほう	領域解放
りょうあしかじゅう	両足荷重
りゅうれんこうぼう	流連荒亡
りゅうりょくかこう	柳緑花紅
りゅうりゅうしんく	粒々辛苦	粒粒辛苦
りゅうとうげきしゅ	竜頭鷁首
りゅうつうだんかい	流通段階
りゅうつうじじょう	流通事情
りゅうつうしゅっか	流通出荷
りゅうつうしゅだん	流通手段
りゅうつうしじょう	流通市場
りゅうたいりきがく	流体力学
りゅうたいじくうけ	流体軸受け
りゅうたいかいせき	流体解析
りゅうせんかんすう	流線関数
りゅうせいかんそく	流星観測
りゅうじょうこはく	竜攘虎搏
りゅうこくだいがく	龍谷大学
りゅうこうおんがく	流行音楽
りゅうがくせいたち	留学生達
りゅうがくせいかつ	留学生活
りゅうかかごうぶつ	硫化化合物
りゃくしょうひょう	略称表
りゃくしきてつづき	略式手続
りゃくしきさいばん	略式裁判
りねんてきそんざい	理念的存在
りったいけいじょう	立体形状
りっしょうせきにん	立証責任
りっこうほしゃすう	立候補者数
りっきょうだいがく	立教大学
りそくせいげんほう	利息制限法
りじゅんついきゅう	利潤追求
りしょくしょうほう	利殖商法
りこうがくせんこう	理工学専攻
りくとうさんりゃく	六韜三略
りくちゅうおおはし	陸中大橋
りくじょうたんぱつ	陸上単発
りくじょうこうつう	陸上交通
りくじょうきょうぎ	陸上競技
りくじょうかんけい	陸上関係
りくかいりょうぐん	陸海両軍
りくうんじむきょく	陸運事務局
りきどうざんじだい	力道山時代
りきがくけいりろん	力学系理論
りがくぶすうがっか	理学部数学科
りがくぶかがくけい	理学部化学系
りがくけんきゅうか	理学研究科
りがいかんけいしゃ	利害関係者
りかいりょくぶそく	理解力不足
りえきじゅんびきん	利益準備金
りあすしきかいがん	リアス式海岸
らんりつじょうたい	乱立状態
らんにゅうたいせん	乱入対戦
らんすうはっせいき	乱数発生器
らっかんしゅぎしゃ	楽観主義者
らくなんしんとしん	洛南新都心
らいぶらりかんすう	ライブラリ関数
らいねんそつぎょう	来年卒業
らいでんためえもん	雷電為衛門
らいしゅんかいまく	来春開幕
らいしゅうほうえい	来週放映
らいしゅうげつよう	来週月曜
らいきゃくかいかん	来客会館
ろんりてんかいりょく	論理展開力
ろんりてきたんきゅう	論理的探求
ろんりてきしょうめい	論理的証明
ろんりこうぞうじょう	論理構造上
ろんぶんしりょうだい	論文資料代
ろっぽんぎしんじゅう	六本木心中
ろっこんしょうじょう	六根清浄
ろっかんしんけいつう	肋間神経痛
ろじょうきょうしゅう	路上教習
ろじょうかんさつがく	路上観察学
ろしゅつけいないぞう	露出計内蔵
ろくじゅうさんじょう	六三条
ろくごうざきとうだい	禄剛崎灯台
ろくがよやくほうしき	録画予約方式
ろくおんぎじゅつしゃ	録音技術者
ろくおんかのうじかん	録音可能時間
ろうどうぶんぱいりつ	労働分配率
ろうどうしゅうにゅう	労働収入
ろうどうくみあいほう	労働組合法
ろうどうきじゅんほう	労働基準法
れんりつほうていしき	連立方程式
れんらくたんとうしゃ	連絡担当者
れんらくしゅうはすう	連絡周波数
れんぽうそうさきょく	連邦捜査局
れんぽうせいふきょく	連邦政府局
れんぽうさいばんしょ	連邦裁判所
れんぽうきょうわこく	連邦共和国
れんぶんせつへんかん	連文節変換
れんぶんすうぶんかい	連分数分解
れんたいほしょうにん	連帯保証人
れんぞくろくがじかん	連続録画時間
れんぞくとうろんかい	連続討論会
れんぞくさつじんはん	連続殺人犯
れんそうきおくじゅつ	連想記憶術
れんさいしゅうりょう	連載終了
れきしてきじょうけん	歴史的条件
れきしてきしゅんかん	歴史的瞬間
れいきゃくのうりょく	冷却能力
れいきゃくすいぶそく	冷却水不足
れいがいしょりきのう	例外処理機能
るいえふしょうまぞく	Actaea	ルイエフショウマ属
るーぶるびじゅつかん	ルーブル美術館
りんりじょうもんだい	倫理上問題
りんせつちょさくけん	隣接著作権
りんしょうせいりがく	臨床生理学
りんしょうしんりがく	臨床心理学
りんしょういがくけい	臨床医学系
りんかいたいいきはば	臨界帯域幅
りろんてきしょうめい	理論的証明
りろんてきかのうせい	理論的可能性
りろんてきかいしゃく	理論的解釈
りようゆうしかくしゃ	利用有資格者
りようけんきゅうかい	利用研究会
りょこうあんないじょ	旅行案内所
りょこうあんないしょ	旅行案内書	旅行案内所
りょくじゅほうしょう	緑綬褒章
りょきゃくりゅうどう	旅客流動
りょきゃくえいぎょう	旅客営業
りょうりけんきゅうか	料理研究家
りょうせいびょうどう	両性平等
りょうせいせいしょく	両性生殖
りょうせいしゅうかい	寮生集会
りょうじかんそうかん	両耳間相関
りょうしりきがくてき	量子力学的
りょうしゃきょうつう	両者共通
りょうしでんじきがく	量子電磁気学
りょうごくこくぎかん	両国国技館
りょうきんせいきゅう	料金請求
りょうきんじょへいさ	料金所閉鎖
りょうがんりったいし	両眼立体視
りょういきしていよう	領域指定用
りゅうどうせいよきん	流動性預金
りゅうつうぎょうしゃ	流通業者
りゅうせんけいぶぶん	流線形部分
りゅうこくだいりこう	龍谷大理工
りゅうこうじょうほう	流行情報
りゅうきゅうほうそう	琉球放送
りゅうきゅうほうげん	琉球方言
りゅうきゅうだいがく	琉球大学
りゅうきゅうぎんこう	琉球銀行
りゅうきゅうおんかい	琉球音階
りゃくしょうしょぞく	略称所属
りはびりてーしょんか	リハビリテーション科
りはっちゃくほんすう	離発着本数
りはっちゃくかいすう	離発着回数
りつめいかんだいがく	立命館大学
りっぽうたいばいせき	立方体倍積
りったいしちゅうどく	立体視中毒
りっけんくんしゅせい	立憲君主制
りっけんくんしゅこく	立憲君主国
りそうてきじょうたい	理想的状態
りそうてきかんきょう	理想的環境
りそうぎゃくふぃるた	理想逆フィルタ
りこうがくせんこうか	理工学専攻科
りくじょうじえいたい	陸上自衛隊
りくぐんちゅうおうぶ	陸軍中央部
りくうんさんじょかい	陸運賛助会
りきどうざんいっこう	力道山一行
りきがくてきせつめい	力学的説明
りきがくせんもんしょ	力学専門書
りがくぶぶつりがっか	理学部物理学科
らんすうせいせいけい	乱数生成系
らししょくぶつあもん	裸子植物亜門	Gymnospermae
らくようこうようじゅ	落葉広葉樹
らくほくこうこうまえ	洛北高校前
ろんりてきせいごうせい	論理的整合性
ろんりてきしこうりょく	論理的思考力
ろんぶんはっぴょうしゃ	論文発表者
ろうどうしゃかいきゅう	労働者階級
ろうどうきじゅんきょく	労働基準局
ろうえきじょうりゅうち	労役場留置
ろーまきょうこうちょう	ローマ教皇庁
れんらくさきじゅうしょ	連絡先住所
れんらくさきしょざいち	連絡先所在地
れんぽうぐんしょうこう	連邦軍将校
れんぞくりったいこうさ	連続立体交差
れんぞくたいりょくがく	連続体力学
れんぞくじょうしゃけん	連続乗車券
れんぞくさつじんじけん	連続殺人事件
れんぞくさつえいじかん	連続撮影時間
れんぞくさいせいじかん	連続再生時間
れんさはんばいとりひき	連鎖販売取引
れんさくたんぺんしゅう	連作短編集
れんさいしゅうりょうご	連載終了後
れんけつのうぜいせいど	連結納税制度
れっしゃへんせいひょう	列車編成表
れっしゃばんごうじゅん	列車番号順
れっしゃしょくどうしゃ	列車食堂車
れいだんぼうちょうせつ	冷暖房調節
れいきゃくけいぜんたい	冷却系全体
るいせききつえんりょう	累積喫煙量
りんりてきしゅうきょう	倫理的宗教
りんじょうかんつうしん	臨場感通信
りんじかいそくれっしゃ	臨時快速列車
りんしょうしょうじょう	臨床症状
りんかくとくちょうてん	輪郭特徴点
りんかいたいいきしょり	臨界帯域処理
りんかいきょうぎじょう	臨海競技場
りろんてきせいごうせい	理論的整合性
りろんけいさんきかがく	理論計算機科学
りようしゃれんらくかい	利用者連絡会
りょこうけんきゅうかい	旅行研究会
りょくおうしょくやさい	緑黄色野菜
りょきゃくれっしゃよう	旅客列車用
りょうゆうならびたたず	両雄並び立たず
りょうせんぱつとうしゅ	両先発投手
りょうしつきつえんしゃ	良質喫煙者
りょうしかがくけいさん	量子化学計算
りょうきんちょうしゅう	料金徴収
りょうきんちゃくばらい	料金着払
りょうきんかいしゅうき	料金回収機
りょうがえてすうりょう	両替手数料
りょういんきょうぎかい	両院協議会
りょういきほうていしき	領域方程式
りょういきぶんかつほう	領域分割法
りゅうりょうちょうせつ	流量調節
りゅうつうせいじょうか	流通正常化
りゅうつうじょうきょう	流通状況
りゅうたいせいぎょがく	流体制御学
りゅうせんけいじょうき	流線形蒸機
りゅうこくだいがくせん	龍谷大学線
りゅうこくだいがくせた	龍谷大学瀬田
りゅうこうせいかんぼう	流行性感冒
りゅうこうかようきょく	流行歌謡曲
りゅうきゅうおうちょう	琉球王朝
りゅうがくせいもんだい	留学生問題
りゅうがくせいぜんいん	留学生全員
りゃくしゅゆうかいざい	略取誘拐罪
りにゅうしょくさくせい	離乳食作成
りったいきじゅつげんご	立体記述言語
りっしょうこうせいかい	立正佼成会
りっしょうあんこくろん	立正安国論
りそうてきだんせいぞう	理想的男性像
りそうてきじょせいぞう	理想的女性像
りせいてきそんざいしゃ	理性的存在者
りこうがくしょせんもん	理工学書専門
りこうがくけんきゅうか	理工学研究科
りくじょうゆそういがい	陸上輸送以外
りくじょうこうつうもう	陸上交通網
りきがくてきせかいかん	力学的世界観
りきがくけんきゅうしつ	力学研究室
りがくけいけんきゅうか	理学系研究科
りかけいしゅっしんしゃ	理科系出身者
りかがくけんきゅうじょ	理化学研究所
りかがくけんきゅうしょ	理化学研究所
りえきかんげんほうしき	利益還元方式
らくとうこうりゅういき	洛東江流域
らいちょうざわほうめん	雷鳥沢方面
らいしゅんしゅうしょく	来春就職
ろんぶんしょうじゅしょう	論文賞受賞
ろじょうかんさつがっかい	路上観察学会
ろくがしゅうりょうじこく	録画終了時刻
れんせいちゅうせいしせい	連星中性子星
れんしゅうきょくさくひん	練習曲作品
れんけつざいむしょひょう	連結財務諸表
るいしんてきしょとくぜい	累進的所得税
りようしゃこうしゅうかい	利用者講習会
りょこうにっていがいよう	旅行日程概要
りょこうせんもんがっこう	旅行専門学校
りょこうしゅうりょうえき	旅行終了駅
りょうゆうともにはたたず	両雄不倶立	両雄倶には立たず
りょうきんじょじゅうたい	料金所渋滞
りょうきんしょじゅうたい	料金所渋滞
りょうきんかいしゅうりつ	料金回収率
りゅうどうけんきゅういん	流動研究員
りゅうつうりょうちょうさ	流通量調査
りゅうつうかがくだいがく	流通科学大学
りゅうじょうかっせいたん	粒状活性炭
りゅうきゅうおうちょうふ	琉球王朝府
りつめいかんだいがくいん	立命館大学院
りったいちゅうしゃじょう	立体駐車場
りくれんとうろくせんしゅ	陸連登録選手
りくじょうきょうぎじょう	陸上競技場
らんりゅうきそけんきゅう	乱流基礎研究
らくとうこうじょうりゅう	洛東江上流
らいきぎょうむもくひょう	来期業務目標
れんりついちじほうていしき	連立一次方程式
れんらくせんはっちゃくじょ	連絡船発着所
れんぞくしあいしゅつじょう	連続試合出場
れんそうしゅぎしゃこうぞう	連想主義者構造
りょきゃくえいぎょうきそく	旅客営業規則
りょきゃくえいぎょうきせい	旅客営業規制
りょうごくはなにしきとうし	両国花錦闘士
りょうきんしはらいけいたい	料金支払形態
りゅうどうせいはいれつほう	流動性配列法
りえきしょぶんけいさんしょ	利益処分計算書
ろうどうきじゅんかんとくしょ	労働基準監督署
りょきゃくとりあつかいきてい	旅客取扱規程
りょうしゃきょうどうかいはつ	両社共同開発
ろうどうかんけいちょうせいほう	労働関係調整法
りゅうたいかがくけんきゅうじょ	流体科学研究所
りょうりいんしょくとうしょうひぜい	料理飲食等消費税
りんぴょうとうしゃかいちんれつざいぜん	臨兵鬪者皆陳列在前
