と	肚	捕	砥	塗	富	跿	兎	土	翔	止	図	戸	汢	徒	莵	途	問	取	冨	録	説	妬	磨	飛	蠹	泊	融	留	渡	溶	都	砿	撮	菟	綴	十	睹	解	砺	頭	畄	登	熔	斗	跳	閇	蚪	執	疾	礪	闘	閉	兔	堵	觧	度	秉	圖	蠧	賭	屠	脱	摂	覩	人	荼	杜	盗	採	外	鎔	研	停	遂	鍍	吐
て	弖	手	〒	照
つ	摘	連	釣	告	築	通	接	積	点	詰	搗	嗣	貫	継	柘	盡	使	着	憑	撞	都	繼	浸	附	津	點	漬	椄	付	次	就	攣	支	尽	吊	突	晦	尾	衝	注	吐
ち	遅	知	夂	痴	緻	踟	茅	褫	薙	致	癡	質	智	乳	黐	魑	地	穉	禿	蜘	弛	家	馳	黹	稚	千	笞	遲	輊	夊	値	血	耻	胝	置	躓	散	恥	岻	池	治
た	經	侘	逹	截	田	澑	堪	建	汰	咤	裁	斷	垂	詑	勃	他	多	朶	它	手	達	発	絶	溜	耐	起	貯	経	太	詫	躱	發	立	閉	賜	足	夛	蛇	給	岔	焚	強	長	佗	闌	炊	断	埀	食	矯
とん	遁	屯	飩	問	丼	敦	豚	頓	東	暾	瓲	団	團	沌	噸	惇	燉	遯
とわ	登和	永遠
とろ	トロ	盪	吐露	瀞	蕩
とり	取	鳥	鶏	取り	鷄	酉	禽
とら	捕	乕	寅	把	捉	囚	虎
とよ	豊	豐
とや	鳥屋	外谷	戸谷
とも	知	点	艫	友	具	供	舮	鞆	智	燈	伴	朋	靹	恭	共	朝	灯	侶
とめ	登米	留
とむ	吐夢
とみ	當	富	登美	冨	頓
とま	佇	苫	止	笘	泊	留	篷	停
とぼ	惚	点	乏	恍
とほ	通	徹	杜甫	徒歩	遠
とべ	戸部	砥部
とふ	塗布	都府
とび	鵄	鴟	飛び	鳶
とひ	徒費	都費	都鄙
とば	飛	鳥羽	賭場
との	殿
とね	刀根	利根	刀禰
とな	稱	称	隣	鄰	唱
とど	椴	止	届	留	畄	屆	停
とて	迚
とつ	咄	凸	訥	吶	突	柮	嫁
とっ	疾っ
とち	杤	栃	橡	土地	柮
とだ	戸田	途絶
とそ	屠蘇
とせ	歳
とす	鳥栖
とじ	賭事	刀自	徒事	徒爾	綴	綴じ	途次	戸締
とし	壽	繁	年	夙	捷	敏	利	暁	歳	都市	世	祀	駿	寿	徒死	稔	俊	肇
とざ	鎖	閉
とさ	土佐
とこ	床	常
とげ	棘	朿	刺
とけ	土気
とく	説く	讀	篤	慝	解く	疾く	黷	徳	犢	悳	匿	禿	特	涜	得	牘	読	督
とぎ	砥	伽	研ぎ	都議	富来	途切
とき	土岐	穐	秋	時間	鴾	朱鷺	刻	鬨	辰	常	鴇	時
とが	咎	利賀	都雅	科	栂	尖
とか	渡河	都下	徒過
とお	通	徹	十	遠
とえ	十重
とう	唐	透	讀	骰	藤	滕	當	筒	篤	亠	鐙	吋	潼	档	蟷	祷	通	竇	蹈	逗	嶌	榻	到	橦	抖	桃	党	蘯	撓	疼	刀	凍	島	偸	磴	檮	掏	騰	滔	謄	搗	訊	陦	韜	棹	諮	纛	饕	幢	棟	疾う	淌	剳	塔	撞	礑	櫂	擣	糖	踏	鬥	套	濤	湯	迯	綯	陶	倒	燈	十	淘	黨	搭	桶	橈	鞳	訪	父	討	荅	頭	鞜	登	稻	朸	溏	兜	酘	掉	痘	盪	夲	叨	鼕	鬪	罩	闘	梼	等	東	閙	籘	冬	橙	樋	答	棠	搨	悼	稲	投	塘	螳	桐	帑	縢	読	嶋	萄	涛	嶝	宕	逃	盗	籐	蕩	道	納	灯	当	統	沓	盜	釖	豆	儻	董	任
とい	問	桶	土肥	樋	戸井	問い
てん	篆	貼	奠	天	点	槙	囀	腆	…	鷆	，	貂	碾	展	梃	・・・	纒	廛	典	諂	甜	転	纏	躔	鷏	填	、	覘	點	殄	殿	丶	轉	霑	店	巓	・	顛	添	癲	辿	恬	輾	靦	忝	壥	．
てわ	手分
てれ	照れ
てる	瑛	晃	輝	照
てり	輝
てら	寺	地球	tera	照	衒
ても	手持
てむ	手向
てま	手間
てぶ	手振	手ぶ
てび	手引
てば	手羽
てぬ	手抜
てな	手慣
てど	手取
てと	手取
てて	父
てづ	手詰
てつ	輟	鐵	跌	姪	Iron	迭	徹	綴	Fe	耋	鐡	銕	手付	屮	餮	哲	轍	鉄	垤	撤	咥
てっ	徹
てだ	手立	手出	手練
てじ	手締
てざ	手差
てさ	手提	手差
てご	手児
てこ	挺子	梃	手子	梃子
てぐ	手具
てぎ	手切
てき	摘	笛	糴	滴	鏑	剔	適	狄	躑	彳	廸	擲	敵	擢	的	迪	俶	荻	覿	嫡	逖
てが	手掛	手書	手賀	手懸
てお	手押	手負	手落
てい	碵	廷	啼	眤	態	渟	詆	釘	提	悌	蹄	觝	体	剃	遉	袋	薙	帝	掟	酊	呈	低	遞	梯	堤	嚔	叮	貞	第	挺	躰	丁	柢	酲	訂	偵	綴	體	騁	棣	弟	亭	禎	鄭	汀	手入	睇	底	諦	滞	羝	逓	抵	定	鵜	締	邸	涕	幀	艇	逞	碇	停	牴	嚏	程	庭	軆	鼎	楴
てあ	手編	手合	手当	手上
つれ	連れ
つる	連	鶴	絃	敦	都留	弦	交尾	吊	寉	蔓
つり	釣	吊
つら	連	面	列	ツラ	辛
つよ	強
つゆ	露	梅雨	汁
つや	艷	通夜	艶
つも	積	模
つめ	冷	詰	詰め	爪
つむ	瞑	紡	頭	舶	紡錘	錘
つみ	罪	辟	詰み
つま	摘	妻	詰	褄	撮	都万	倹	嬬	抓	約
つぼ	窄	壺	坪	蕾	壷
つぶ	潰	螺	瞑	粒
つひ	潰	幣	費
つば	鐔	唾	鍔
つの	角	都農	都濃	募	津野
つね	恆	典	経	桓	恒	常	抓
つな	継	繼	津名	綱	繋
つど	集	津戸	都度
つと	務	努	夙	勉	衝と	勤
つて	伝手	伝
つづ	續	綴	続	通津	約
つつ	筒	慎	謹	裹	砲	突突	障	包	突
つち	土	椎	槌	鎚	壌
つだ	津田	傳	伝
つた	蔦	傳	伝	樢
つず	綴
つじ	辻
つし	津市	都志
つこ	使
つげ	柘	柘植	都祁	告げ
つけ	漬け	漬	付
つぐ	嗣	継	噤	鉗	津具
つく	創	筑	殱	造	盡	捏	津久	殲	尽	做	作
つぎ	次
つき	月	築	坏	欟	付き	憑き	槻	付	突き	尽き
つが	番	都賀	栂
つか	捕	遺	仕	疲	遣	柄	攫	束	塚	使	冢	掴	閊	障	把	支	捉
つえ	丈	拐	杖
つう	通	痛
つい	堆	終	潰	椎	築	對	弊	縋	啄	槌	対	墜	追	鎚	費	序	遂
ちん	陳	狆	鴆	朕	闖	抻	賃	砧	鎮	鎭	珎	碪	椿	沈	珍	枕	趁
ちわ	痴話	地和
ちり	地理	塵	知里	智利
ちよ	千代
ちょ	墸	佇	箸	苧	躇	著	緒	瀦	猪	竚	紵	貯	樗	潴	儲	豬	楮
ちゆ	治癒
ちゅ	丶
ちゃ	咤	茶
ちみ	魑魅	地味
ちほ	智保	地歩	千穂
ちぶ	知夫	恥部
ちば	地場	千葉
ちの	茅野	千野
ちぬ	釁	血塗
ちな	知名	因
ちと	些と	少と
ちづ	地図
ちつ	腟	窒	蟄	秩	帙	膣
ちっ	些
ちぢ	千々	縮
ちち	致知	乳	父	遅々	義父
ちだ	千田
ちた	知多
ちぞ	血染
ちそ	地租
ちせ	知世
ちず	地図	千寿	智頭
ちじ	知事	縮
ちし	地誌	致仕	致死	智歯	地史
ちさ	智佐	知砂	千沙
ちご	乳児	稚子	稚児
ちこ	近
ちぐ	痴愚
ちく	築	筑	逐	畜	馳駆	竹	蓄	地区	矗
ちぎ	遅疑	契	千切	杠	千木
ちき	飭	稙	知己
ちが	千賀	交	違
ちか	智佳	誓	地下	知夏	盟	治下	知華	知可	親	知佳	地価	千夏	智加	近	智香	値化
ちえ	千重	千枝	知重	千絵	智恵	知慧	智慧	知恵	知惠	知枝	千英	知衣	知江
ちい	地位	地維	地衣	小	地異
たん	湍	摶	丹	椴	賺	堪	誕	担	襌	鄲	眈	淡	潭	猯	旦	毯	殫	嘆	酖	胆	站	澹	槫	攤	綻	檀	探	啗	褝	端	反	擔	湛	鍛	啖	憚	緞	餤	靼	憺	箪	亶	疸	歎	炭	単	貪	短	蛋	痰	譚	膽	覃	壇	彖	但	坦	單	耽	慱	袒
たを	撓	手折
たわ	戯	撓	嵶
たれ	誰	垂れ
たる	垂	弛	樽
たり	足り
たら	誑	鰔	足ら	鱈	膤	太良
たよ	頼	便
たゆ	斬	弛
たや	田屋	田谷	多屋
たも	玉網	保
ため	澑	爲	試	溜	為	溜め
たむ	手向
たみ	多美	民
たま	霊	球	澑	堪	珠	珪	多摩	彈	弾	溜	玉	賜	偶	給	田万	靈
たぼ	髱
たべ	多辺	田部	食べ
たぶ	他部	椨
たふ	倒	佗負	斃
たび	旅	足袋	度
たば	他馬	束	田場
たの	他の	楽	恃	多野	頼	田野	愉	樂
たね	多根	種子	胤	種
たに	峪	溪	渓	谿	谷
たな	柵	棚	店
たど	到	多度	辿
たと	譬	喩	例
たで	蓼
たて	立て	建	縦	蓼	舘	楯	竪	┃	│	館	立	盾	縱	殺陣
たづ	訊	訪	尋
たつ	逹	竜	達	韃	燵	斬	立	龍	立つ	辰	闥	撻
たっ	逹	達
たち	逹	大刀	舘	達	質	館	太刀	立	城	多値	立ち	性質
ただ	維	正	忠	無料	伊	多田	爛	質	糜	惟	直	唯	糺	但	只	匡
たた	疊	讃	叩	称	祟	畳	湛	敲	疉	賛	多々	疂
たず	訊	訪	尋
たす	扶	助	足す	＋
たじ	多事	他事
たし	他誌	多肢	多指	足し	他紙	慥	確
たざ	打坐
たご	多語	田子	多胡	多湖
たこ	蛸	凧	鮹	鱆	章魚	胝	多古	胼胝
たけ	丈	哮	建	雄	斌	茸	毅	猛	他家	竹	嶽	誥	健	威	岳	武
たぐ	手繰	比	類
たく	綰	拓	澤	鐸	沢	啅	戳	択	柘	巧	托	卓	磔	擇	炊く	託	啄	琢	度	擢	多久	宅	魄	鈬	濯	倬	焚く	拆	柝	謫
たぎ	激	滾	多義
たき	瀑	竜	瀧	多岐	多喜	多紀	滝
たが	多賀	互	他我	箍	違
たか	集	高	臣	亨	鷹	崇	尚	隆	多価	孝	嵩	敬	宇	尭	多寡	孚	貴	任
たお	田尾	嫋	嵶	垰	倒	手折	斃
たえ	妙	絶え	栲
たう	田植	Τ	τ	多雨
たい	堆	鯛	態	帯	汰	對	碓	体	戴	逮	怠	貸	袋	苔	滯	平	躰	颱	駘	隊	岱	頽	耐	體	擡	胎	褪	他意	抬	太	待	靆	替	諦	対	滞	退	帶	田居	大	田井	台	泰	腿	黛	玳	殆	隶	軆	代	紿
とんや	問屋
とんま	頓馬
とんぼ	蜻蛉
とんび	鳶
とんば	東場
とんち	頓智	頓知
とんず	筒子
とんじ	遁辞
とんし	豚脂	頓死
とんざ	頓挫
とんご	頓悟
とんが	尖
とわだ	十和田
とろん	徒論
とろろ	薯蕷
とろび	とろ火
とろう	徒労
とれん	都連
とれつ	堵列
とるこ	土耳古	土耳其
とりわ	取り分
とりよ	取り寄	鳥寄
とりや	鳥屋	鳥谷	取り止
とりも	取り持
とりめ	鳥目
とりみ	鳥見
とりま	取り混	取り巻	取巻
とりひ	取り引	取引
とりの	取り除
とりに	取り逃
とりな	執り成	取り成
とりで	取手	塞	砦
とりて	取り手
とりつ	都立	取り次	取り尽	取り付	取り憑	取次	取付
とりち	取り散
とりだ	取出	取り出
とりた	取立	取り立
とりす	取り澄	鳥巣
とりし	取り締	取締
とりさ	取り去	取り下
とりこ	虜擒	取り込	取り越	俘	擒	虜
とりけ	取消	取り消
とりく	取組	取り組
とりき	取木	取り決	取り木	取り極	取り切
とりか	取り替	取り換	取り交	取り掛	取交
とりお	取り置
とりえ	取柄	取り柄
とりう	取り得	鳥生
とりい	取り入	鳥居	取入	鳥井
とりあ	取り合	取り敢	取り上
とらぶ	トラブ
とらぎ	トラ技
とらが	虎刈
とらお	虎雄	寅男	寅雄	虎男
とらい	戸来	渡来
とよま	登米
とよの	豊野	豊能
とよね	豊根
とよつ	豊津
とよだ	豊田
とよた	豊田
とよす	豊洲
とよじ	豊治
とよこ	豊子
とよき	豊樹
とよう	渡洋
とゆう	都邑	都有
とやま	富山	戸山	外山
ともよ	知世	知代	智世
ともや	智也	知也
ともみ	知実	友海	具美	智美	知視	知美	智己	とも美	朋美	具視	友視	朋三	具実	智巳
ともべ	友部
ともへ	艫舳
ともの	友野	伴野
ともね	共寝
ともに	共に
ともな	伴
ともち	砥用
ともだ	友田
ともじ	友治	知司
ともし	知士
ともざ	艫座
ともこ	友子	智子	知子	朝子	朋子	とも子	倫子
ともぐ	共食
ともき	友紀	朋喜	友喜	知樹	智樹
ともか	友香
ともお	智雄	知夫	友雄	朋夫	友朗	智央	智夫
ともえ	知重	友衛	巴
ともい	友井
とめん	塗面
とめば	留場
とめど	止処	留処
とめじ	留治
とめこ	留子
とめお	留め置
とむら	弔	訪	外村	戸村
とみん	都民
とみよ	富魚
とみや	富谷
とみの	富野
とみに	頓に
とみて	冨手
とみた	富田	冨田
とみじ	富治
とみこ	富子	登美子	富美子
とみか	富加
とみお	富雄	富美男	富男	富夫
とみえ	富江
とみい	富井
とまり	泊	渡真利	泊まり	泊り
とまや	苫屋
とまど	戸迷	戸惑
とまつ	戸松	塗沫	塗抹
とまた	苫田	攴
とます	斗
とまく	塗膜
とぼし	乏し
とぼく	杜牧
とほの	遠退
とほう	途方
とべい	渡米
とぶら	弔	訪
とふつ	渡仏
とふご	塗付後
とびら	扉
とびひ	飛び火
とびは	飛び跳
とびの	飛び乗	飛び退
とびぬ	飛び抜
とびで	飛び出
とびつ	飛び付
とびち	飛び地	飛び散
とびだ	飛び出
とびた	飛び立	飛田
とびこ	跳び越	飛子	飛び越	飛び込
とびか	飛び交
とびお	飛び降	飛び下	飛び起
とびい	飛び入
とびあ	飛び上	跳び上
とばり	帷	戸張り	帳	幃	戸張	幄
とばた	戸畑
とばす	都バス
とばく	賭博
とばえ	鳥羽絵
とはん	登攀	登坂
とはい	徒輩
とのみ	富海
とのま	殿馬
とのと	殿戸
とのご	殿御
とのこ	砥粉
とのい	宿直
とねり	舎人
とにち	渡日
となん	都南
となり	隣り	隣	鄰
となみ	外波	礪波	砺波	渡並
となき	渡名喜
とない	都内
とどろ	軣	轟
とどめ	止め
とどむ	閼
とどま	滞
とどけ	届け	届	屆
とどう	都道
ととの	調	整	斉
ととき	十時
ととう	徒党	渡頭	渡島
とでん	都電
とても	迚	迚も
とてい	徒弟
とづか	戸塚
とつか	戸塚
とっぴ	突飛
とっぱ	鳥羽	突破
とって	把手	取っ手	取手	把っ手
とっつ	取っ付
とっさ	咄嗟
とっこ	独鈷
とっく	疾く	特区	疾っく	取っ組
とっき	特記	突起	特器	特機
とっか	特価	特化	徳化	取っ替	特科
とちじ	都知事
とちく	屠畜
とちぎ	栃木	朽木
とちお	栃尾
とだな	戸棚
とだし	戸田市
とだか	戸高
とだい	東京都立大学
とたん	途端	塗炭
とそつ	兜率
とそう	塗装
とぜん	徒然
とぜつ	杜絶	途絶
とぜい	都税
とせん	渡船
とせい	渡世	都政
とすし	鳥栖市
とじめ	綴じ目
とじま	戸締	戸島
とじこ	閉じ込	綴じ込
とじき	戸敷
としん	妬心	都心	兎唇
としよ	敏代	年寄
としょ	屠所	図書
としゅ	徒手	斗酒
としや	俊弥	利也	敏也	俊也	敏哉	俊哉
としゃ	吐瀉
としみ	利美	敏巳	都志見	寿実	年美
としま	十島	年増	戸嶋	戸島	豊島	利島
としぶ	都市部
としは	年端
としと	年取
としじ	俊治
としご	年子
としこ	トシ子	利子	俊子	年子	敏子	淑子	寿子	とし子	年越	登志子
としき	俊樹	年紀	戸敷	年樹	稔貴	敏生	歳樹	敏樹
としか	都市化
としお	俊朗	利生	敏男	寿夫	稔雄	寿男	俊夫	敏郎	俊雄	利男	利雄	利夫	敏夫	俊男	敏雄	登志夫	寿雄	利朗	年老	淑夫
としえ	利絵	とし恵	敏江	季衣	敏枝	俊恵
としあ	年明
とざん	登山
とざわ	戸沢
とざま	外様
とざと	外里
とざき	戸崎
とざい	吐剤
とさに	土佐煮
とさつ	塗擦	屠殺
とさず	土佐酢
とさか	鶏冠	戸坂
とさえ	土佐絵
とごう	戸郷
ところ	所	處	処
とこよ	常世
とこや	床屋
とこず	床擦
とこし	戸越
とこう	都甲	渡航
とこい	常井
とけん	都県	覩見
とけつ	吐血
とけこ	溶け込
とけい	徒刑	時計	土圭
とけあ	溶け合
とぐら	戸倉
とぐち	戸口
とくり	徳利
とくら	十倉	戸倉	都倉
とくむ	特務
とくみ	徳見	徳美
とくま	徳間
とくは	特派
とくに	特に
とくど	得度
とくち	渡久地
とくだ	得田	徳田
とくじ	徳次	徳治	徳地
とくし	得之	特旨	篤志	特使
とくさ	木賊
とくこ	徳子
とくぎ	特技	徳義
とくき	特記
とくか	特化
とくお	徳雄	十九夫	徳男
とくえ	徳衛
とくい	特異	得意
とぎん	都銀
とぎれ	跡切れ	途切れ
とぎつ	時津
とぎす	研ぎ澄
とぎし	砥師
ときん	と金	鍍金
ときわ	常磐	常盤	常葉
ときよ	時世
ときふ	説き伏
ときね	十樹根
ときに	時に
ときつ	説き付	時津
ときち	十吉
ときだ	時田
ときた	時田
ときこ	時空子	時子	登紀子
ときお	時生	時男	時夫	登紀夫	時雄	時郎
ときあ	説き明	解き明
とがわ	外川	戸川
とがり	戸狩	戸苅
とがめ	咎め
とがみ	戸上
とがま	利鎌
とがし	冨樫	富樫
とがき	ト書	ト書き
とがい	都外
とかち	十勝
とかげ	蜥蜴	石竜子
とかい	都会	渡海
とおわ	十和
とおる	透	逹	享	亨	達	徹	融	理
とおり	通	通り
とおや	遠矢
とおめ	遠目
とおみ	遠見
とおま	遠間	遠巻
とおぼ	遠吠
とおび	遠火
とおの	遠野	遠の	遠乗	遠退
とおね	遠音
とおで	遠出
とおだ	遠田
とおす	遠過
とおし	通し
とおく	遠く
とおか	10日	十日
とおう	渡欧
とおい	遠井
とえい	都営	渡英
とうわ	東倭	十和	東和
とうろ	当路
とうれ	東レ
とうる	透	徹
とうり	通	統理	党利	桃李
とうよ	投与	東予
とうゆ	灯油
とうや	陶冶	当夜	洞爺	塔屋	塔矢
とうむ	党務
とうみ	唐箕
とうま	東馬	冬馬	当間	当麻	當麻	討魔	藤間
とうぼ	掏摸
とうぶ	頭部	東武	東部	当部
とうふ	■	豆腐
とうび	掉尾
とうひ	等比	逃避	討匪	頭皮	当否
とうば	塔婆
とうは	党派	踏破
とうの	遠野	統乃	東野	当の	冬野
とうな	唐菜
とうど	凍土	糖度	陶土
とうと	東都	尊	疾う疾	貴
とうで	遠出
とうち	投地	等値	倒置	当地	島地	統治
とうだ	頭打	任田
とうた	淘汰
とうぜ	党是
とうす	遠過	刀子
とうじ	答辞	冬至	当寺	藤治	当事	刀自	田路	東寺	統辞	蕩児	等時	田牛	湯治	当時	統治	杜氏	悼辞
とうし	凍死	闘志	骰子	投資	透視	唐詩	祷祠	唐紙	闘士	祷祀
とうざ	当座
とうさ	等差	踏査
とうご	東児	頭語	統語
とうこ	東子
とうげ	峠
とうけ	当家
とうぎ	闘技	党議	東儀	討議
とうき	投棄	党旗	登記	投機	冬季	当期	当季	騰貴	陶器	党紀	党規	頭記	当帰	当機	闘鬼	冬期
とうが	冬芽	陶瓦
とうか	１０日	陶化	陶家	灯火	透過	糖化	当課	等価	投下	橙	燈下	橙果	10日	豆果	桃花	等化	燈火	十日
とうい	陶猗	当意	当為	東夷	糖衣	等位
とうあ	東亜	東亞
といろ	十色
といや	問屋
といつ	問詰	問い詰	対子
といち	十一
といた	戸板
といし	砥石	礪
といき	吐息
といか	問い掛
といあ	問い合	問合
とあみ	投網
とあさ	遠浅
とーれ	東レ
てんわ	天和
てんろ	転炉
てんり	天理
てんよ	天与
てんや	店屋
てんめ	点目
てんま	天魔	天馬	天満	伝馬
てんぽ	転補	填補	店舗
てんぷ	貼付	天賦	添付
てんぶ	転部
てんぴ	天火	天日
てんび	天引
てんば	天馬
てんね	天衣
てんに	点２
てんと	点取	奠都
てんち	転地	転置	天地
てんじ	篆字	典侍	点字	添字	展示
てんし	天使	天資	覘視	展翅	天子
てんさ	点差
てんご	点５
てんこ	典故	点呼
てんげ	天下
てんぐ	天狗
てんく	転句
てんぎ	転義	典儀
てんき	転機	天氣	転記	転帰	天気	天機
てんが	天下	典雅
てんか	転化	点火	添加	転訛	天下	転嫁	転科
てんえ	天衣
てんい	天意	天衣	転移	典医	転位	典韋
てをだ	手を出
てわた	手渡
てわざ	手業	手技
てわけ	手分け
てれん	手練
てれや	照れ屋
てれび	電視
てるる	Tellurium	Te
てるみ	輝美	照美
てると	照人
てるこ	てる子	照子	輝子
てるき	輝樹
てるお	輝男	晃夫	光男	輝雄	照夫	晃央	照雄	照男	輝夫
てるい	照井
てりは	照り葉	照り映
てりつ	照り付
てりこ	照り込
てらの	寺野
てらだ	寺田
てらこ	寺子
てらお	寺尾
てらい	寺井
てゆび	手指
てやわ	手柔
てやく	手役
てやき	手焼
てもり	手盛り
てもど	手戻
てもと	手元	手許
てもち	手持	手持ち
てめえ	手前
てみず	手水
てまわ	手回
てまり	手毬	手鞠
てまね	手真似	手招
てまど	手間取
てまき	手巻	手巻き
てまえ	手前	点前
てほん	手本
てほど	手解
てへん	天辺	手偏	頂辺
てぶり	手振り	手振
てぶら	手ぶら
てふだ	手札
てふき	手拭き
てびろ	手広
てびき	手引	手引き
てびか	手控
てひど	手酷
てばん	手番
てばや	手早
てばな	手放	手離
てばた	手旗
てばこ	手箱
てはら	手原
てはず	手筈
てはじ	手始
てはい	手配	手牌
てぬる	手緩
てぬき	手抜き
てぬい	手縫い
てにい	手に入
てなわ	手縄
てなれ	手馴れ
てなら	手習
てなみ	手並	手並み
てなべ	手鍋
てなが	手長
てなお	手直
てどり	手取り	手取
てとり	手取り
てづる	手蔓
てづり	手釣
てづよ	手強
てづめ	手詰	手詰め
てづま	手詰
てづく	手作
てづか	手塚	手掴
てつろ	鉄路
てつり	哲理
てつや	哲弥	徹也	鉄也	徹夜	鉄弥	哲哉	哲也
てつみ	哲美
てつづ	手続
てつだ	手伝
てつた	哲多
てつじ	哲至	轍次	哲二	哲士	哲嗣	哲司	哲志	綴字	哲史
てつし	哲士	哲史	哲資
てつこ	徹子	哲子
てつけ	手付け	手付
てつき	哲樹	手付
てつか	手塚
てつお	哲郎	鉄雄	哲男	鉄夫	哲夫	哲臣	哲雄	哲生	徹男	鉄男
てっぷ	轍鮒
てっぴ	鉄扉
てっと	手っ取
てっさ	鉄鎖
てっき	鉄器	摘記	敵機	適期	鉄騎
てっか	鉄火
てぢか	手近
てちが	手違
てだれ	手練
てだま	手玉
てだて	手立て
てだす	手助
てだし	手出し
てだい	手代
てたれ	手タレ
てぞん	手損
てそう	手相
てぜま	手狭
てぜい	手勢
てせい	手製
てずれ	手擦れ
てずり	手刷
てずか	手塚
てすり	手摺り	手すり
てすじ	手筋
てすき	手隙	手漉き	手透き
てすう	手数
てじめ	手締め
てじま	手嶋	手島
てじな	手品
てじか	手近
てしま	手嶋	手島
てしば	手柴
てした	手下
てしお	天塩	手塩
てざわ	手触
てざし	手差し
てざき	手崎
てさば	手捌
てさし	手差し
てさげ	手提	手提げ
てさぐ	手探
てさき	手先
てごわ	手強
てごろ	手頃	手ごろ
てごめ	手籠
てごま	手駒
てごた	手応	手應
てこず	梃摺
てこう	手甲
てこい	梃入
てぐち	手口
てぐす	天蚕糸
てくび	手首
てくば	手配
てくだ	手管
てくせ	手くせ	手癖
てぎわ	手際
てぎれ	手切れ
てきや	的屋
てきび	手厳
てきひ	適否
てきど	適度
てきち	適地	敵地
てきず	手傷	手創	手疵
てきじ	適時
てきし	敵視
てきぎ	適宜
てきき	敵機	適期
てきが	摘芽
てきか	摘果	滴下	適価
てきい	敵意
てがわ	手側
てがる	手軽
てがら	手柄
てがみ	手紙
てがた	手形	手堅
てがき	手書	手書き
てがか	手掛
てがい	手飼
てかせ	手枷
てかず	手数
ており	手織
ておの	手斧
ておち	手落ち
ておし	手押し
ておけ	手桶
ておく	手遅
ておい	手負い
てうち	手打
てうす	手薄
てうえ	手植え
ていれ	手入れ
ていり	廷吏	定理	低利
ていゆ	提喩
ていや	悌也
ていぶ	底部
ていふ	貞婦
ていね	手稲
ていど	程度
ていと	帝都
ていち	低地	定置	定値
ていた	手痛
ていそ	定礎	提訴
ていじ	貞次	禎治	丁字	定時	呈示	貞二	綴字	低次	禎二	提示	悌二	貞治
ていし	定詞	停止	底止	手石
ていこ	艇庫	貞子	挺庫
ていぎ	提議	定義
ていき	定気	定期	提起
ていが	定芽
ていか	定家	低下	定價	定価	低価
ていい	帝位	定位	低位
てあら	手粗	手荒	手洗
てあみ	手編	手編み
てあぶ	手焙
てあて	手当て	手当
てあつ	手厚
てあし	手足
てあか	手垢
てあい	手合
つんぼ	聾
つんざ	劈
つわの	津和野
つれだ	連れ立	連れ出
つれそ	連れ添
つれさ	連れ去
つれご	連れ子
つれこ	連れ込	連れ子
つれあ	連れ合
つるや	鶴屋	鶴谷
つるみ	鶴見
つるま	鶴間
つるべ	鶴瓶	釣瓶
つるな	蔓菜
つるだ	鶴田
つるた	鶴田
つるざ	鶴座
つるぎ	剣	劍	劔	剱	釼	劒	鶴来
つるが	鶴我	鶴賀	敦賀
つるえ	鶴枝	鶴江
つるい	釣井	鶴居
つりば	釣り場
つりて	釣手
つりだ	吊り出
つりし	釣り師	釣師
つりさ	吊り下
つりこ	釣り込
つりぐ	釣具	釣り具
つりあ	釣り上	釣上	吊り上	釣合	釣り合
つらら	氷柱
つらぬ	貫
つらあ	面当
つよみ	強味	強み
つよび	強火
つよす	強過
つよし	津義	剛士	剛	幹	毅	強	毅師
つよさ	強さ
つよき	強気
つゆこ	露子
つゆき	露木
つやま	津山
つもり	津守
つめよ	詰め寄
つめた	冷	冷た
つめご	詰碁
つめこ	詰め込
つめか	詰め替	詰め掛
つめあ	詰め合
つむり	頭
つむら	津村	津邑
つむじ	旋毛
つむぎ	紡木	紬	紡
つみれ	摘入
つみほ	罪滅
つみに	積荷	積み荷
つみと	摘み取
つみだ	積み出
つみた	積立
つみこ	積み込
つみき	積木
つみあ	積み上	積上
つまび	詳	審	爪弾
つまど	褄取	妻戸
つまづ	躓
つまず	躓
つまご	妻籠
つまお	妻夫
つまい	妻井
つぼや	壺屋
つぼみ	蕾	莟
つぼね	局
つぼた	坪田
つぼい	坪井	壷井	壺井	壺居
つべつ	津別
つぶれ	潰れ
つぶら	円
つぶよ	粒選
つぶや	呟
つぶて	礫
つぶす	潰
つひに	遂に	終に
つばめ	燕
つばた	津幡
つばさ	翅	翼
つばき	椿	唾
つばい	椿井
つはら	津原
つのだ	角田
つのぎ	角木
つのお	角尾
つねよ	常与
つねに	常に
つねじ	常次
つねこ	恒子
つねお	恒夫	常雄	常男	恒雄	恒男	常夫
つなん	津南
つなみ	津波
つなひ	綱引
つなぐ	綱具
つなぎ	津奈木	繋
つなが	繋
つなお	綱男
つどい	集	集い
つとめ	勤め
つとむ	務	努	勉	勤	力
つとに	夙に
つづれ	綴れ
つづり	綴
つづら	葛
つづみ	皷	鼓
つづま	約
つづけ	続け
つづく	続く
つづき	続き	都築	綴喜
つつみ	筒見	堤	包	恙	愼	包み
つつま	慎
つつぬ	筒抜
つつじ	榴	躑躅
つつし	慎	謹	鎮	鎭	愼
つつが	恙	筒賀
つつい	筒井
つっぷ	突っ伏
つっぱ	突っ撥	突っ張	突張
つっつ	突っ突
つった	突っ立
つっこ	突込	突っ込	突っこ
つっき	突っ切
つっか	閊	突っ掛	支
つちゆ	土湯
つちや	土谷	土屋	土家
つちだ	土田	槌田
つちた	土田
つちこ	土子
つちか	培
つちい	土井	土居
つたや	蔦屋
つたな	拙
つたき	津滝
つたえ	伝え
つずき	都築
つじの	辻野
つじた	辻田
つじい	辻井
つしま	津嶋	対馬	對馬	津島
つざき	津崎
つさか	津坂
つごう	都合
つける	付ける
つけめ	付け目
つけび	付け火
つけね	付け根	付け値
つけな	漬菜
つけち	付知
つけた	付け足
つけこ	付け込	漬け込
つけく	付句
つけか	付け替
つけい	付け入
つけあ	付け上
つぐも	津雲
つぐみ	鶫
つぐな	償
つぐお	嗣雄
つくろ	繕
つくり	作り	旁	傍
つくら	繕
つくも	九十九
つくみ	津久見
つくば	蹲	筑波
つくね	築根
つくと	津久戸
つくで	作手
つくだ	附田	佃
つくし	筑紫	土筆
つくえ	机
つくい	津久井
つぎめ	継ぎ目	継目
つぎほ	接ぎ穂
つぎて	継ぎ手
つぎた	注ぎ足	継ぎ足
つぎこ	注ぎ込	つぎ込
つぎき	接木	継ぎ木	継木
つぎお	次雄	次夫	次男
つきよ	月夜
つきめ	尽き目
つきみ	月見
つきひ	月日
つきは	尽き果
つきの	月野
つきぬ	突き抜
つきと	突き飛	突き止
つきで	突き出
つきつ	突き付	突き詰
つきだ	突き出
つきた	突き立
つきそ	付き添	付添
つきじ	築地
つきさ	突き刺
つきこ	月子
つきぎ	月切	月極
つきが	月掛
つきお	突き落
つきあ	突き当	突き上	付き合	月明	突き合	付合
つがわ	対川	津川
つがる	津軽
つがい	番	津飼
つかれ	疲れ
つかむ	搏	攫
つかみ	掴み
つかの	塚野
つかだ	束田	塚田
つかさ	元	司	曹
つかえ	仕え
つかい	遣い	使い
つうわ	通話
つうろ	通路
つうや	通夜
つうめ	通目
つうひ	通費	通臂
つうば	痛罵
つうち	通知
つうだ	痛打
つうじ	通詞	通時
つうし	通史
つうく	痛苦
つうき	通気	通期
つうか	通過	通貨
ついや	費や	費
ついぼ	追慕
ついほ	追捕	追補
ついぶ	追捕
ついび	追尾
ついひ	追肥
ついに	遂に	終に
ついで	次いで	尋いで	序	序で
ついぞ	終ぞ
ついそ	追訴
ついじ	築地
ついし	追試	墜死
ついご	対語
ついく	対句
ついき	鎚起	追記	立木	築城
ついか	追加
ついえ	毅
ちんみ	珍味
ちんぷ	陳腐
ちんぶ	鎮撫
ちんぴ	陳皮
ちんば	跛
ちんじ	椿事	珍事
ちんし	沈思
ちんざ	鎮座
ちんさ	沈渣	賃下
ちんご	鎮護
ちんき	丁幾	珍奇
ちんが	賃貸	賃借
ちんか	鎮火	沈下
ちんあ	賃上
ちわり	地割	地割り
ちわく	地惑
ちろう	遅漏
ちれき	地歴
ちれい	地霊
ちりば	鏤
ちりぢ	散り散
ちらん	治乱	知覧
ちらし	散らし
ちらく	地落	地絡
ちよの	千代乃
ちよだ	千代田
ちよこ	千代子
ちょし	楮紙
ちょこ	猪口
ちょく	敕	勅	飭	稙	捗	直	猪口	陟	躅
ちょう	微	眺	誂	甼	銚	貼	張	鯛	釣	澄	頂	昶	晁	蔦	調	廳	腸	澂	貂	重	糶	疔	塚	悵	暢	冢	齠	輒	挺	弔	彫	諜	懲	楪	丁	凋	超	鳥	帳	牒	聴	徴	窕	帖	町	跳	廰	聽	鬯	雕	挑	輙	潮	寵	嘲	鵈	趙	蝶	漲	吊	樢	脹	朝	長	兆	肇	萇	膓	迢	庁	喋	鼎	髫	稠	佻
ちゆき	千幸
ちゆう	知勇	知友
ちゅん	中
ちゅつ	黜
ちゅう	躊	鋳	註	紬	冑	胄	忠	疇	沖	蟲	晝	紐	昼	厨	冲	柱	冢	仲	鍮	誅	紂	中	駐	虫	籀	酎	寵	籌	肘	畴	惆	宙	※	廚	丑	鑄	儔	綢	抽	衷	稠	注
ちやこ	千夜子
ちゃわ	茶話
ちゃや	茶屋
ちゃめ	茶目
ちゃみ	茶見	茶美	茶味
ちゃま	茶魔
ちゃほ	茶舗
ちゃば	茶葉
ちゃの	茶飲
ちゃづ	茶漬
ちゃじ	茶事
ちゃく	摘	茶汲	着	嫡
ちゃき	茶木	茶器
ちゃか	茶菓	茶化	茶加
ちゃお	找
ちゃう	茶宇	茶請
ちもじ	血文字
ちもく	地目
ちもう	恥毛
ちめい	知名	知命	地名	致命
ちむら	地村
ちみん	治民
ちみつ	緻密
ちみち	血道
ちまよ	血迷
ちまめ	血豆
ちまた	巷
ちまき	粡	粽
ちぼう	知謀	智謀
ちほう	痴呆	地方
ちべん	智辯
ちへん	地変
ちへど	血反吐
ちへい	治平	地平
ちぶつ	地球物理	地物
ちぶさ	乳房
ちふゆ	千冬
ちふみ	千文
ちひろ	知宏	千紘	千尋	馳浩	千裕
ちひつ	遅筆
ちばん	地番
ちばな	知花
ちばし	血走	千葉市
ちはん	池畔
ちはる	智春	千春
ちはら	茅原	千原
ちはや	千早
ちはつ	遅発
ちはい	遅配
ちのり	血糊	地の利
ちのね	茅根
ちのし	茅野市
ちのけ	血の気
ちのう	智能	知能
ちねん	知念
ちねつ	地熱
ちにち	知日
ちにく	血肉
ちなみ	因
ちなつ	千夏
ちどん	遅鈍
ちどり	鵆	千鳥
ちどめ	血止め
ちとせ	千歳	千登世
ちとく	知得	地徳
ちてん	地点
ちてつ	地鉄
ちてき	知的
ちてい	地底
ちづる	千鶴
ちづこ	千鶴子
ちづか	千束
ちつみ	千津美
ちっと	些と
ちっそ	N	窒素	Nitrogen
ちっし	窒死
ちぢわ	千々石
ちぢれ	縮れ
ちぢみ	縮
ちちぶ	秩父
ちちご	父御
ちちく	乳繰
ちだい	地代
ちたん	Titanium	Ti
ちたね	千種
ちたつ	笞撻	遅達
ちたし	知多市
ちたい	痴態	遅滞	地帯
ちぞめ	血染め
ちそく	遅速	知足
ちそう	地相	馳走	地層
ちせつ	稚拙
ちせこ	智勢子
ちせき	治績	地積
ちせい	地勢	知性	痴性	治世
ちずや	地図屋
ちずこ	知寿子	千寿子	千鶴子
ちずか	地図化
ちすわ	千須和
ちすじ	血筋
ちすい	治水	池水
ちじん	知人	地人	痴人
ちじょ	痴女
ちじつ	遅日
ちじく	地軸
ちじき	地磁気
ちしん	地心	池心
ちしろ	千代
ちしょ	地所
ちしゃ	痴者	知者	苣	萵苣	治者	智者
ちしま	千島
ちしつ	知悉	地質
ちしき	知識
ちしお	血潮
ちざけ	血酒
ちざい	笞罪	知財
ちさん	遅参	治山	地産	治産
ちさと	千里
ちさこ	千佐子	知紗子
ちさく	千咲
ちさき	地先
ちさい	地裁
ちこつ	恥骨
ちこく	治国	遅刻
ちこう	地皇	知行	恥垢	地溝	遅効
ちけん	地圏	智見	智剣	知見	地検	地券	知県	治権	治験
ちけい	地形	笞刑	地景
ちぐさ	千種	千草
ちぐう	知遇
ちくん	治勲
ちくわ	竹輪
ちくら	千倉
ちくま	筑摩
ちくほ	筑穂
ちくび	乳首
ちくひ	竹皮	竹扉
ちくば	竹馬
ちくは	竹葉
ちくじ	逐次
ちくし	筑紫	竹紙	竹枝
ちくさ	千種
ちくご	逐語	筑後	築後
ちくい	築井
ちぎん	地銀
ちぎり	契	千切
ちぎょ	稚魚
ちがや	茅
ちがく	地学
ちがえ	違え
ちがい	稚貝	地外	違い
ちかん	遅緩	置喚	痴漢	弛緩	置換
ちから	千賀良	主税	力
ちかよ	近寄
ちかま	近間
ちかば	近場
ちかづ	近付
ちかだ	近田
ちかす	近過
ちかし	近し	迩
ちかこ	千加子	千香子	渠睦子	ちか子	智香子	知可子	千嘉子	千賀子	智加子	睦子
ちかげ	千影
ちかく	地核	地殻	近く	知覚
ちかか	地下化
ちかお	親雄	周夫	知馨夫
ちかい	地階	近井	邇	地界
ちおん	地温
ちえん	遅延	地縁
ちえり	智恵理
ちえみ	智恵美	智枝美	千恵美	千絵美	智栄美
ちえこ	知恵子	智恵子	千枝子	千恵子
ちうみ	血膿
ちいん	知音
ちいさ	小さ	小
ちいく	知育
ちいき	地域	値域
ちあん	治安
ちあゆ	稚鮎
ちあき	千昌	千秋	千亜紀	千章	千明	千晶
ちあい	血合
たんり	単利	単離
たんむ	坦務
たんみ	淡味
たんぽ	担保
たんぼ	田圃	田んぼ
たんぶ	反歩	端部
たんび	耽美
たんぱ	短波
たんば	丹波	丹羽
たんの	端野	丹野
たんに	単二	歎異	単に
たんな	丹那
たんち	丹治	探知
たんだ	短打	単打
たんそ	炭素	C	炭疽	Carbon
たんす	箪笥
たんじ	丹治	単耳
たんし	譚詩	短枝	単子	短詩	短資	箪食	端子
たんざ	端坐	単座	単坐	端座
たんさ	丹砂	探査
たんご	端午	丹後	単語
たんげ	丹下
たんく	短躯
たんき	単機	単記	短期	短気	単騎
たんか	単果	啖呵	炭化	單價	短歌	単価	担架	譚歌
たんえ	丹絵
たんい	単為	単位	單位
たわら	田原	俵	太原
たわむ	戯	戲
たわし	束子
たわけ	戯け	白痴
たわい	他愛
たろう	太郎	田老	太朗	太良	多郎
たれつ	多列
たれさ	垂れ下
たれこ	垂れ込	垂れ籠
たるみ	垂水	弛み
たるほ	足穂
たるひ	垂氷
たるき	榱	椽	垂木	樽木
たるい	樽井	垂井
たりつ	他律
たりき	他力
たらみ	多良見
たらま	多良間
たらず	足らず
たらこ	鱈子
たらぎ	多良木
たらい	盥
たより	便り
たよく	多欲
たよう	多様	多用	他用
たゆた	揺蕩
たゆう	大夫	太夫	大輔
たやま	田山
たやす	容易
たもん	大紋	多聞	他門
たもり	田森	田守
たもと	田本	袂
たもつ	保
ためん	他面	多面
ためら	躊躇	猶豫
ために	為に
ためす	試す
ためし	様	例	樣	試し
ためこ	溜め込
たむろ	屯
たむら	田村	田邑
たむし	田虫
たむけ	手向け
たみや	田宮
たみこ	たみ子
たみき	民喜
たみお	民生	民夫	民雄	民男
たみえ	民江
たまわ	承	賜
たまる	田丸
たまり	澑	溜	玉利	玉里
たまよ	多満代	弾除	たま代
たまゆ	玉湯
たまや	玉屋
たまみ	珠美
たまほ	玉穂
たまの	玉野
たまに	偶に
たまな	玉名
たまど	玉戸
たまで	玉手
たまつ	玉突
たまち	田町
たまだ	玉田	玉出
たまし	多摩市
たまご	卵	玉子
たまこ	多摩湖
たまげ	魂消
たまく	多摩区
たまぎ	弾切	魂消
たまき	玉木	玉城	玉置	環
たまお	玉緒
たまえ	玉恵	玉江
たまい	玉入	玉井
たぼう	多望	多忙
たほう	他方	多峰	多方
たべん	多弁
たべち	食べ散
たべす	食べ過
たべき	食べ切
たべか	食べ掛
たべお	食べ終
たぶん	多聞	他聞	多分
たぶら	誑
たぶふ	タブ譜
たぶち	田渕	田淵
たぶせ	田布施
たぶさ	髻
たふと	尊	貴
たびら	田平
たびゆ	旅行
たびな	旅慣
たびだ	旅立
たびじ	旅路
たひら	田平
たばる	田原
たばら	田原
たばね	束ね
たばな	手放
たばた	田端	太幡	田畑
たばさ	手挾
たばこ	煙草	莨
たばか	謀
たばい	多売
たはら	田原
たはむ	戲
たはつ	多発
たはた	田畑
たのも	頼も
たのう	多能
たねん	他念	多年	他年
たねま	種蒔
たねび	種火
たねだ	種田
たねぎ	種切
たねい	種井
たねあ	種明
たぬま	田沼
たぬし	田主
たぬき	狸	貍	田貫
たにん	他人
たにま	谷間	渓間
たにの	谷野
たにだ	谷田
たにた	谷田
たにせ	谷瀬
たにし	田螺
たにく	多肉
たにえ	谷江
たにい	溪井	谷井
たなん	多難
たなわ	手縄
たなみ	棚見
たなべ	田辺	田邉
たなび	棚引
たなだ	棚田
たなし	田無
たなこ	店子
たなき	棚木
たなか	田中	田仲
たなえ	田苗
たなあ	棚上
たどん	炭団
たどつ	多度津
たどく	多読
たどう	他動
たとみ	田富
たとえ	例え	譬え	喩え
たとう	他党
たでず	蓼酢
たでく	蓼食
たでか	タデ科
たてん	多点	他店
たてや	建家	建屋
たてめ	縦目
たてま	建増
たてべ	建部
たてふ	縦歩
たての	舘野	立野	館野
たてね	建値
たてつ	建付	楯突	盾突
たてし	殺陣師
たてざ	楯座
たてこ	立て込
たてぐ	縦組	建具
たてき	立て切	建樹	閉て切
たてが	縦書
たてか	立て掛	立て替	建て替
たてお	建夫	建郎	立夫
たづら	田面
たづな	覊	手綱
たづさ	携	攜
たづこ	田鶴子
たづく	田作
たつや	達哉	立矢	辰哉	龍也	達也	立哉	竜也	立弥	辰也
たつみ	辰爾	辰巳	巽	竜実	辰己	立見
たつま	竜馬	辰馬
たつの	辰野	竜野	龍野
たつた	龍田	立田	竜田
たつせ	立つ瀬
たつじ	達治	達司	龍司	辰司	辰二
たつし	辰史	達志	達史
たつき	方便	活計	立木
たつお	竜雄	竜生	辰男	龍夫	辰雄	龍男	辰夫	達男	達雄	竜夫	龍雄	達夫	立雄	達郎
たつい	達意
たっぴ	竜飛	龍飛
たっと	尊	貴
たった	立田
たっし	達し
たちよ	立ち読	立ち寄	立読	立寄
たちゆ	立ち行
たちや	達谷
たちむ	立ち向
たちみ	立ち見	立見
たちま	立ち交	忽
たちひ	立飛
たちば	立場
たちの	立ち退
たちど	立ち止
たちさ	立ち去	立ち下
たちこ	立ち込	立ち籠
たちぐ	立食
たちく	他地区
たちぎ	立ち聞	立木
たちき	截ち切	断ち切	立ち聞	裁ち切	立木
たちう	太刀打
たちい	立ち入	立入	立居	立ち居	起ち居
たちあ	立会	立ち会	立ち上	立上	立ち合	立合	起ち上
ただん	多段
ただれ	爛れ
ただよ	漂
ただや	多田屋
ただみ	只見
ただの	唯野	只野
ただす	匡
ただし	忠志	但し	正	惟史	忠	貞	忠司	忠史	直	禎	理	尚志	匡史	是	匡	正し
ただき	但木	只木
ただお	忠夫	忠雄	維男	忠男
ただい	多大	他大
たたん	多端	他端
たたり	祟
たたら	多田羅	多々良	踏鞴	蹈鞴
たたみ	疊	畳	疉	疂
たたに	田谷
たたど	多々戸
たたづ	佇
たたず	佇
たたき	三和土
たたか	戰	戦	斗	鬪	闘
たたえ	湛え	湛
たたい	多態	田多井	多胎	多体	田々井
たぞえ	田添	田副
たそく	多足
たそが	黄昏
たそう	多相	多層
たぜい	多勢
たせん	他薦
たずね	尋ね
たずな	手綱
たずさ	携	攜
たずき	方便	活計
たすけ	太助	助け	多助
たすく	弼	佑	輔	相	匡
たすき	襷
たすか	助か
たすう	多数
たじん	多人
たじり	田尻
たじめ	田治米
たじみ	多治見
たじま	田嶌	但馬	田島	田嶋
たじつ	他日
たじか	田近
たしん	他心	多芯
たしろ	田代
たしょ	他諸	他書	他所
たしゅ	他種	多種
たしゃ	他社	多謝	他者	他車
たしま	田嶋
たしな	窘	嗜
たしつ	咤叱	多湿
たしき	多識
たしか	確か
たしあ	足し合
たざん	他山
たざわ	田沢	田澤
たざけ	田酒
たざき	田崎
たざい	多罪
たさん	多産
たさつ	他殺
たさく	多作
たさき	田崎
たさか	田坂
たさい	多彩	多才
たごん	多言	他言
たごう	田郷
たこん	多恨
たこく	他国
たこう	多孔	他行	多項	他校	多幸
たげん	多言	他言	多元
たげい	多芸
たけん	他県	他見
たけや	竹弥	竹屋	武谷
たけみ	武見	武三
たけべ	武部	竹部	建部
たけふ	竹生	武生
たけの	武野	竹野
たけと	丈人	岳人	竹人	健人
たけつ	多血
たけち	武市	武智
たけだ	武田	竹田
たけた	竹田
たけじ	武治
たけし	武志	武史	剛	丈司	豪	剛志	剛史	健史	毅史	岳史	毅	威志	英	猛	武嗣	健志	丈史	健	武司	威	武士	岳	武	武石	竹志	毅之
たけこ	武子
たけき	健樹
たけお	竹生	武雄	健郎	威雄	武男	岳男	竹男	岳生	丈生	毅雄	武朗	丈夫	竹雄	健生	竹尾	健夫	武夫	竹夫
たけい	多形	竹居	武居	竹井	武井	他系	多型
たぐん	多群
たぐり	田栗
たぐち	田口
たぐす	田楠
たぐい	類い	疇	類	畴
たくわ	畜	貯	蓄
たくら	企	田倉
たくや	拓哉	卓也	卓弥	卓哉	琢也	拓也
たくみ	卓己	拓美	巧	琢弥	拓海	匠	内匠	琢巳	琢美
たくま	琢磨	託間	宅間	詫間	逞
たくぼ	田久保	田窪
たくふ	卓布
たくは	貯	蓄
たくと	琢人
たくち	宅地
たくじ	拓史	託児	卓爾	琢爾	卓治	拓嗣	卓司
たくし	拓志	卓子	卓史
たくき	琢己
たくお	卓雄	卓夫	拓雄
たくい	宅井
たぎり	田切
たぎご	多義語
たきや	滝谷
たきび	焚き火	焚火
たきの	瀧野	多喜乃	滝野
たきね	滝根
たきつ	焚き付
たきだ	瀧田
たきた	滝田	瀧田
たきし	薫き染
たきこ	炊込	薫き込	炊き込
たきぎ	薪
たきお	滝尾	多喜夫
たきい	滝井
たきあ	炊き上
たがん	多眼
たがわ	多川	田河	田川
たがや	畉	多賀谷	畊	耕
たがみ	田上
たがひ	違ひ	互
たがね	鏨
たがた	田方
たがく	多額
たがき	田垣
たがい	互い	互	違い
たかん	多感	多環
たから	寳	財	寶	宝
たかや	高屋	隆弥	隆也	高谷
たかめ	高目	高め
たかみ	高み	高見	孝美
たかべ	高部
たかぶ	昂	亢ぶ	昂ぶ
たかば	高場
たかは	鷹派	高羽	タカ派
たかの	鷹野	高野	高乃
たかね	高音	高値	高根	高嶺
たかに	高荷
たかな	高菜	高鳴
たかど	高止
たかつ	高津
たかだ	高田
たかた	田方	高田
たかせ	高瀬
たかす	高過	鷹栖	高鷲	高須
たかし	洪	隆史	尚司	高	貴士	降	高師	高士	鷹師	貴志	隆志	敬士	岳史	卓	貴史	高司	孝司	崇	崇史	高史	尚史	尚	隆	隆資	孝	孝史	卓史	隆司	恭士	孝志	敬	大	貴司	尚志	高志	敬史	喬	多加史	隆士	貴
たかさ	高さ
たかこ	隆子	貴子	孝子	高子	堂子	多賀子	敬子	多香子
たかく	高久	多角
たかぎ	喬木	高来	都木	鷹木	高城	高樹	高木
たかき	高来	孝紀	高樹	高木
たかか	多花果
たかお	高夫	孝夫	貴士	高雄	孚夫	鷹生	尚夫	貴夫	貴雄	隆雄	貴朗	孝雄	隆夫	孝男	高尾	貴男	崇夫	貴生	隆男
たかい	高井	他界
たおれ	殕	倒れ
たおか	田岡
たえま	絶えま	絶え間
たえは	絶え果
たえだ	絶え絶
たえず	絶えず
たえこ	多恵子	妙子
たえか	堪え兼
たえい	絶え入
たうら	田浦
たうち	田内
たうた	田歌
たうえ	田上	田植	田植え
たいん	多淫
たいわ	大和	対和	対話
たいろ	退路
たいり	大利
たいら	平ら	平
たいよ	貸与
たいむ	隊務
たいま	大麻	当麻
たいぼ	太母
たいほ	逮捕	退歩
たいぶ	体部	退部	大部
たいふ	大夫	大輔
たいひ	堆肥	退避	対比	待避	貸費
たいは	大破
たいど	大度	態度
たいと	泰斗
たいち	多一	対置	太一	対地
たいだ	怠惰
たいそ	太祖
たいじ	帯磁	泰司	泰次	胎仔	泰二	太地	対峙	退治	胎児
たいし	大史	大使	大志	大師	太子	対し	太史
たいざ	胎座	退座	対座
たいさ	大佐	大差
たいご	隊伍	対語	タイ語	大悟
たいこ	太鼓	奈子	大呼	鯛子	太古
たいげ	帯下
たいけ	大家
たいぐ	大愚
たいく	体躯
たいぎ	大義	体技	大儀
たいき	対気	大樹	待機	大気	大器
たいが	大河	胎芽
たいか	袋果	耐火	大廈	耐過	大厦	大火	大家	対価	退化	滞貨	大過	大化
たいい	胎位	体位	大尉	大意	退位
たいあ	体当
たあい	他愛
とんぷく	頓服
とんばら	頓原
とんにく	豚肉
とんとろ	豚トロ
とんでん	屯田
とんちき	頓痴気
とんぞく	遁俗
とんそく	豚足
とんそう	遁走
とんせい	遯世	遁世
とんじる	豚汁
とんじょ	東女
とんしょ	屯所
とんしゅ	頓首
とんしゃ	豚舎	頓写
とんこつ	豚骨
とんこう	遁甲	敦煌	燉煌
とんぐう	頓宮
とんかつ	豚カツ
とんえい	屯営
とわだし	十和田市
とわだこ	十和田湖
とわたり	門渡り
とれだか	取れ高
とれたて	取れ立て
とりわす	取り忘
とりわき	鳥脇
とりろう	鶏郎
とりよせ	取り寄せ	鳥寄せ
とりょう	塗料	斗量
とりやめ	取り止め
とりやま	鳥山
とりもの	捕物	捕り物
とりもど	取り戻
とりもち	取り持ち
とりむす	取り結
とりみだ	取り乱
とりまわ	取り回
とりまと	取り纏
とりまぎ	取り紛
とりまき	取り巻き	取巻き
とりまえ	取り前
とりぶん	取り分	取分
とりぶえ	鳥笛
とりひろ	取り広
とりひき	取り引き	取引
とりばし	取り箸
とりはら	取り払
とりはだ	鳥肌
とりはず	取り外
とりはこ	取り運
とりはか	取り計
とりのぞ	取除	取り除
とりのす	鳥の巣
とりのこ	取り残	鳥の子
とりのが	取り逃
とりにく	鶏肉	鳥肉
とりなお	撮り直	取り直	録り直
とりどり	取り取り
とりどし	酉年
とりとめ	取り留め
とりてん	鳥天
とりてき	取的
とりつぶ	取り潰
とりつけ	取付け	取付	取り付け
とりつく	取り尽
とりつぎ	取次ぎ	取次	取り次ぎ
とりちが	取り違
とりだし	取り出し	取出
とりだか	取り高	取高
とりだい	鳥大
とりたに	鳥谷
とりたて	取立	取り立て
とりたち	鳥達
とりそろ	取り揃
とりそこ	取り損
とりせつ	取説
とりしら	取り調	取調
とりしま	取り締	鳥島	取り締ま	取締
とりしき	取り仕切
とりざら	取り皿	取皿
とりざた	取りざた	取沙汰	取り沙汰
とりさわ	鳥沢	鳥澤
とりさば	取り捌
とりさげ	取下げ	取り下げ
とりさか	鳥坂
とりごや	鳥小屋
とりごえ	鳥越
とりこわ	取り壊
とりころ	取り殺
とりこみ	取込	取り込み
とりこぼ	取り零
とりこし	取り越し
とりけし	取消し	取り消し	取消
とりくみ	取り組み	取組	取組み
とりくち	取口
とりくず	取り崩
とりきめ	取り極め	取決め	取り決め
とりがら	鳥ガラ
とりがい	鳥飼	鳥貝
とりかわ	取り交	取交
とりかた	取り固	取り方
とりかじ	取り舵	取舵
とりかご	鳥籠
とりかこ	取り囲
とりかえ	取替え	取り返
とりかい	鳥飼
とりおと	取り落
とりおさ	取り抑
とりおき	取り置き
とりうむ	Th	Thorium
とりうみ	鳥海
とりうち	鳥打ち
とりいれ	取入れ
とりいる	取り入る
とりいそ	取り急
とりあわ	取り合
とりあつ	取り集
とりあげ	取り上げ
とらわれ	囚われ
とらふぐ	虎河豚
とらひめ	虎姫
とらひこ	寅彦
とらのこ	虎の子
とらねこ	虎猫
とらどし	寅年
とらとう	虎党
とらぞう	虎造	虎三
とらさん	寅さん
とらくす	寅楠
とらきち	虎吉	寅吉
とらがり	虎狩り	虎刈り
とらいち	寅市
とよやま	豊山
とよまる	豊丸
とよまつ	豊松
とよふみ	豊文	東洋史
とよふく	豊福
とよひろ	豊弘	豊広
とよひら	豊平
とよひと	十余一
とよひさ	豊久
とよひこ	豊彦
とよはら	豊原
とよはま	豊浜
とよはし	豊橋
とよのぶ	豊伸	豊信
とよなか	豊中
とよとみ	豊富	豊臣
とよとし	豊年
とよてつ	豊鉄
とよたま	豊玉
とよたし	豊田市
とよしま	豊嶋	豊島
とよしな	豊科
とよしき	豊四季
とよさわ	豊沢
とよさと	豊郷	豊里
とよさく	豊作
とよさき	豊崎
とよさか	豊栄
とよころ	豊頃
とよこう	豊高
とよくら	豊倉
とよくに	豊国
とよきち	豊吉
とよかわ	豊川
とよかず	豊和
とよおか	豊丘	豊岡
とようら	豊浦
とようち	豊内
とよあけ	豊明
とよあき	豊明
とゆうち	都有地
とやまし	富山市
とやかく	兎や角
ともよし	智由	友良	智義	知節	知義
ともゆき	友幸	知之	朋之	知行	共之	智之	智幸	智行	朋幸
ともやす	友康	朋康
とももり	知盛
ともみつ	伴光
ともみち	友道	伴通	智道
ともまつ	友松
ともまさ	智真
ともふさ	智英
ともびき	友引
ともひろ	智博	朋博	知宏	朋宏	智洋	智浩	友洋	智広	知浩	共洋	智弘	友広	恭祐
ともひと	智仁	智斉
ともひで	友秀	智秀	知英
ともひさ	知久	智久	朋久	友久
ともひこ	智彦	知彦	友彦	朋彦
ともはる	智春	知治
ともはな	友花
とものり	智紀	智則	友紀	智規	友則	知紀	智徳	知典	知徳
ともなり	共鳴り	友成
ともなが	友永	朝永	朝長
ともなか	邑中
ともども	共々
ともとし	智年
ともづり	友釣
ともづな	纜	繿
ともちか	朋哉	友近	知親
ともだち	友達
ともだお	共倒
ともたけ	智武
ともたか	友隆	智孝
ともぞう	友蔵
ともしび	灯火	燭	灯し火	灯	燈
ともざる	友猿
ともぐい	共食い
ともくに	友國
ともきよ	友清
ともきち	友吉
ともがら	讐	輩	讎
ともかせ	共稼
ともかず	智一	友和	共和	智和
ともおか	友岡
ともえり	共襟
ともえな	巴投
ともえだ	友枝
ともうら	共裏
ともいろ	共色
ともいち	友一
ともいし	友石
ともあき	智彰	智朗	恭章	公暁	智明	倫明	公明
とめやま	留山
とめべん	止め弁
とめそで	留袖
とめしょ	留所
とめぐん	登米郡
とめきち	留吉
とめがね	止め金	留金
とめおき	留置
とみよし	富吉
とみやま	富山
とみやす	富安
とみもと	富本
とみまつ	富松
とみひさ	富久
とみひこ	富彦
とみはり	富張
とみはま	富浜
とみなり	冨成
とみなが	冨永	富永
とみとく	富徳
とみしろ	都城
とみしま	富島
とみざわ	富澤	富沢
とみさわ	冨沢	富沢
とみさと	富里
とみくじ	富籤
とみかわ	富川
とみおか	冨岡	富岡
とみうら	冨浦	富浦
とみあい	富合
とまりこ	泊まり込
とまりぎ	止り木
とままえ	苫前
とまべち	苫米地
とましの	苫篠
とぶとり	飛ぶ鳥
とぶすま	戸襖
とぶくろ	戸袋
とふけん	都府県
とびわし	飛鷲
とびらえ	扉絵
とびまわ	飛び回
とびばこ	飛び箱
とびとび	飛び飛び
とびすさ	飛び退
とびしま	飛島
とびさき	飛先	飛び先
とびこみ	飛び込み
とびげり	飛び蹴り
とびぐち	鳶口
とびきり	飛切り
とびおり	飛び降り
とびおか	飛岡
とびうお	飛魚
とびいろ	鳶色
とびいり	飛び入り	飛入り
とびいし	飛び石	飛石
とびある	飛び歩
とばやま	鳥羽山
とばどの	鳥羽殿
とばせん	鳥羽線
とばくち	とば口
とばえき	鳥羽駅
とはいえ	とは言え
とのさま	殿様
とのさき	外崎
とのがた	殿方
とのおか	外岡
とのうち	登内
とねやま	刀根山
とねぐん	利根郡
とねがわ	利根川
とにゅう	吐乳
とにかく	兎に角
となりあ	隣合	隣り合
となかい	馴鹿
とどろき	轟	轟き	等々力	軣
とどめる	閼
とどまつ	椴松	椴
とどこお	滯	滞
とどけで	届け出	届出
ととりべ	鳥取部
ととのえ	整
ととさま	父様
とつめん	凸面
とつほう	凸包
とつべん	訥弁
とつとつ	咄々	吶々	訥訥	訥々
とつでん	凸電
とつぜん	突然
とつじょ	突如
とつげき	突撃	突激
とつがわ	十津川
とつがた	凸型
とつかわ	十津川
とつかく	戸塚区
とつおう	凸凹
とっぷつ	突沸
とっぷう	突風
とっぱん	凸版
とっぱら	取っ払
とっぱつ	突発
とっとり	鳥取
とってか	取って代
とってお	取って置
とってい	突堤
とっつか	取っ捕
とったん	突端
とっしん	突進
とっこつ	突兀
とっこう	特攻	特効	徳行	特高
とっけん	特研	特権
とっけつ	突厥
とっけい	特恵
とっくん	特訓
とっくり	徳利
とっきょ	特許
とっかん	吶喊	突貫
とっかく	突角
とっかか	取っ掛
とっかい	特会	特快	特解
とちょう	登頂	都庁
とちゅう	途中
とちもと	栃本
とちない	栃内
とちっこ	土地っ子
とちだい	土地代
とちざわ	栃沢
とちぎし	栃木市
とちがら	土地柄
とちかん	土地勘
とちかわ	橡川
とそうぶ	塗装部
とそうご	塗装後
とそうき	塗装機
とじょう	屠場	外城	登城	途上	図情
とじまり	戸締り
とじほん	綴本
とじぶた	綴じ蓋
とじしろ	綴じ代
とじこも	閉じ籠
とじこみ	綴じ込み
とじいと	綴じ糸
としんぶ	都心部
としんち	都心地
としわか	年若
としろう	利郎	俊朗	敏郎	俊郎
としよわ	年弱
としより	年寄り	年寄
としょひ	図書費
としょく	徒食	塗色
としゆき	俊行	敏幸	俊之	利幸	敏之	敏行	利行	歳之	利之	俊幸
としゅつ	吐出
としやす	敏康	敏靖	利泰
としめい	都市名
としみつ	俊光	利光	敏光
としみち	季道	利通	利道	俊道
としまさ	敏正
としまく	豊島区
としほど	年程
としふみ	年史	敏文	俊文	俊史
としふさ	俊房
としひろ	敏宏	俊弘	俊宏	敏裕	利宏	利弘	利浩	敏啓	俊裕	利博	敏弘	歳弘	利広	俊博	俊浩
としひと	敏仁
としひで	俊秀	俊英
としひさ	俊久	利久	敏寿
としひこ	俊彦	壽彦	稔彦	利彦	捷彦	年彦	敏彦	寿彦
としはる	利治	敏治	季栄	俊治	寿晴
としのり	聡徳	俊範	敏規	寿則	利則	利典	年紀	敏憲	俊則	敏則
としのよ	年の夜
としのぶ	利信	敏伸	利伸
としのは	年の端
としのせ	歳の瀬	年の瀬
としなり	利成
としなみ	年波
としなお	利直	俊直
としない	都市内
としてる	敏輝
としづよ	年強
としつぐ	俊嗣	敏嗣	壽二
としつき	年月
としちず	都市地図
としだま	年玉
としだか	年高
としたに	利谷
としただ	利忠	俊匡
としたか	俊孝	利孝	敏隆
としぞう	俊三
としした	年下
とししげ	利重
としごろ	年頃
としごと	年毎
としこし	年越し
としけん	都市圏
としくに	年邦
としがた	都市型
としがす	都市ガス
としがい	都市外	年甲斐
としかん	都市間
としかつ	敏克	利勝
としかず	利和	寿和	敏一	寿一	俊一	敏和	利一	俊和
としかさ	年嵩
としうえ	年上
としあけ	年明け
としあき	利明	壽	俊章	寿明	敏朗	俊朗	俊昭	聡明	利昭	敏明	敏彰	年昭	敏昭	繁明	俊彰	俊明
とざんき	登山記
とさやま	土佐山
とさっこ	土佐っ子
とさけん	土佐犬
とさいぬ	土佐犬
ところせ	所狭
ところが	処が
とこやま	床山
とこぶし	常節
とこはる	常春
とこのま	床の間	床ノ間
とこなめ	常滑
とこなつ	常夏
とこつち	床土
とこずれ	床擦れ
とこしき	床敷
とこしえ	永久	常しえ
とこうひ	渡航費
とこいた	床板
とこあげ	床上げ
とげぬき	刺抜き
とげとげ	刺刺	刺々
とげうお	棘魚
とけいや	時計屋
とけいざ	時計座
とくわり	特割
とくろん	特論
とくれい	督励	特例
とくりつ	特立
とくよう	特用	徳用	特養
とくゆき	徳行	得之
とくゆう	特有	特融
とくやま	徳山
とくやす	徳康
とくやく	特約
とくもり	特盛
とくもと	徳元	徳本
とくもく	徳目
とくめい	特命	匿名
とくみつ	徳光
とくみち	篤道
とくまる	徳丸	得丸
とくぼう	徳望
とくほん	読本
とくほう	特報
とくべつ	特別
とくへい	徳平
とくひろ	徳弘
とくひら	徳平
とくひつ	特筆
とくひさ	徳久
とくばん	特番
とくばら	特払
とくばい	特売
とくはら	徳原
とくはつ	特発
とくはし	徳橋
とくはい	特配
とくのう	篤農
とくにん	特認	特任
とくなが	徳永
とくない	都区内
とくどう	得道
とくとみ	徳冨	徳富
とくとく	得々
とくとう	特等	禿頭
とくでん	特電
とくてん	特典	特点	得点
とくてい	特定
とくだん	特段
とくだね	特種	特ダネ
とくだい	特大
とくたい	特待
とくぞう	徳蔵
とくそん	特損
とくそく	督促
とくそう	特装	特捜	徳操	禿瘡	得喪
とくせん	特撰	特選	特薦	特専	督戦
とくせつ	特設
とくせい	徳政	徳星	徳性	涜聖	特性	特製
とくずき	特漉き
とくじん	徳人
とくじゅ	特需
とくじつ	篤実
とくしん	得心	篤信	特進	得真	涜神
とくしゅ	特種	特殊
とくしゃ	特赦	特写	特車
とくしま	徳島
とくしつ	得失	特質
とくしか	篤志家
とくさん	特産
とくさわ	徳沢
とくさつ	特撮
とくさく	得策
とくこう	特高
とくぐん	督軍
とくがわ	徳川
とくがく	督学	篤学
とくがき	徳垣
とくおか	徳岡
とくえい	徳衛
とくいび	特異日
とくいち	特異値	徳一
とくいげ	得意気
とくいく	徳育
とぎゃく	吐逆
とぎもの	研ぎ物
とぎまち	富来町
とぎせん	都議選
とぎじる	磨ぎ汁
とぎかい	都議会
ときわず	常磐津
ときわざ	常盤座
ときわぎ	常磐木
ときょう	都響
ときもの	解き物
ときめく	時めく
ときまさ	常正
ときほぐ	溶き解
ときひろ	時弘	時広
ときはな	解き放
ときなし	時無し
ときどき	時時	時々
ときとう	時任
ときたま	時偶
ときざわ	鴇沢
ときさだ	時貞
ときぐし	解き櫛
ときがわ	都幾川
ときがり	時借り
ときがし	時貸し
ときかた	解き方
ときおり	時折	時おり
ときおか	時岡
ときえだ	時枝
ときいろ	鴇色
とがのお	栂尾
とがにん	咎人
とがくし	戸隠
とがうち	戸河内
とかしき	渡嘉敷
とかげざ	蜥蜴座
とかいは	都会派
とかいか	都会化
とおりま	通り魔
とおりね	通り値
とおりぬ	通り抜
とおりな	通り名
とおりす	通り過
とおりこ	通り越
とおりが	通り掛
とおやま	遠山
とおまわ	遠回
とおまき	遠巻き
とおぼえ	遠吠え	遠吠
とおのり	遠乗り
とおなり	遠鳴り
とおちか	遠近
とおぜめ	遠攻め
とおざか	遠ざか
とおえん	遠縁
とおあさ	遠浅
とうわく	当惑
とうろん	闘論	討論
とうろく	登録
とうろう	燈篭	螳螂	蟷螂	燈籠	灯籠
とうれい	答礼
とうるい	盗塁	糖類
とうりん	登臨
とうりつ	倒立	頭立
とうらく	騰落	当落
とうらい	到来	当来
とうよこ	東横
とうよく	東翼
とうよう	蕩揺	東洋	投用	陶窯	当用	陶俑	盗用	陶遥	頭葉	東陽	登用
とうやま	當山	遠山	当山
とうやこ	洞爺湖
とうやく	投薬	当薬	湯薬
とうもつ	唐物
とうもく	頭目
とうもう	投網
とうめん	等面	当面	東面
とうめい	東名	透明
とうむら	東村
とうみん	島民	冬眠
とうみつ	糖蜜
とうぼく	冬木	唐木	透木	倒木
とうぼう	逃亡
とうほん	謄本	唐本
とうほく	東北
とうほう	東宝	東方	答砲	当方	答訪	東邦	桐朋	投法	等方
とうべん	答弁
とうべつ	当別
とうへん	陶片	等辺
とうへき	東壁	盗癖
とうへい	東平
とうぶん	糖分	当分	等分
とうぶつ	唐物
とうふや	豆腐屋
とうふく	東福	等幅
とうふう	東風	党風	唐風
とうひん	盗品
とうばん	登板	当番
とうばつ	倒伐	盗伐	党閥	討伐
とうばく	倒幕	討幕
とうばい	等倍	当倍
とうはん	登坂	東阪	東版	東販	盗犯	登攀
とうはば	等幅
とうはと	東鳩
とうはつ	頭髪
とうはく	東伯	等伯
とうねん	当年
とうにん	当人
とうにち	東日
とうなん	盗難	東南
とうなす	唐茄子
とうない	頭内	東内	党内
とうどり	頭取
とうどく	東独
とうどう	藤堂	東道	東堂
とうとつ	唐突	頭突
とうとう	等等	疾う疾う	滔滔	等々	東陶	東塔	滔々	蕩蕩	丁丁	到頭	登登	陶陶	鼕鼕	偸盗	滔
とうでん	盗電	東電
とうてん	読点	当店	東天
とうてつ	透徹	饕餮
とうてき	投擲
とうてい	到底
とうつき	当月
とうつう	疼痛	頭痛	東通
とうちゃ	闘茶
とうちく	東筑
とうちか	統治下
とうだん	当団	登壇
とうだい	当代	東大	燈台	灯台	東京大学	東台
とうたん	東端
とうたつ	到達
とうたく	董卓
とうぞく	盗賊
とうそん	藤村
とうそつ	統率
とうそく	等速	党則	頭側
とうそう	痘瘡	鬪爭	党争	逃走	闘争
とうぜん	當然	陶然	当前	当然
とうせん	東遷	当籤	頭線	陶染	唐船	東線	当選	盗泉
とうせつ	当節
とうせき	等積	投石	党籍	透析
とうせい	東征	統制	籐製	冬青	騰勢	陶製	当世	倒生	党勢
とうすぽ	東スポ
とうすけ	東介	藤輔
とうすう	頭数
とうすい	陶酔	統帥	透水
とうじん	刀刃	陶人	唐人	党人	蕩尽
とうじょ	唐書	倒叙
とうじゅ	東樹	藤樹
とうじば	湯治場
とうじつ	当日	冬日
とうじき	陶磁器
とうしん	投信	等親	投身	灯心	答申	闘神	東伸	等身	頭身	東進	刀身
とうしょ	当初	島嶼	投書	当所	頭書	当処
とうしゅ	当主	党首	頭首	投手
とうしゃ	投射	謄写	謄寫	当社	透写
とうしば	東芝
とうしど	透視度
とうしつ	糖質	等質
とうしき	等式
とうしか	投資家
とうざん	頭山	唐山	当山
とうざい	東西
とうさん	倒産	父さん	東讃
とうさま	父様
とうさつ	盗撮	透察
とうさく	倒錯	盗作	東作
とうさい	登載	当歳	搭載	統裁
とうごく	東国	投獄	当国
とうごう	等号	＝	投合	統合	東郷
とうこん	刀痕	当今	闘魂
とうこつ	頭骨	橈骨
とうこく	透谷
とうこう	東光	等高	陶工	投光	投降	登高	東耕	刀工	東郊	登校	投稿	東工
とうげん	桃源
とうげつ	当月
とうげい	陶芸
とうけん	刀剣	当権	陶甄	東建	闘犬
とうけつ	凍結	盗血
とうけい	統計	闘鶏	倒景	東経
とうぐう	東宮
とうくつ	盗掘
とうぎん	当今
とうぎり	当限
とうぎょ	統御
とうきん	陶鈞
とうきぼ	登記簿
とうきび	唐黍
とうきち	藤吉
とうきじ	当記事
とうがん	冬瓜	東岸
とうがね	東金
とうがく	唐楽
とうがい	等外	頭蓋	凍害	当該	頭外
とうかん	統監	当館	等閑	投函	凍寒
とうかつ	統轄	統括
とうかく	当確	頭角	等角	等覚	倒閣
とうかき	等化器
とうかい	倒壊	倒潰	韜晦	当会	東海
とうおん	等温	唐音
とうおく	塔屋
とうおう	陶泓	東欧
とうえん	登園	遠縁
とうえい	投影	東永	東映	灯影	東栄	倒影
とううん	東雲
とううつ	陶鬱
とういん	党員	当院	桐蔭	頭韻	東員	登院
とういも	唐芋
とういつ	統一
とういち	東一
とういす	籐椅子
とういく	陶育
とうあん	答案
とうあつ	等圧
といめん	対面
といなお	問い直	問直
といとい	対々
といただ	問い質
といかえ	問い返
といあわ	問い合わ	問合
てんろく	天六
てんれつ	点列
てんれい	典例	典礼	典麗
てんりん	転輪
てんりし	天理市
てんらん	展覧	天覧
てんらく	顛落	転落
てんらい	天来
てんよう	転用
てんゆう	天祐	天佑
てんやく	点薬	点訳
てんもん	天文
てんもく	天目
てんもう	天網
てんめん	纏綿
てんめつ	点滅
てんめい	天明	店名	天命
てんむす	天むす
てんまん	天満
てんまや	天満屋
てんまど	天窓
てんまつ	天松	顛末
てんまく	天幕
てんぽん	点本
てんぽう	天保	天方
てんぼう	点棒	展望
てんほう	天和
てんほー	天和
てんぺん	天辺	転変	天変
てんべつ	点別
てんぷら	天ぷら	天麩羅
てんぷく	顛覆	天福	転覆
てんぶん	篆文	天分	天文
てんぶつ	典物	天物
てんぴん	天稟
てんびん	天秤
てんびき	天引き
てんぱん	典範	天板
てんぱく	天白	天伯
てんぱい	聴牌	顛沛
てんばん	天板
てんばつ	天罰
てんばい	転売
てんはく	天白
てんのう	天皇	天王
てんねん	天然
てんにん	天人	転任
てんにょ	天女
てんない	店内
てんどん	天丼
てんどく	顛読	点読
てんどう	天道	天童	天堂	天動
てんとり	点取り
てんとく	転得
てんとう	転倒	点灯	天道	纏頭	店頭	点燈	顛倒
てんてん	短点	．．．	点々	：	・・・	転々	……	展転	輾転	‥	…
てんてき	点滴	天敵
てんてい	点綴	天帝
てんつい	点対
てんちゃ	点茶
てんだい	天台
てんたん	恬淡
てんたく	転宅
てんたい	転貸	天体
てんぞく	転属
てんぞう	点像
てんそば	天蕎麦
てんそく	纒足	店則	纏足	天測	典則
てんそう	転送
てんぜん	典膳	恬然
てんせん	転線	転戦	点線
てんせき	転籍	転石	典籍
てんせい	転成	展性	天性	点睛	天成	転生
てんずみ	点炭
てんすう	点数
てんすい	天水
てんじん	天神	天人
てんじょ	天助
てんじゅ	天寿	天授
てんじゃ	点者
てんじつ	天日
てんじく	天竺
てんしん	点心	転身	転進	天真	天心	天津
てんしょ	転所	添書	典書	篆書
てんしゅ	天主	天守	店主
てんしゃ	転写	転社
てんしつ	天質
てんしち	転質
てんしじ	点支持
てんしげ	天繁
てんしき	点式
てんざん	天山
てんざい	点在
てんさん	天蚕
てんさく	添削	転作
てんさい	天際	甜菜	天才	転載	天災
てんごく	典獄	天国
てんこも	天こ盛
てんこく	転告	篆刻
てんこう	転校	天候	転向	典孝	天功
てんげん	天元	点源
てんけん	点検	天険
てんけつ	転結	点穴
てんけい	点景	天啓	添景	天恵	典型
てんぐさ	天草
てんぐう	天宮
てんくう	天空
てんぎく	天菊
てんきん	転勤
てんきょ	転居	典拠
てんきや	天気屋
てんきぼ	点鬼簿
てんきず	天気図
てんがん	天眼	点眼
てんがく	転学
てんがい	天外	天蓋	天涯
てんかん	展観	癲癇	転換	点間	転官
てんかわ	添川
てんかす	天滓
てんかご	添加後
てんかい	展開	転回	天界	天海
てんおん	転音	天恩
てんおう	天王
てんえん	展延
てんえい	天永	天栄
てんうん	天運
てんいん	転院	店員
てんいり	点入
てんいち	天一
てわたし	手渡し
てれとう	テレ東
てれくさ	照れ臭
てれあさ	テレ朝
てるゆき	輝之	輝幸
てるやす	輝泰
てるもと	輝元
てるひろ	照洋
てるひさ	照久
てるひこ	照彦	照比古	輝彦
てるのり	照則
てるのぶ	晧史	照信	輝暢
てるたか	照貴
てるあき	輝明
てりやす	輝泰
てりやき	照り焼き
てりかえ	照り返
てらやま	寺山
てらもと	寺元	寺本
てらむら	寺村
てらまち	寺町
てらまえ	寺前
てらにし	寺西
てらそま	寺杣
てらせん	寺銭
てらじま	寺島
てらしま	寺島	寺嶋
てらした	寺下
てらしあ	照し合
てらさわ	寺沢	寺澤
てらさき	寺崎
てらさか	寺坂
てらごや	寺小屋
てらこや	寺子屋
てらくら	寺倉
てらがわ	寺側
てらかわ	寺川
てらかど	寺門
てらかた	寺方
てらおか	寺岡
てらうち	寺内
てやわら	手柔
てみやげ	手土産
てみじか	手短
てまわり	手回り
てまわし	手回し
てまひま	手間暇
てまねき	手招き
てまちん	手間賃
てまだい	手間代
てまくら	手枕
てほどき	手解き
てぶそく	手不足
てぶくろ	手袋
てびかえ	手控え
てばなれ	手離れ
てばなし	手放し
てばさき	手羽先
てはじめ	手始め
てはいし	手配師
てのもの	手の物
てのひら	手の平	掌
てのなか	手の中
てのこう	手の甲
てのうち	手の内
てぬぐい	手拭	手拭い	手ぬぐい
てぬかり	手抜かり
てにをは	天爾遠波
てにもつ	手荷物
てにはい	手に入
てならい	手習	手習い
てなおし	手直し
てどうさ	手動作
てづまり	手詰まり	手詰り
てづくり	手作り
てづかみ	手掴み
てつわん	鉄腕	鉄椀
てつろう	哲郎	哲朗	鉄郎	徹郎
てつりん	鉄輪
てつゆき	徹行	徹之
てつやあ	徹夜明
てつもん	鉄門
てつめん	鉄面
てつまん	徹マン
てつまど	鉄窓
てつぼう	鉄棒
てつぶん	鉄分
てつぶろ	鉄風炉
てつびん	鉄瓶
てつひろ	哲弘	哲宏
てつひと	鉄一	鉄人
てつのり	哲憲
てつなべ	鉄鍋
てつどう	鉄道	鐵道
てつづき	手続き	手続
てつだい	手伝い
てつせい	鉄製
てつじん	鉄人	哲人
てつしん	鉄芯
てつざん	鉄山
てつざい	鉄剤	鉄材
てつけん	鉄研
てつくず	鉄屑
てつがく	哲学
てつかず	手付かず	手着かず
てついろ	鉄色
てついち	鉄一
てつあき	哲明
てっぽう	鉄砲
てっぺん	天辺	鉄片
てっぺき	鉄壁
てっぺい	撤兵	鉄平
てっぷん	鉄粉
てっぴつ	鉄筆
てっぱん	鉄鈑	鉄板
てっぱつ	鉄鉢
てっぱい	撤廃
てっとう	鉄塔
てってい	徹底
てっつい	鉄槌	鉄鎚
てったい	撤退
てっそく	鉄則
てっせん	鉄扇	鉄線
てっせき	鉄石
てっせい	哲西	鉄製
てっさく	鉄柵	鉄索
てっこつ	鉄骨
てっこう	鐵鋼	手甲	鉄鋼	鉄甲	鐵鉱	鐵工	鉄工	鉄鉱
てっけん	鉄拳	鉄建	鉄研	鉄剣
てっけつ	鉄血	剔抉
てっきん	鉄琴	鉄筋
てっきょ	撤去	剔去
てっかん	鉄管
てっかば	鉄火場
てっかく	適格	的確
てっかい	撤回
てちょう	手帳	手帖
てちがい	手違い
てだすけ	手助け
てそうみ	手相見
てすさび	手遊び
てじょう	手錠
てじゅん	手順
てじゃく	手酌
てじなし	手品師
てしろぎ	手代木
てしょく	手職	手燭
てしごと	手仕事
てしかが	弟子屈
てざわり	手触り
てざいく	手細工
てさばき	手捌き
てさぐり	手探り
てごたえ	手応え
てごころ	手心
てこいれ	てこ入れ	テコ入れ	梃入れ
てぐすね	手ぐすね	手具脛	手薬煉
てぐさり	手鎖
てくばり	手配り
てきろく	摘録
てきれい	適例	適齢
てきるい	敵塁
てきよう	摘要	適用
てきやく	適薬	適訳	適役	敵役
てきめん	覿面
てきほう	適法
てきへい	敵兵
てきはつ	摘発
てきはい	敵背
てきにん	適任
てきとう	適当
てきてい	滴定
てきだん	擲彈	擲弾	敵弾
てきたい	敵対
てきそん	劇村
てきぜん	敵前
てきせつ	適切
てきせい	適性	適正	敵性
てきじん	敵陣
てきじょ	摘除	滌除
てきじだ	適時打
てきしん	摘心
てきしょ	適所
てきしゅ	敵手
てきしゃ	適者	敵車
てきしつ	敵失
てきざい	適材
てきさく	適作
てきさい	適才
てきごう	適合
てきこく	敵国
てきげん	適言
てきぐん	敵軍
てきがわ	敵側
てきがた	敵方
てきかん	敵艦
てきかた	敵方
てきかく	適確	適格	的確
てきおん	適温
てきおう	適応
てきえい	敵影
てがぬま	手賀沼
てがたな	手刀
てがかり	手掛かり	手がかり	手掛り
てかげん	手加減
てかがみ	手鏡	手鑑
ておくれ	手遅れ
ていろん	定論
ていれん	低廉
ていれつ	貞烈	低劣
ていれい	定例
ているい	涕涙
ていりつ	定率	挺立	鼎立	定立	定律	低率
ていりき	禎力
ていらく	低落
ていよく	低翼	体良く
ていよう	定容	提要
ていやく	定訳	締約
ていもう	剃毛
ていめん	底面
ていめい	低迷	締盟
ていまい	弟妹
ていぼく	低木
ていぼう	堤防
ていほん	底本	定本
ていへん	底辺
ていふく	定幅
ていふか	低負荷
ていばん	定番	定版
ていばつ	挺抜
ていはつ	剃髪
ていはく	停泊	碇泊
ていはい	停廃
ていのう	低能
ていねん	丁年	停年	定年	諦念
ていねい	丁寧
ていない	廷内	庭内	邸内
ていとん	停頓
ていとく	提督	帝徳
ていとう	抵当	低頭	低糖	提灯
ていでん	停電	遞傳
ていてん	定点
ていてつ	蹄鉄
ていてい	廷丁	亭々
ていだん	梯団	低段	鼎談
ていだい	提題	帝大
ていたく	邸宅
ていたい	手痛い	定退	堤体	停滞
ていぞく	低俗
ていぞう	貞蔵	逓増
ていそく	低速	定則
ていそう	貞操	低層	底層	逓送
ていぜん	庭前	挺然
ていせん	停船	停戦
ていせつ	挺節	貞節	定説
ていせき	艇積	定石
ていせい	訂正	帝政	貞静	帝制	定性	低声
ていすう	艇数	定数
ていじん	帝人
ていじろ	丁字路
ていじょ	貞女
ていじぶ	提示部
ていじつ	定日
ていじご	定時後
ていしん	挺身	定進	艇身	逓信	廷臣	挺進	遞信
ていしょ	低所
ていしゅ	亭主	艇首
ていしゃ	停車
ていしつ	低質	帝室	廷叱	低湿
ていしじ	停止時
ていしき	程式	定式
ていざん	定残	低山
ていさん	帝産
ていさつ	偵察
ていさく	定朔
ていさい	体裁
ていこく	帝國	定刻	帝国
ていこう	低高	定項	抵抗
ていげん	提言	低限	低弦	定限	低減	逓減
ていけん	定見	定検
ていけつ	貞潔	締結	挺傑
ていけい	梯形	提携	定形	定型
ていくう	低空
ていぎん	帝銀
ていぎぶ	定義部
ていぎづ	定義付
ていきん	提琴
ていきど	低輝度
ていがく	低額	定額	停学
ていかん	停刊	定感	諦観	定款	帝冠
ていかく	定格	底角
ていかい	停会	低徊
ていおん	定温	低温	低音
ていおう	帝王
ていえん	庭園	定演
ていうん	低運
ていいん	定員
ていいど	低緯度
ていいち	貞一	禎一	定位置
ていいき	低域
ていあん	提案
ていあつ	定圧	低圧
てぃじろ	T字路	Ｔ字路
てあわせ	手合せ	手合わせ
てあらい	手洗い	手洗
てあぶり	手焙り
てあたり	手当たり	手当り
てあそび	手遊び
つんどく	積讀	積ん読	積読
つわもの	強者	兵
つわぶき	石蕗
つれもど	連れ戻
つれてき	連れて来
つれづれ	徒然
つれかえ	連れ帰
つれあい	連合い
つるやま	鶴山
つるみず	鶴水
つるみく	鶴見区
つるまき	鶴巻	弦巻
つるまい	鶴舞
つるふじ	鶴藤
つるばみ	橡
つるはし	鶴橋	鶴嘴
つるはぎ	鶴脛
つるぞう	鶴蔵
つるしま	鶴島
つるしあ	吊るし上
つるさき	鶴崎
つるこう	鶴光
つるくさ	蔓草
つるがや	鶴ヶ谷
つるかわ	鶴川
つるかめ	鶴亀
つるおか	鶴岡
つるいち	鶴一
つりもと	釣元
つりぼり	釣り堀	釣堀
つりほう	釣法
つりぶね	釣舟	釣り舟	釣船	釣り船
つりびと	釣人	釣り人
つりばり	釣り針	釣針
つりばし	吊り橋	吊橋
つりどの	釣殿
つりだし	吊り出し
つりたに	釣谷
つりせん	釣銭
つりしょ	釣書
つりざお	釣り竿	釣竿
つりごし	釣り輿
つりぐや	釣具屋
つりがね	釣り鐘	釣鐘
つりがき	釣書
つりかわ	吊り皮	吊革	釣り革
つりかた	釣り方
つりうむ	Tm	Thulium
つりいと	釣り糸	釣糸
つりあい	釣り合い	釣合
つらよご	面汚
つらゆき	貫之
つらなり	連なり
つらだし	面出し
つらがま	面構
つらあて	面当て
つよごし	強腰
つゆほど	露程
つゆはら	露払
つゆはし	露橋
つゆどき	梅雨時
つゆぞら	梅雨空
つゆじも	露霜
つゆざむ	梅雨寒
つゆごろ	梅雨頃
つゆくさ	露草
つゆいり	梅雨入
つゆあけ	梅雨明け	梅雨明
つやもの	艶物
つやぶみ	艶文
つやだし	ツヤ出し	艶出	艶出し	つや出し
つやざき	津屋崎
つやごと	艶事
つやけし	つや消し	艶消し	艶消
つもほう	自模和
つめもの	詰物	詰め物
つめばら	詰め腹	詰腹
つめすじ	詰筋
つめしょ	詰所
つめさき	爪先
つめきり	爪切り
つめかえ	詰め替え
つめえり	詰襟
つめいん	爪印
つめあわ	詰合
つめあと	爪痕
つむがり	都牟刈
つむがた	紡錘形
つみぶか	罪深
つみびと	罪人
つみのこ	積み残
つみなお	積み直
つみとが	罪科
つみたて	積立	積立て
つみごえ	積肥
つみこみ	積み込み
つみくさ	摘み草
つみきん	積み金	積金
つみかさ	積み重	積重
つみかえ	積み替え
つみいれ	摘入れ
つみあげ	積み上げ
つまみな	摘まみ菜
つまみだ	撮み出
つまみぐ	撮み食
つまべに	爪紅
つまびき	爪弾き
つまはじ	爪弾
つまどり	褄取り
つまさき	爪先	つま先
つまごい	嬬恋	妻恋	つま恋
つまおと	爪音
つぼはち	つぼ八
つぼにわ	坪庭
つぼだけ	坪岳
つぼすう	坪数
つぼさき	坪崎
つぼくら	坪倉
つぼかわ	坪川
つぼうち	坪内
つぶらや	円谷
つぶより	粒選り
つぶやき	呟き
つぶひと	粒一
つぶぞろ	粒揃
つぶさに	具に	悉に	備に
つぶさき	粒崎
つぶぎん	粒銀
つぶあん	粒餡	粒あん
つばもと	鍔元
つばくろ	燕
つばきか	ツバキ科	Theaceae
つばきい	椿井
つはもの	兵
つのまた	角叉
つのへん	角偏
つのぶえ	角笛
つのはず	角筈
つのがら	角柄
つのがみ	角髪
つのがき	角書
つのがい	角皆
つのおか	角岡
つねよし	常吉	恒吉	恒美
つねゆき	恒行	常幸
つねやす	常安	経康
つねもり	常森
つねまさ	恒正
つねひろ	常廣	常広	恒博	恒宏
つねひら	恒平
つねひこ	恒彦
つねはる	常晴
つねのり	恒憲
つねなみ	常並
つねなが	常長
つねとよ	常豊
つねとし	種敏	恒敏
つねとう	恒任	恒藤
つねづね	常々
つねたけ	典武	恒毅
つねずみ	常澄
つねきよ	経清
つねきち	常吉
つねかわ	恒川
つねあき	常明
つなわた	綱渡
つなひき	綱引き
つなしま	綱嶋	綱島
つなぎめ	繋ぎ目
つなぎと	繋ぎ止
つなぎこ	繋ぎ込
つなぎか	継ぎ換
つなかん	ツナ缶
つとめて	努めて
つとめあ	勤め上
つづりじ	綴り字
つづらこ	葛籠
つづけじ	続け字
つつみこ	包み込
つつぬけ	筒抜け
つつなか	筒中
つつそで	筒袖
つつさき	筒先
つつぐち	筒口
つつぎり	筒切り
つつがな	恙無
つつおと	筒音
つっぱな	突っ放
つっぱし	突っ走
つっこみ	突込み	突っ込み
つっかえ	突っ返
つちろう	土牢
つちよせ	土寄せ
つちやま	土山
つちもと	土本
つちもち	土持
つちむろ	土室
つちへん	土偏
つちばし	土橋
つちはし	土橋
つちのと	己
つちのえ	戊
つちとい	土樋
つちざき	土崎
つちぐり	土栗
つちぐも	土蜘蛛	蝪
つちくれ	土塊	土くれ
つちかわ	土川
つちかべ	土壁
つちおと	槌音
つちうら	土浦
つちいろ	土色
つだぬま	津田沼
つたない	拙い
つたえき	伝え聞
つじもと	辻本	辻元
つじむら	辻村
つじどう	辻堂
つじつま	辻褄
つじした	辻下
つじさわ	辻沢
つじぎり	辻斬り
つじぎみ	辻君
つじかわ	辻川
つじおか	辻岡
つじうら	辻占
つしまく	津島区
つごもり	晦
つげぐち	告げ口
つけわす	付け忘
つけやき	付け焼き
つけもの	漬け物	漬物
つけまわ	付け回
つけぶみ	付け文
つけびと	付け人
つけひげ	付け髭
つけねら	付け狙
つけづめ	付け爪
つけたし	付け足し
つけくわ	付け加
つけかた	付け方
つけかえ	付替
つけおち	付け落ち
つけうま	付け馬
つけあわ	付け合
つけあい	付合
つぐのぶ	嗣信
つぐとも	嗣智	嗣朋
つぐとし	次利
つくろい	繕い	繕
つくりて	作り手
つくりつ	作り付
つくりだ	作り出
つくりこ	作り込
つくりか	作り替
つくりお	作り置
つくりあ	作り上
つくよみ	月讀み
つくぼう	突棒
つくばね	筑波嶺
つくばし	つくば市	筑波市
つくづく	熟々	熟
つくだに	佃煮
つくいこ	津久井湖
つぎもの	継ぎ物
つぎはぎ	継ぎ接ぎ
つぎのま	次の間
つぎつぎ	次々
つぎきれ	継切
つぎがみ	継紙
つきわり	月割
つきよの	月夜野
つきよだ	月夜田
つきゆび	突き指
つきやま	築山
つきやぶ	突き破
つきやく	月役
つきもり	月森
つきもの	憑き物	つき物	付物	付き物
つきまと	付き纏
つきまち	月待ち
つきぼし	月星
つきべつ	月別
つきへん	月偏
つきびと	付き人	付人
つきひめ	月姫
つきばん	月番
つきばら	月払
つきはな	突き放
つきはじ	月始	月初
つきのわ	月の輪
つきのき	槻木
つきなみ	月並	槻並	月次
つきとお	突き通
つきづき	月々
つきだて	月舘	築館
つきだし	突き出し
つきたて	月舘
つきそう	付き添う
つきそい	付添い	付添	付き添い
つきずえ	月末
つきすす	突き進
つきすう	月数
つきしま	月島
つきさむ	月寒
つきごろ	月頃
つきごめ	搗き米
つきごと	月毎
つきごし	月越し
つきぐみ	月組
つきくず	突き崩
つきぎり	月限	月切り
つきぎめ	月極め
つききち	月基地
つききず	突き傷
つきがた	月形
つきがせ	月ヶ瀬
つきがけ	月掛け
つきかげ	月影
つきかえ	突き返
つきおと	突き落
つきおく	月遅
つきおか	月岡
つきうま	付き馬
つきうご	衝き動	突き動
つきいち	月一
つきあわ	突き合
つきあげ	突き上げ
つきあう	付き合う
つきあい	付き合い	付合
つがいけ	栂池
つかれめ	疲れ目
つかれは	疲れ果
つかれき	疲れ切
つかもと	塚本
つかみと	掴み取
つかみだ	掴み出
つかみあ	掴み合
つかまつ	仕
つかはら	束原	塚原
つかのめ	塚目
つかのま	束の間
つかたに	塚谷
つかしま	塚島
つかさど	掌	司
つかごし	塚越
つかこし	塚越
つかぐち	塚口
つかくち	塚口
つかいわ	使い分
つかいま	使い魔
つかいは	使い果
つかいな	使い慣	使い馴
つかいで	使い出
つかいて	使い手
つかいつ	使い尽
つかいだ	使い出
つかいす	使い捨
つかいし	束石
つかいこ	使い込
つかいお	使い終
つかあな	塚穴
つうろん	通論	痛論
つうれつ	痛烈
つうれい	通例
つうりき	通力
つうらん	通覧
つうらい	通来
つうよう	通用	痛痒
つうゆう	通有
つうやく	通約	通訳
つうめい	通名
つうぼう	通謀	痛棒
つうほう	通宝	通報
つうへい	通弊
つうぶん	通分
つうふん	痛憤
つうふう	痛風	通風
つうぱい	字牌
つうばん	通番
つうはん	通販
つうねん	通年	通念
つうどく	通読
つうどう	通導	通洞
つうでん	通電
つうてん	痛点
つうてい	通底
つうたつ	通達
つうぞく	通俗
つうそく	通則
つうせつ	痛切	通説
つうせき	痛惜
つうせい	通性
つうすい	通水
つうじん	通人
つうしん	通信	痛心
つうしき	通式
つうさん	通算	通産
つうごう	通号
つうこん	痛恨
つうこく	通告	痛哭
つうこう	通航	通行	通交	通工	通好
つうげん	痛言
つうげき	痛撃
つうけん	通研	電気通信研究所	東北大学電気通信研究所
つうけい	通計
つうきん	通勤
つうがく	通学
つうかん	通関	通観	痛感	通巻
つうかじ	通過時
つうかご	通過後
つうかく	痛覚
つうかい	通解	痛快	通快
つうえん	通園
つううん	通運
つういん	痛飲	通院
ついろく	追録
ついらく	墜落
ついほう	追放
ついふく	追捕	追復
ついのう	追納
ついにん	追認
ついとつ	追突
ついとう	追悼	追討
ついだつ	追奪
ついたて	衝立
ついたち	1日	朔日	一日	１日
ついたい	椎体
ついぞう	追贈
ついそう	追送	追想	追走
ついぜん	追善
ついせき	追跡
ついずい	追随
ついすう	対数
ついしん	P.S.	追伸
ついごう	追号
ついこつ	椎骨
ついこう	追考	追行
ついげき	追撃
ついきん	追金
ついきそ	追起訴
ついかん	追完
ついかい	追懐
ついおく	追憶
ついえさ	潰え去
つーもー	自摸
つーぱい	字牌
ちんれつ	陳列
ちんりつ	賃率
ちんもん	珍問
ちんもく	沈黙
ちんめん	沈湎
ちんめい	珍名
ちんぽん	珍本
ちんぽこ	似指
ちんぽう	珍宝
ちんぼつ	沈没
ちんぺい	陳平
ちんべん	陳弁
ちんぷか	陳腐化
ちんぶん	珍聞
ちんぶつ	珍物
ちんぴん	珍品
ちんぱん	青幇
ちんばん	珍盤
ちんねん	珍念
ちんとう	珍答	枕頭
ちんでん	沈殿	沈澱
ちんでき	沈溺
ちんてい	鎮定
ちんつう	鎮痛	沈痛
ちんちん	沈々
ちんだん	珍談	沈檀
ちんだい	鎮台
ちんたお	青島
ちんたい	沈滞	賃貸
ちんぞう	珍蔵
ちんぜい	鎮西
ちんせん	沈船	沈潜	賃銭
ちんせつ	珍説
ちんせき	珍石	珍籍	枕席	沈積
ちんせい	鎮静	沈静
ちんすい	沈水
ちんじゅ	鎮守
ちんしょ	砧杵	陳書	珍書
ちんしゅ	珍手	珍種
ちんしゃ	陳謝
ちんさげ	賃下げ
ちんこん	鎮魂
ちんこう	沈降	沈香	鎮江
ちんげい	珍芸
ちんぎん	沈吟	賃金
ちんきん	沈金
ちんがり	賃借り
ちんがし	賃貸し
ちんうつ	沈鬱
ちんあん	珍案
ちんあつ	鎮圧
ちんあげ	賃上げ
ちろうい	地労委
ちりょく	地力	知力
ちりょう	治療
ちりゅう	知立
ちりゃく	智略	治略	知略
ちりめん	縮緬
ちりはま	千里浜
ちりなべ	ちり鍋
ちりとり	塵取
ちりてき	地理的
ちりぢり	散り散り
ちりがみ	ちり紙	チリ紙	塵紙
ちりがく	地理学
ちりいん	地理院
ちよろず	千万
ちよまる	千代丸
ちよだく	千代田区
ちよくら	千代倉
ちよがみ	千代紙
ちよかわ	千代川
ちょんぼ	錯和
ちょんぎ	ちょん切
ちょろん	緒論
ちょろく	著録
ちょりつ	佇立
ちょめい	著名	著明
ちょぼく	貯木
ちょへん	著変
ちょぶん	著聞
ちょとつ	猪突
ちょっと	一寸
ちょっき	直帰
ちょっか	直下
ちょちく	貯蓄
ちょだい	著大
ちょぞう	著増	貯蔵
ちょせん	緒戦
ちょすい	貯水
ちょしょ	著書
ちょしゃ	著者
ちょさく	著作
ちょこう	著効
ちょげん	緒言
ちょくわ	直和
ちょくろ	直路
ちょくゆ	勅諭	直喩
ちょくふ	直付
ちょくで	直出
ちょくじ	直示
ちょくし	直視	勅使	勅旨
ちょくさ	直鎖
ちょくご	勅語	直後
ちょくか	直下
ちょきん	貯金
ちょうわ	調和
ちょうろ	朝露
ちょうり	嘲詈	調理	蝶理
ちょうや	聴野	長夜
ちょうめ	丁目
ちょうむ	庁務
ちょうみ	調味
ちょうぼ	帳簿	徴募
ちょうほ	調歩
ちょうぶ	町歩	頂部
ちょうふ	貼付	調布	長府
ちょうび	掉尾
ちょうひ	張飛
ちょうば	嘲罵	跳馬	帳場
ちょうは	調波	長波
ちょうの	蝶野
ちょうな	手斧	鐇
ちょうど	丁度	調度
ちょうと	長途
ちょうだ	長打	長蛇
ちょうそ	彫塑
ちょうず	手水
ちょうじ	寵児	弔辞	長治	丁子	懲治
ちょうし	長姉	銚子	弔詩	長詩	弔詞	聴視	長子	冢祀	調子
ちょうざ	長座
ちょうさ	潮差	調査	長沙
ちょうご	長後
ちょうけ	帳消
ちょうく	長駆	長句	長躯
ちょうぎ	嘲戯	朝議	朝儀	町議	張儀
ちょうき	弔旗	長期	寵姫
ちょうが	頂芽
ちょうか	超過	弔歌	町家	長歌	長靴	釣果
ちょうい	潮位	弔意	弔慰
ちゅうわ	中和
ちゅうる	中流
ちゅうゆ	注油
ちゅうや	昼夜	中也
ちゅうま	中馬
ちゅうぶ	中部	中風
ちゅうび	中火
ちゅうひ	中皮	中飛
ちゅうは	中波	中破
ちゅうに	中二	中２	中2
ちゅうど	中度
ちゅうと	中途
ちゅうづ	宙吊
ちゅうち	中置
ちゅうた	宙太
ちゅうそ	註疏
ちゅうず	中主
ちゅうじ	中耳	忠治	忠司	忠二
ちゅうし	忠死	忠士	注視	中止
ちゅうざ	中座
ちゅうさ	中佐
ちゅうこ	中古
ちゅうぎ	忠義
ちゅうき	中気	中期	駐機	注記
ちゅうか	中夏	中華
ちゅうう	中有
ちゅうい	中尉	注意	中位
ちゃんた	全帯
ちゃんご	杖鼓
ちゃわん	茶碗
ちゃやま	茶山
ちゃめし	茶飯
ちゃみせ	茶店
ちゃびん	茶瓶
ちゃぱつ	茶髪
ちゃばん	茶番
ちゃばら	茶腹
ちゃばな	茶花
ちゃばこ	茶箱
ちゃはる	察哈爾
ちゃのゆ	茶の湯
ちゃのみ	茶飲み
ちゃのま	茶の間
ちゃない	茶内
ちゃどう	茶道
ちゃとう	茶湯
ちゃてん	茶店
ちゃづつ	茶筒
ちゃづけ	茶漬け	茶漬
ちゃつみ	茶摘み
ちゃつぼ	茶壺
ちゃつう	茶通
ちゃっこ	着呼
ちゃっか	着荷	着火
ちゃちゃ	茶々	茶茶
ちゃだな	茶棚
ちゃだい	茶代
ちゃたん	北谷
ちゃたく	茶托
ちゃせん	茶筌	茶筅	茶せん
ちゃせき	茶席
ちゃじん	茶人
ちゃしぶ	茶渋
ちゃしつ	茶室
ちゃさじ	茶匙
ちゃこし	茶漉し
ちゃくみ	茶くみ
ちゃくぼ	嫡母
ちゃくば	着馬
ちゃくに	着荷
ちゃくち	着地
ちゃくじ	着磁
ちゃくし	嫡子
ちゃくざ	着座
ちゃくさ	着差
ちゃくい	着意	着衣
ちゃきん	茶巾
ちゃがら	茶殻
ちゃがま	茶釜
ちゃがし	茶菓子
ちゃかい	茶会
ちゃおず	餃子
ちゃえん	茶園	茶圓
ちゃうす	茶臼
ちゃうけ	茶請け
ちゃいろ	茶色
ちゃいれ	茶入
ちもよう	血模様
ちめいど	知名度
ちみゃく	地脈
ちみどろ	血みどろ
ちまみれ	血塗れ	血まみれ
ちまなこ	血眼
ちまつり	血祭	血祭り
ちぼしん	地母神
ちほうば	地方馬
ちほうじ	地方時
ちほうし	地方紙	地方誌
ちほうさ	地方差
ちほうご	地方語
ちほうく	地方区
ちほうか	痴呆化
ちぶくろ	血袋
ちびっこ	ちびっ子
ちひょう	地表
ちばばん	千葉版
ちばなれ	乳離れ
ちばだい	千葉大
ちばけん	千葉県
ちばがわ	千葉側
ちばかん	千葉間
ちばえき	千葉駅
ちはらい	遅払い
ちのみご	乳飲み児	乳飲み子	乳呑み児
ちのしお	地の塩
ちのえき	茅野駅
ちのうみ	血の海
ちのうか	知能化
ちのいけ	血の池
ちのあめ	血の雨
ちのあせ	血の汗
ちにちは	知日派
ちなみに	因みに
ちてきび	知的美
ちていこ	地底湖
ちつない	膣内
ちつづき	血続き
ちつせん	膣栓
ちつじょ	秩序
ちっとも	些とも
ちっそく	窒息
ちっこう	築港
ちっきょ	蟄居
ちっかん	竹簡
ちぢれげ	縮れ毛
ちぢみこ	縮み込
ちぢみあ	縮み上
ちちょう	地調
ちちゅう	地中
ちちゃく	遅着
ちちまつ	千々松
ちちぶし	秩父市
ちちばな	乳離
ちちはる	斉斉哈爾
ちちのひ	父の日
ちちじま	父島
ちちくさ	乳臭
ちちぎみ	父君
ちちがた	父方
ちちかた	父方
ちちおや	父親
ちちうし	乳牛
ちちうえ	父上
ちちいろ	乳色
ちだるま	血ダルマ	血だるま	血達磨
ちたねく	千種区
ちたぐん	知多郡
ちせいは	知性派
ちせいか	知性化
ちずてん	地図店
ちずてき	地図的
ちずせん	智頭線
ちずしき	地図式
ちじょく	恥辱
ちじょう	笞杖	痴情	地上
ちじゅつ	治術
ちじせん	知事選
ちしんじ	遅進児
ちしりつ	致死率
ちしょう	池沼	地象	知将	致傷
ちしぶき	血しぶき	血飛沫
ちしてき	致死的
ちざいぶ	知財部
ちけむり	血煙
ちけいず	地形図
ちぐさく	千種区
ちくわふ	竹輪麩
ちくろく	逐鹿
ちくるい	畜類
ちくりん	竹林
ちくよう	畜養
ちくめい	地区名
ちくほう	筑豊
ちくべつ	地区別
ちくはく	竹帛
ちくのう	蓄膿
ちくねん	逐年
ちくねつ	蓄熱
ちくない	地区内
ちくでん	逐電	蓄電
ちくてん	逐電
ちくてい	築堤	築庭
ちくちく	矗々
ちくぞう	築造	蓄蔵
ちくぜん	竹善	筑前
ちくせん	地区戦
ちくせき	蓄積
ちくじか	逐次化
ちくしゃ	畜舎
ちくしの	筑紫野
ちくしじ	筑紫路
ちくざい	蓄財
ちくさん	畜産
ちくさつ	畜殺
ちくさく	竹柵	千種区
ちくかん	地区間	竹竿	竹簡
ちくいち	逐一
ちくあん	竹安
ちぎょう	知行
ちきょう	地峡
ちきゅう	地球	恥丘
ちがっか	地学科
ちがさき	茅ヶ崎
ちがくぶ	地学部
ちかんし	置換子
ちかんご	置換後
ちかろう	地下牢
ちからも	力持
ちからな	力無
ちからづ	力付
ちからつ	力尽
ちからぞ	力添
ちからさ	力差
ちかよう	地下用
ちかやま	近山
ちかみち	近道
ちかまつ	近松
ちかひろ	近廣	近広
ちかどう	地下道
ちかてつ	地下鉄
ちかって	誓って
ちかぢか	近々
ちかぜい	地価税
ちかせん	地下線
ちかずみ	近角
ちかすい	地下水
ちかじか	近々
ちかしつ	地下室
ちかざわ	近澤
ちかごろ	近頃
ちかけい	地下茎
ちかきち	地下基地
ちかがい	地下街
ちかえき	地下駅
ちかいあ	誓い合
ちえんは	遅延波
ちえねつ	知恵熱
ちえしゃ	知恵者
ちいるい	地衣類
ちいほう	地和
ちいさな	小さな
ちいきさ	地域差
ちいきご	地域語
ちーほー	地和
ちーちゃ	起家
たんわく	単枠
たんれん	単連	鍛練	鍛錬
たんれつ	単列
たんれい	端麗
たんりょ	短慮
たんりつ	単立
たんらん	貪婪
たんらく	短絡
たんよん	単四
たんよく	貪欲
たんよう	単葉
たんゆう	胆勇
たんもの	反物
たんめん	湯麺	単面
たんめい	短命
たんみん	短眠
たんまつ	端末
たんまち	反町
たんぽぽ	蒲公英
たんぼく	単木
たんぼう	探訪
たんほう	探訪
たんぺん	短辺	短編	短篇
たんぺい	短兵
たんぷく	単複
たんぶん	単文	短文	探聞
たんふく	単複
たんぴん	単品
たんびは	耽美派
たんぱん	短パン
たんぱつ	単発	短髪
たんぱく	淡泊	蛋白	淡白
たんばん	胆礬
たんばら	丹原
たんばい	単売
たんのう	胆嚢	堪能
たんねん	単年	丹念	端然
たんにん	担任
たんなん	丹南
たんなる	単なる
たんどく	丹毒	單獨	耽読	単独
たんどう	胆道
たんとう	丹東	探湯	但東	担当	短刀	単刀
たんでん	丹田	炭田
たんでき	耽溺
たんてん	端点
たんてつ	鍛鉄
たんてき	胆摘	端的
たんてい	単蹄	短艇	探偵	端艇
たんづつ	短筒
たんつぼ	痰壷
たんちょ	単著	端緒
たんちき	探知機	探知器
たんだい	探題	短大
たんたん	坦々	湛々	淡々	眈々	眈眈	淡淡
たんたる	Tantalum	Ta
たんたい	単体	担体
たんぞう	鍛造	胆臓
たんそさ	炭素鎖
たんそく	短足	探測	嘆息	歎息
たんそう	担送	単相	炭層	単走	単層	単奏
たんぜん	端然	丹前
たんぜい	担税
たんせん	単線
たんせつ	鍛接
たんせき	旦夕	痰咳	胆石
たんせい	嘆声	端正	単性	端整	淡青	丹青	丹精
たんすう	単数
たんすい	淡水
たんじん	炭塵
たんじつ	短日
たんじく	単軸	短軸
たんじき	単時期
たんしん	短信	短針	単身	探針
たんしょ	短所	端緒
たんしゃ	単車	丹砂	単写	単射
たんしつ	炭質
たんしき	単式
たんしお	タン塩
たんざん	湛山
たんざわ	丹沢
たんざく	短冊
たんざき	単座機
たんさん	炭酸	単産	単三
たんさく	探策	探索	単作
たんさき	探査機
たんさい	短才	淡彩
たんころ	単コロ
たんこう	鍛工	単溝	炭坑	淡紅	炭鑛	鍛鋼	淡黄	単項	単孔	単行	短光	炭鉱	単鉤	単向	湛江
たんげん	単元
たんげい	端倪
たんけん	探検	短見	短剣	探険
たんけい	短形	短径
たんぐつ	短靴	単靴
たんきん	鍛金	単金
たんきよ	たん清
たんがん	嘆願	歎願	単眼	単願
たんかん	短観	胆管	単館	単漢
たんかひ	単花被
たんかく	短角
たんかか	単花果
たんおん	短音	単音
たんいふ	単位符
たんいつ	単一
たんいち	単一
たんあな	単穴
たわむれ	戯	戯れ
たわごと	戯言
たろせん	他路線
たろいも	タロ芋
たれみず	垂水
たれまく	垂幕	垂れ幕
たれなが	垂れ流
たれつき	タレ付き
たれぎぬ	垂れ絹
たれがみ	垂れ髪
たれがし	誰某
たるみず	垂水
たるみく	垂水区
たるなま	樽生
たるだい	樽代
たるざけ	樽酒
たるがた	樽型
たりんか	多輪花
たりょう	多量
たりゅう	他流
たりうむ	Tl	Thalium
たらふく	鱈腹
たらちね	垂乳根
たらじる	鱈汁
たらしこ	誑し込
たようか	多様化
たゆうこ	太夫子
たもがわ	田茂川
ためらい	躊躇い
ためひろ	為広
ためなが	為永
ためしず	試し刷
ためしげ	爲成
ためぐち	タメ口
ためきよ	為清
ためうち	溜め撃ち
ためいけ	溜池	溜め池	ため池
ためいき	溜息	溜め息	ため息
たみるご	タミル語
たみくさ	民草
たみおか	民岡
たみあき	民朗
たまりば	たまり場	溜り場	溜まり場
たまりか	堪り兼
たまよけ	弾除け
たまゆら	玉響
たまやま	玉山
たまもの	賜物	賚	賜
たまもと	玉本
たまむら	玉村
たまむし	玉虫
たまみそ	玉味噌
たまみず	玉水
たままゆ	玉繭
たままき	玉牧
たまほり	玉堀
たまひめ	玉姫
たまはら	玉原
たまはし	玉橋
たまのし	玉野市
たまのお	玉の緒
たまのい	玉井
たまねぎ	玉ネギ	玉ねぎ	玉葱
たまなわ	玉那覇	玉縄
たまつき	玉突	玉突き
たまちく	多摩地区
たまだい	多摩大
たまたま	偶	偶々
たません	多摩線
たますじ	玉筋	球筋
たましま	玉島
たましい	魂
たまさと	玉里
たまこし	玉越
たまぎぬ	玉衣
たまがわ	玉川	田万川	多摩川
たまがき	玉垣
たまかわ	玉川
たまかず	玉数
たまかし	玉柏
たまおき	玉置
たまいれ	玉入れ
たべもの	食べ物	食物
たべはじ	食べ始
たべのこ	食べ残
たべつづ	食べ続
たべつく	食べ尽
たべごろ	食べ頃
たべかた	食べ方
たぶんや	多分野	他分野
たぶんぎ	多分木
たぶんか	他文化
たぶもん	他部門
たぶぶん	他部分
たぶのき	椨
たぶしょ	他部署	他部所
たふけん	他府県
たびらこ	田平子
たびょう	多病
たびびと	旅人
たびどり	旅鳥
たびだち	旅立ち
たびたび	度々
たびさき	旅先
たびかさ	度重
たひんど	多頻度
たばやま	丹波山
たばこや	煙草屋
たばいと	多バイト
たのもし	頼もし
たのみこ	頼み込
たのはた	田野畑
たのなか	田野中
たのしみ	愉しみ	楽しみ
たのしさ	愉しさ
たのかみ	田の神
たのうら	田浦
たのうえ	田上
たねもみ	種籾
たねもの	種物
たねむら	種村
たねまき	種まき	種蒔き
たねほん	種本
たねなし	種無し
たねとり	種取り
たねとし	種敏
たねつけ	種付け
たねせん	種銭
たねぎれ	種切れ
たねかわ	種川
たねおみ	種臣
たねうま	種馬
たねうし	種牛
たねいも	種芋
たねいち	種市
たねあき	種明
たねあか	種明
たにわき	谷脇
たにょう	多尿
たにやま	谷山
たにもと	谷本
たにむら	谷村
たにみず	谷水
たにまわ	谷回
たにまち	谷町
たにふじ	谷藤
たにはら	谷原
たになか	谷中
たにぞこ	谷底
たにすじ	谷筋
たにじま	谷島
たにしげ	谷繁
たにざわ	谷沢
たにざき	谷崎
たにぐみ	谷汲
たにぐち	谷口
たにがわ	谿	谷側	谷川
たにがみ	谷上
たにがき	谷垣
たにかわ	谷川
たにかぜ	谷風
たにおり	谷折り
たにおか	谷岡
たにえき	谷駅
たにうち	谷内
たにあし	谷脚
たにあい	谷間
たなもの	店者
たなぼた	棚ボタ	棚牡丹	棚ぼた
たなばた	七夕
たなはし	棚橋
たなちん	店賃
たなざわ	棚沢
たなざら	店晒
たなぐら	棚倉
たなぐも	棚雲
たなくら	棚倉
たなおろ	棚卸
たなうえ	棚上
たないた	棚板
たないけ	種池
たなあみ	田名網
たなあげ	棚上げ
たどりつ	辿りつ	辿り着
たどころ	田所
たどうろ	他道路
たどうし	他動詞
たとへば	例へば
たとえば	例えば
たでもく	タデ目	Polygonales
たてわり	縦割り
たてわき	帯刀
たてよこ	縦横
たてやま	立山	楯山	館山
たてもの	建物
たてめぐ	立て巡
たてむら	舘村
たてまつ	立松	奉
たてまち	立町
たてまし	建て増し	建増し
たてまさ	建正
たてまえ	建前	立前
たてぼう	｜	縦棒
たてほり	縦堀
たてぶえ	縦笛	竪笛
たてふだ	立て札	立札
たてひざ	立て膝
たてひこ	建彦
たてばい	縦倍
たてはら	立原
たてはば	縦幅
たてぬき	経緯
たてなみ	縦波
たてなが	縦長
たてなお	立て直	建て直
たてとお	立て通
たてつぼ	建坪	立坪
たてつづ	立て続
たてつけ	建付	立付け
たてつく	楯突く
たてちゃ	点茶	立茶
たてせん	│	｜	縦線
たてすじ	縦筋
たてじわ	縦皺
たてじま	縦縞
たてじく	縦軸
たてしな	蓼科	立科
たてさわ	立澤
たてごと	竪琴
たてこも	立て籠
たてこし	館腰
たてこう	竪坑
たてけい	縦系
たてぐみ	縦組
たてがみ	鬣
たてがた	縦型
たてがき	縦書き
たてかん	立看	立て看
たてかわ	立川
たてかた	立て方
たてかえ	立替え	立替	建替
たておき	縦置き	縦置
たておか	楯岡
たてうり	建売	建売り
たてうま	立馬
たてうち	舘内	館内
たていわ	館岩
たていと	縦糸	經	経糸
たていち	縦位置
たていた	立板
たていし	立石	建石
たてあな	竪穴
たてあき	賢明
たづくり	田作り
たつんど	達人
たつろう	達朗	達郎
たつゆき	達之	達行
たつやま	龍山	竜山
たつまき	竜巻
たつべん	達弁
たつぶん	達文
たつひろ	達弘
たつひこ	達彦	龍彦
たつのり	辰徳	辰範	辰則	達徳	達就
たつなり	達就
たつなみ	立浪
たつどし	辰年
たつとし	達俊	達利
たつたか	辰敬
たつじん	達人
たつしま	立嶋
たつごう	竜郷
たつぐち	辰口
たつくち	辰口
たつきよ	達清
たつきち	辰吉
たつかわ	達川	立川
たつおき	辰興
たつおか	龍岡	立岡	竜岡
たついち	辰一
たつあき	達明
たっぴつ	達筆
たっせい	達成
たっしゃ	達者
たっしき	達識
たっこう	卓効
たっけん	卓見	宅建	達見
たっけい	磔刑
たっかん	達観
たちわざ	立技	立ち技
たちより	立ち寄り
たちよみ	立読み
たちやま	立山
たちやく	立役
たちもり	館盛
たちもの	裁ち物	断ち物
たちもど	立ち戻
たちめい	太刀銘
たちまわ	立ち回
たちまち	忽	忽ち	怱ち	立町	立待ち
たちふさ	立ち塞
たちばん	立ち番
たちばな	立花	橘
たちはら	立原
たちのぼ	立ち上
たちぬい	裁ち縫い
たちなら	立ち並
たちなお	立ち直
たちどお	立ち通
たちとお	立ち通
たちつづ	立ち続
たちつく	立ち尽
たちすじ	太刀筋
たちすく	立ち竦
たちざわ	立沢	立澤
たちさき	太刀先
たちぐい	立ち食い	立食い
たちくら	立ち暗
たちぎき	立聞き	立ち聞き
たちぎえ	立消え	立ち消え
たちがれ	立枯れ
たちがみ	舘上
たちかわ	太刀川	立川
たちかぜ	太刀風
たちかけ	太刃掛	太刀掛
たちかえ	立ち返
たちえり	立襟
たちうり	立売
たちうち	太刀打ち	立射ち
たちうお	太刀魚
たちいり	立入	立ち入り	立入り
たちいた	立ち至
たちいき	他地域
たちあげ	立ち上げ	起ち上げ
たちあい	立ち合い	立会	立合	立ち会い
ただわか	唯若
ただよし	忠良	忠儀	忠吉	忠央	忠義
ただゆき	忠之	忠幸	忠行
ただもの	只者
ただもと	忠元
ただみち	直道	忠道
ただまさ	忠正
ただふみ	忠文	能文
ただひろ	忠浩	忠広	忠弘	忠博	忠宏
ただひら	忠平
ただひさ	正久
ただひこ	忠彦	伊彦
ただはる	忠治
ただのり	忠度	匡孝	忠則	只乗り
ただのぶ	忠信
ただなか	只中
ただとし	忠利	正利
ただちに	直ちに
ただたん	只単
ただたか	匡孝
ただせん	太多線
ただしく	正しく
ただごと	只事	徒事	唯事
ただけん	タダ券	只券
ただくま	只熊
ただおき	忠興
ただおか	忠岡
ただいま	只今	ただ今	唯今
ただあき	忠明	理顕
たたんし	多端子
たたみま	畳間
たたみこ	畳み込
たたみか	畳み掛
たたすく	他タスク
たたきつ	叩き付	叩きつ
たたきだ	叩き出
たたきこ	叩き込
たたきお	叩き起
たたきう	叩き売
たたきあ	叩き上
たたかい	戦い
たたいた	多対多
たそしき	他組織
たそがれ	黄昏
たそうか	多層化
たそーと	多ソート
たせんく	他線区
たせかい	多世界
たずねい	尋ね入
たずねあ	尋ね当
たずさわ	携
たすけあ	助け合
たすきぞ	襷反
たすきが	襷掛
たすうは	多数派
たすうこ	多数個
たじょう	多情
たじゅう	多重
たじげん	多次元
たしんぴ	多心皮
たしんぎ	多進木
たしょく	多色	多食
たしょう	他生	多少	他称	多祥	多生
たしゅみ	多趣味
たしゅつ	他出
たしゅう	他宗	他州
たしゃく	他借
たしてん	多視点
たしざん	足算	足し算
たしこむ	足し込む
たしかに	確かに
たざわこ	田沢湖
たざせき	多座席
たさいと	他サイト
たごさく	田吾作
たこやき	たこ焼	蛸焼	タコ焼
たこべや	タコ部屋	蛸部屋
たこじま	蛸島
たこくご	多国語
たこあし	タコ足	蛸足
たこあげ	凧揚げ
たげんご	他言語	多言語
たけよし	武吉	建美
たけゆき	岳之	健幸
たけやり	竹槍	武鑓
たけやま	竹山	武山
たけやぶ	竹薮
たけもり	竹森
たけもと	武元	武本	竹本
たけもち	威望
たけむら	竹村	武村
たけみや	竹宮	武宮
たけみつ	武満	竹光
たけまつ	竹松
たけまさ	竹政
たけまえ	竹前
たけぶえ	竹笛
たけふみ	武文
たけふじ	武藤
たけふさ	竹房
たけひろ	威博	毅寛	竹広	武大	威裕	武裕	雄洋
たけひら	竹平
たけひと	雄人	武人	武仁
たけひで	武秀	武英
たけひさ	武久	竹久
たけひご	竹籤
たけひこ	雄彦	健彦	剛彦	武彦	竹彦	建彦	毅彦
たけばし	竹橋	竹箸
たけはる	丈晴	毅治
たけはら	竹原	武原
たけはな	竹花
たけはし	竹橋
たけのり	武憲	健雅	武範
たけのぶ	武信	健伸
たけのこ	竹の子	筍	笋
たけなわ	酣	武縄	竹縄	闌
たけなり	丈成	雄成
たけなみ	竹並
たけなか	武中	竹中
たけなお	武直
たけとり	竹取
たけとよ	武豊
たけとも	斌友
たけとみ	武富	竹富
たけとし	武俊	壮聡
たけづつ	竹筒
たけつぐ	健嗣
たけだし	竹田市
たけだけ	猛々
たけたに	竹谷
たけぞの	竹園
たけぞえ	竹添
たけすえ	武居
たけしま	竹島	武島
たけしば	竹芝
たけした	竹下
たけざわ	竹澤	竹沢
たけざき	竹崎
たけざお	竹竿
たけさか	竹坂
たけこし	竹越	竹腰
たけぐち	竹口
たけぐし	竹串
たけくに	武邦
たけがわ	竹河
たけがり	茸狩
たけがた	竹形
たけがき	竹垣
たけかわ	武川	竹河	竹川
たけかず	丈和
たけおか	竹岡
たけうま	竹馬
たけうち	武内	竹内
たけいち	武一	武市	竹市
たけいし	武石
たぐりよ	手繰り寄
たぐりこ	手繰り込
たくわん	沢庵
たくわえ	貯え	蓄え
たくろん	卓論
たくろう	拓郎	卓朗
たくりつ	卓立
たくらみ	企み
たくよう	托葉
たくぼく	啄木
たくほん	拓本
たくばつ	択抜	卓抜
たくはつ	托鉢
たくはい	宅配
たくぞう	卓三	卓造
たくそう	託送	拓宋
たくぜつ	卓絶
たくせん	託宣
たくせつ	卓説
たくしん	宅診
たくしょ	謫所
たくしき	卓識
たくさん	沢山
たくさり	田鎖
たくさい	卓才
たくけい	磔刑
たくえつ	卓越
たくいつ	択一
たくあん	沢庵
たくあき	卓明
たぎょう	た行	タ行
たぎてき	多義的
たぎせい	多義性
たきょく	多極	他局
たきょう	他郷	田京
たきゅう	田久
たきやま	滝山	瀧山
たきもの	焚物
たきもと	滝本	瀧本
たきひろ	滝広
たきはら	滝原
たきのう	多機能	他機能
たきなみ	滝波
たきとう	多気筒
たきつぼ	滝壷
たきつせ	滝つ瀬
たきだし	炊き出し	炊出し
たきたて	炊き立て
たきしゅ	多機種	他機種
たきざわ	滝沢	滝澤	瀧沢
たきさわ	滝沢	滝澤
たきぐち	瀧口	滝口
たきがわ	多岐川	滝川	瀧川
たきかわ	滝川	瀧川
たきうち	瀧内	滝内
たきあせ	滝汗
たがんし	多眼視
たがらす	田烏
たがっか	他学科
たがしら	田頭
たがくぶ	他学部
たがいに	互いに
たからべ	財部
たからだ	宝田
たからか	高らか
たからい	宝井
たかよし	高好	隆克	貴良	隆吉	孝佳	孝允	高良	孝義	隆義
たかゆき	敬之	隆之	孝幸	能之	隆幸	孝之	尊之	高之	貴之	崇行	孝行	貴幸	高行	貴行	隆行	高幸	崇之	敬行
たかやま	高山	鷹山
たかやす	貴康	高安
たかもり	鷹森	高盛	高森	隆盛
たかもと	高本
たかむら	高村	篁
たかむね	高宗
たかみや	高宮
たかみね	高峰	嵩嶺	高嶺
たかみつ	貴光	隆充
たかみち	孝通	尊道	隆道
たかみず	高水
たかみす	高見州
たかまる	鷹丸
たかまど	高窓
たかまつ	高松
たかまさ	高政	孝昌	隆政	隆征	孝政
たかふみ	隆文	隆史	孝史	貴史	貴文	孝文
たかふだ	高札
たかひろ	隆浩	隆博	隆啓	貴大	敬弘	貴浩	貴博	高宏	高広	高裕	崇博	隆寛	隆宏	貴宏	貴広	隆弘	貴裕	隆広	孝広	孝宏	孝浩	孝洋
たかひら	高平	高比良
たかひと	隆人	隆仁	貴仁
たかひで	貴英
たかひさ	高尚	貴久	隆久
たかひこ	貴彦	孝彦	隆彦	高彦
たかひく	高低
たかはる	高原	高春
たかはら	高原
たかはま	高浜	高濱
たかはな	高花	高鼻
たかはた	高畠	高畑
たかはし	高橋	高梁
たかはぎ	高萩
たかのり	敬則	孝憲	高徳	孝徳	隆典	孝規	敬典	崇徳	孝則	孝典	隆則
たかのぶ	敬信	孝信	貴信
たかのは	鷹羽
たかのぞ	高望
たかのす	鷹の巣	鷹巣
たかにし	高西
たかなわ	高縄	高輪
たかなり	高鳴り
たかなみ	高波	高浪
たかなべ	高鍋
たかなし	小鳥遊	高梨
たかなか	高中
たかなお	高尚	高直
たかどの	高殿	楼
たかとり	高鳥	高取
たかとも	鷹友
たかとみ	高富	孝富
たかとび	高跳び	高飛び
たかとし	孝寿	隆利	隆俊	孝利	孝俊
たかとき	高時
たかとお	高遠
たかとう	高藤	高遠
たかつぐ	高嗣
たかつく	高津区
たかつき	高坏	高槻	高月
たかつか	高塚
たかちほ	高千穂
たかだま	高玉
たかだて	高館
たかだし	高田市
たかだか	高々
たかだい	高台
たかせい	多価性
たかずみ	敬済
たかすみ	高住
たかすぎ	高杉
たかすが	高須賀
たかしろ	鷹城	高城
たかしま	高嶋	鷹島	高島
たかしな	高品	高科
たかしお	高汐	高潮
たかざわ	高沢
たかさわ	高沢	高澤
たかさと	高郷
たかさご	高砂
たかさき	高崎
たかさか	高坂
たかこう	高高
たかくわ	高桑	高鍬
たかくら	高倉	高蔵
たかくか	多角化
たかぎわ	高際
たかぎし	高岸
たかがり	鷹狩
たかがき	高垣
たかかわ	高河
たかかず	剛和	剛一
たかかげ	隆景
たかおの	高尾野
たかおか	高丘	高岡	高岳
たかえだ	高枝
たかうち	高内
たかうじ	尊氏
たかいど	高井戸
たかいち	高市	隆一
たかいし	高石
たかあら	高荒
たかあし	高足
たかあき	孝明	隆明	貴章	学聡	貴昭	孝哲
たおれふ	倒れ伏	倒れ臥
たおやめ	手弱女
たおやか	嫋やか
たおしこ	倒し込
たえだえ	絶え絶え
たえしの	堪え忍
たえがた	耐え難
たうんし	タウン誌
たいわん	台湾
たいろん	対論
たいろう	大老
たいれつ	隊列
たいれい	大礼	耐冷	胎齢
たいるい	苔類
たいりん	大輪	台臨
たいりつ	対立
たいりく	大陸
たいらん	台覧	大乱
たいよく	大欲
たいよう	大陽	態様	耐用	大要	大洋	太洋	体用	太陽
たいゆう	大邑	大勇	大雄
たいやく	対訳	大約	大厄	大役
たいやき	鯛焼
たいもう	体毛	大望	大網
たいめん	泰緬	体面	対面
たいめし	鯛飯
たいめい	大命	待命	岱明	泰明
たいまん	怠慢
たいまつ	松明
たいまい	玳瑁	大枚
たいぼく	大木
たいぼう	耐乏	大望	待望	体貌
たいほく	台北
たいほう	大峰	大鵬	大砲	大宝	大豊
たいぺい	台北
たいべん	胎便
たいべつ	大別
たいべい	滞米	対米
たいへん	対辺	大変
たいへい	泰平	大兵	太平	大平
たいぶん	大分
たいぶつ	対物
たいふう	台風	颱風
たいひか	堆肥化
たいばん	胎盤
たいばつ	体罰
たいはん	大半	大藩
たいはく	太白
たいはい	頽廢	頽廃	退廃	大敗
たいのう	滞納	怠納
たいねん	耐年
たいねつ	耐熱
たいにん	体認	大任	退任
たいにち	滞日	対日
たいにし	対西
たいない	体内	対内	胎内	隊内
たいどく	胎毒
たいどう	帯同	胎動
たいとく	体得
たいとう	擡頭	台糖	帯刀	対当	対等	台東	台頭	体当
たいでん	帯電
たいてん	大典	退店	退転
たいてき	対敵	大敵
たいてい	退廷	大抵	大帝
たいちょ	大著
たいだん	退団	対談
たいぞう	退蔵	諦三	泰蔵	大蔵	太造	泰造	泰三	大造
たいそく	体側	大息
たいそう	大喪	太宗	大宗	大葬	大層	体操
たいぜん	大全	泰然
たいぜい	大勢
たいせん	大戰	苔癬	対戦	対潜	大戦
たいせつ	体節	大切	大雪
たいせき	堆石	対蹠	体積	堆積	退席	滞積
たいせい	対生	大聖	大声	泰西	体制	体勢	体性	大勢	態勢	大青	胎生	耐性	大政	大成	頽勢
たいずし	鯛鮨
たいする	対する
たいすけ	退助	泰介	泰祐	泰佑
たいすう	大数	対数
たいすい	大水	耐水	大酔
たいじん	対人	対陣	大人	退陣	泰人
たいじゅ	大樹
たいじく	体軸
たいしん	対審	大身	大信	太信	耐震	大震
たいしょ	大書	太初	対処	大暑	対蹠	大所
たいしゅ	太守	大酒	対手
たいしゃ	代赭	大社	退社	代謝	大赦
たいして	大して
たいしつ	体質	退室	対質	耐湿
たいした	大した
たいざん	泰山	大山	鯛山
たいざい	帯在	大罪	滞在
たいさん	退散
たいさつ	大冊
たいさく	大作	対策
たいさい	体菜	大才	大祭
たいごく	大獄
たいごう	対合
たいこく	大国
たいこう	大綱	大興	帯鉤	体講	大行	対向	退行	対抗	大公	大江	対校	体腔	体育講義	退校	大功	太閤	体高
たいげん	体言	体現	大言
たいけん	帯剣	大圏	大剣	体験	大権
たいけつ	対決
たいけい	大計	大慶	隊形	体型	体系	隊型	腿頚	体形	大系	大兄	体刑
たいぐん	大群	大軍
たいぐう	対偶	待遇
たいくん	大君
たいくつ	退屈
たいくう	体腔	滞空	対空
たいぎょ	大魚
たいぎご	対義語
たいきん	退勤	大金
たいきょ	退去	大挙
たいがん	対岸	対顔	大願
たいがく	退学
たいがい	大概	対外	体外	大外
たいかん	戴冠	大患	大官	対艦	退官	体幹	体感	耐寒	大観
たいかく	対格	体格	対角
たいかい	退会	大海	大会
たいおん	体温
たいおう	滞欧	對應	対欧	対応
たいえん	退園
たいえき	退役	体液
たいえい	退嬰	大栄
たいいん	隊員	退隠	太陰	退院
たいいち	対一	太一
たいいく	体育
たいいき	大域	帯域
たいあん	対案	大安	泰安
たいあつ	耐圧
たいあた	体当
たあはい	多牌
たあちゃ	他家
とんやがい	問屋街
とんぼがえ	蜻蛉返
とんちゃく	頓着
とんじんち	貪瞋痴
とんじゃく	頓着
とんきょう	頓狂	頓興
とんかつや	とんかつ屋
とろろいも	薯蕷芋
とろうかん	徒労感
とろいせき	登呂遺跡
とるこぶろ	トルコ風呂
とるこいし	トルコ石
とりもなお	取りも直
とりのいち	酉の市
とりとりべ	鳥取部
とりつだい	東京都立大学	都立大
とりつこう	都立高
とりつけぶ	取付部
とりつくろ	取り繕
とりしらべ	取調	取り調べ	取調べ
とりしまり	取締り	取り締まり	取り締り	取締
とりくんだ	取り組んだ
とりかぶと	鳥兜
とりかえし	取り返し
とりおどし	鳥威し
とりおこな	執り行
とりいそぎ	取り急ぎ
とりあわせ	取り合せ	取り合わせ	取合せ
とりあらそ	取り争
とりあつか	取扱	取り扱
とりあたま	鳥頭
とりあえず	取り敢えず	取りあえず
とらのもん	虎の門	虎ノ門
とらのまき	虎の巻
とらがしら	虎頭
とらえかた	捉え方
とらいじん	渡来人
とらいけい	渡来系
とよひらく	豊平区
とよひせん	豊肥線
とよはしし	豊橋市
とよのぼり	豊登
とよなかし	豊中市
とよだせん	豊田線
とよたろう	豊太郎
とよすえき	豊洲駅
とよぎだい	豊技大
とよがおか	豊ヶ丘
とよおかく	豊岡区
とやまわん	富山湾
とやまびん	富山便
とやまはつ	富山発
とやまだい	富山大
とやまさん	富山産
とやまけん	富山県
とやまがわ	富山側
とやまえき	富山駅
ともみはら	倶美原
ともばたら	共働
とものかい	友の会
とものうら	鞆の浦
ともだおれ	共倒れ
ともたろう	智太郎
ともがおか	友ヶ丘
ともかせぎ	共稼ぎ
ともかがみ	共鏡
ともえふじ	巴富士
ともえなげ	巴投げ
ともえぐみ	巴組
ともえがわ	巴川
とみんばん	都民版
とみんぜい	都民税
とみたろう	富太郎
とみこうみ	左見右見
とみぐすく	豊見城
とまりこみ	泊り込み
とまりがけ	泊り掛け
とまこまい	苫小牧
とびらせん	扉線
とびらいち	扉位置
とびどうぐ	飛道具	飛び道具
とびしょく	鳶職
とびきゅう	飛び級
とびうおざ	飛魚座
とばくせい	賭博性
とばくざい	賭博罪
とのしょう	土庄
とのいびと	宿直人
となりむら	隣村
となりまち	隣町
となりぐみ	隣組
とどけもの	届け物
とどけさき	届け先
とどけがき	届書
とていせい	徒弟制
とつにゅう	突入
とつぜんし	突然死
とつぎさき	嫁ぎ先
とつかえき	戸塚駅
とっぷきじ	トップ記事
とっぱこう	突破口
とっとりし	鳥取市
とってかわ	取って代
とってかえ	取って返
とっておき	取って置き
とっしゅつ	突出
とっこうき	特攻機
とっくみあ	取っ組み合
とっきょか	特許課	特許化
とっきゅう	特級	特急
とっきぶつ	突起物
とっきたい	突起体
とっかひん	特価品
とっかてき	特化的
とちゅうず	途中図
とちのわか	栃乃和歌
とちじせん	都知事選
とちぎけん	栃木県
とだせいじ	戸田誠司
とたんやね	トタン屋根
とそつてん	兜率天
とそうめん	塗装面
とそうまえ	塗装前
とそうはば	塗装幅
とそうずみ	塗装済
とそうしじ	塗装指示
とぜんいき	都全域
とせいにん	渡世人
とじかっこ	閉括弧
としんない	都心内
としんちく	都心地区
としんがわ	都心側
としんかん	都心間
としわすれ	年忘れ
としょしつ	図書室
としょけん	図書券
としょがく	図書学
としょかん	図書館
としゃぶつ	吐瀉物
としまわり	年回り
としまおか	豊島岡
としまえん	豊島園
としぶんか	都市文化
としぶちず	都市部地図
としのころ	年の頃
としのこう	年の功
としのうち	年の内
としせいび	都市整備
としごもり	年籠り
としこっか	都市国家
としきのう	都市機能
としおんな	年女
としおとこ	年男
とざんどう	登山道
とざんしゃ	登山者
とざんぐつ	登山靴
とざんぐち	登山口
とざんきち	登山基地
とさんせん	土讃線
とさやまだ	土佐山田
とさにっき	土佐日記
とさしみず	土佐清水
とさかのり	鶏冠海苔
ところてん	心太
ところせま	所狭
ところざわ	所沢
ところがら	所柄
ところがき	所書
とこばらい	床払い
とこばなれ	床離れ
とこばしら	床柱
とこだたみ	床畳
とこしえき	戸越駅
とこうしゃ	渡航者
とこうさき	渡航先
とけんどう	都県道
とけいとう	時計塔
とけいてん	時計店
とけいつき	時計付
とけいだい	時計台
とけいそう	時計草
とけいざら	時計皿
とけいかん	時計館
とくやまし	徳山市
とくめいか	匿名化
とくむかん	特務艦
とくべつし	特別視
とくべつく	特別区
とくべつき	特別機
とくべつか	特別化
とくべつい	特別委
とくひょう	得票
とくばいび	特売日
とくはいん	特派員
とくのしま	徳之島
とくのうか	篤農家
とくてんさ	得点差
とくてんき	得点機
とくていち	特定値
とくていか	特定化
とくちょう	特徴	特長
とくちゅう	特注
とくだいじ	徳大寺
とくたろう	徳太郎
とくそほう	特措法
とくそうぶ	特捜部
とくせいち	特性値
とくせいさ	特性差
とくじろう	徳次郎
とくじょう	特上
とくしょく	涜職	特色
とくしょう	特賞	特称	∃
とくしゅつ	特出
とくしゅか	特殊化
とくしゅう	特集
とくしまし	徳島市
とくさいろ	木賊色
とくぎょう	徳業	得業
とくがわけ	徳川家
とくがわき	徳川期
とくいわざ	得意技
とくいてん	特異点
とくいてき	特異的
とくいぜん	得意然
とくいせい	特異性
とくいさき	得意先
とぎばなし	伽噺	伽話
ときわまつ	トキワ松
ときわだい	常盤台
ときわじゅ	常盤樹
ときつかぜ	時津風
ときたまご	溶卵	溶き卵
ときじろう	時次郎
ときがらし	溶き芥子
ときいらい	時以来
とがりごえ	尖り声
とがめだて	咎め立て
とかちがわ	十勝川
とかいてき	都会的
とかいっこ	都会っ子
とかいじん	都会人
とおりみち	通り道
とおりぬけ	通り抜け
とおりあめ	通り雨
とおめがね	遠眼鏡
とおみづか	遠見塚
とおまわり	遠回り
とおまわし	遠回し
とおとうみ	遠江
とおしもの	通し物
とおがった	遠刈田
とおからず	遠からず
とおかまち	十日町
とおかった	遠刈田
とおかいち	十日市
とおあるき	遠歩き
とえはたえ	十重二十重
とえいせん	都営線
とえいしゃ	都営車
とうろくぼ	登録簿
とうろくび	登録日
とうろくひ	登録費
とうろくば	登録馬
とうろくじ	登録時
とうろくご	登録語
とうりょう	棟梁	当量	投了	統領	頭領	等量
とうりゅう	当流	刀流	闘竜	逗留
とうりゃく	党略
とうりとく	等利得
とうりだい	東理大
とうようし	東洋史
とうゆうし	投融資
とうめいど	透明度
とうめいし	透明視
とうみょう	燈明	灯明
とうみつど	等密度
とうぶんぷ	等分布
とうぶのだ	東武野田
とうふなべ	豆腐鍋
とうふくじ	東福寺
とうびょう	闘病	投錨
とうひょう	投票
とうひこう	討匪行	逃飛行	逃避行
とうはんじ	登坂時
とうにょう	糖尿
とうにゅう	豆乳	刀入	投入
とうとうみ	遠江
とうちょく	当直
とうちょう	盗聴	唐朝	登庁	頭長	登頂	頭頂	等張
とうちゅう	頭注	陶鋳
とうちゃん	父ちゃん
とうちゃく	到着
とうちほう	倒置法
とうちせん	等値線
とうちしゃ	統治者
とうちしき	倒置式
とうだいり	東大理
とうだいじ	東大寺
とうたつは	到達波
とうたつど	到達度
とうそしき	当組織
とうそくど	等速度
とうせんご	当選後
とうせきじ	透析時
とうせきき	透析機
とうせいは	統制派
とうじろう	藤治郎
とうじりつ	透磁率
とうじょう	東条	登城	筒状	搭乗	登場	刀杖	頭状	東上	凍上	棟上	東條	東城
とうじばん	東寺版
とうじつう	当日売
とうじせい	等時性
とうじすで	当時既
とうじしゃ	当事者
とうじさい	冬至祭
とうじこく	当事国
とうじいん	等持院
とうしょく	当職	東食
とうしょう	闘将	東証	刀傷	凍傷	闘翔	刀匠
とうしゅく	投宿
とうしゅう	踏襲	東周	等終
とうしゃひ	当社比
とうしとう	投資等
とうしせん	唐詩選
とうししゃ	投資者
とうしがく	投資額
とうさんご	倒産後
とうさいば	当歳馬
とうさいと	当サイト
とうさいき	搭載機
とうごろん	統語論
とうごてき	統語的
とうごけい	頭語系
とうごうご	統合後
とうごうき	統合器
とうごうか	統合化
とうこうび	登校日	投稿日
とうこうじ	登校時	投稿時
とうこうご	投稿後
とうげみち	峠道
とうげぞく	峠族
とうげごえ	峠越
とうげこう	登下校
とうげえき	峠駅
とうげいか	陶芸家
とうけつろ	凍結路
とうけいぶ	頭頸部
とうけいち	統計値
とうくろう	藤九郎
とうぎょう	陶業
とうぎゅう	闘牛
とうきょり	等距離
とうきょく	当局
とうきょう	東京	東教
とうきゅう	等級	討究	投球	東急
とうきゃく	等脚
とうきぶつ	投棄物
とうきてき	投機的
とうきせん	登記船
とうきせい	投機性	陶器製
とうきすじ	投機筋
とうきしょ	登記書	登記所
とうきかく	当企画
とうがらし	唐辛子
とうがった	遠刈田
とうがっか	当学科
とうかんし	等閑視
とうかりつ	透過率
とうかめん	透過面
とうかまち	十日町
とうかてん	等価点
とうかてき	透過的	等価的
とうかつぶ	統括部	統轄部
とうかせる	等価セル
とうかせい	等価性	透過性
とうかこう	透過光
とうかげん	桃花源
とうかがた	透過型
とうかかん	十日間
とうかかく	当価格	等価格
とうかおん	透過音
とうかいし	東海市
とうえいず	投影図
とうえいき	投影機
とういてき	等位的
とういつば	統一場
とういつか	統一化
といれよう	トイレ用
といやまち	問屋町
といみさき	都井岬
といあわせ	問い合わせ	問合せ	問合	問い合せ	問合わせ
てんりょう	転寮	天領
てんりゅう	点流	天竜	天龍
てんりだい	天理大
てんりせん	天理線
てんらくし	転落死
てんやもの	店屋物
てんもんや	天文屋
てんもんぶ	天文部
てんもんか	天文家
てんまばし	天満橋
てんまつき	顛末記
てんません	伝馬船
てんまがわ	天満川
てんぽがた	店舗型
てんぷらや	天麩羅屋
てんぷいた	添付致
てんぶくろ	天袋
てんぴょう	天平
てんぴぼし	天日干し
てんぴじお	天日塩
てんびんざ	天秤座
てんびょう	点描
てんはくく	天白区
てんのうず	天王州
てんのうじ	天王寺
てんのうけ	天皇家
てんにんか	天人花
てんにゅう	転入
てんどうし	天童市
てんとくじ	天徳寺
てんとうじ	点灯時	転倒時
てんでんか	点電荷
てんてつき	転轍機
てんちょう	天聴	天頂	転調	店長
てんちゅう	天誅	天柱	転注
てんちじん	天地人
てんたいや	天体屋
てんそうろ	転送路
てんそうじ	転送時
てんそうき	転送機
てんせいご	転生後
てんじんや	天神屋
てんじよう	点字用
てんじょう	殿上	点状	天上	纏繞	天井	添乗	天壤	天壌
てんじゅう	転住
てんじもう	展示申
てんじほう	展示法
てんじぶつ	展示物
てんじひん	展示品
てんじしゃ	展示車
てんじしつ	展示室
てんじきき	展示機器
てんじかん	展示館
てんじかい	展示会
てんじいん	展示員
てんしょく	天職	転職
てんしょう	天承	転生	天昇	天象	天正
てんしゅん	転瞬
てんしゅつ	転出	点出
てんしやく	天使役
てんしゃく	転借
てんしたち	天使達
てんさいじ	転載時	天才児
てんさいご	転載後
てんさいか	転載可
てんこもり	天こ盛り
てんけいち	典型値
てんぐやま	天狗山
てんぐまい	天狗舞
てんぐばし	天狗橋
てんぐたけ	天狗茸
てんぐざる	天狗猿
てんぎょう	転業
てんきんひ	転勤費
てんきょう	癲狂
てんきゅう	天球
てんきあめ	天気雨
てんがくぶ	転学部
てんかんろ	転換炉
てんかんじ	転換時
てんかんき	転換器	転換期
てんかまえ	点火前
てんかぶつ	添加物
てんかふん	天花粉
てんかびと	天下人
てんかとり	天下取り
てんかてい	点過程
てんかじき	点火時期
てんかしん	点加振
てんかざい	添加剤
てんかけい	点火系
てんかいぶ	展開部
てんかいち	天下市
てんかいず	展開図
てんかいじ	展開時
てんかいご	展開後
てんいがい	点以外
てろそしき	テロ組織
てれびらん	テレビ欄
てれびよう	テレビ用
てれびだい	テレビ台
てるびうむ	Terbium	Tb
てりょうり	手料理
てりかえし	照り返し
てらどまり	寺泊
てらしょう	寺庄
てらしあわ	照らし合
てらがいと	寺垣内
てらおとこ	寺男
てもときん	手許金
てまりうた	手鞠唄	手毬唄	手鞠歌
てまつぶし	手間潰し
てまきずし	手巻き寿司	手巻寿司
てまえみそ	手前味噌
てまえがわ	手前側
てほんびき	手本引き
てべんとう	手弁当
てふうきん	手風琴
てびょうし	手拍子
てびきだい	手引第
てびきしょ	手引書
てびきあん	手引案
てはいしょ	手配書
てなぐさみ	手慰み
てどりがわ	手取川
てつやぐみ	徹夜組
てつめんぴ	鉄面皮
てつぶんか	鉄文化
てつびょう	鉄鋲
てつづきち	手続き値
てつたろう	哲太郎	鉄太郎
てつじろう	哲治郎
てつじょう	鉄条
てつごうし	鉄格子
てつけきん	手付金
てつきどう	鉄軌道
てつがくし	哲学史
てつがくか	哲学科
てつかぶと	鉄兜
てつあれい	鉄亜鈴
てっていか	徹底化
てっちゅう	鉄柱
てっしょう	徹宵	哲章	鉄漿
てっしゅう	撤収	撤收
てっきょご	撤去後
てっきょう	鉄橋
てっきゅう	鉄球
てっかめん	鉄仮面
てっかまき	鉄火巻	鉄火巻き
てだすかり	手助かり
てぜんたい	手全体
てすとばん	テスト版
てしんごう	手信号
てしがわら	勅使河原
てしおざら	手塩皿
てしおがわ	天塩川
てさぎょう	手作業
てけいさん	手計算
てくらがり	手暗がり
てぎれきん	手切れ金
てきれいき	適齢期
てきりょう	適量
てきようぶ	適用部
てきようじ	適用時
てきようご	適用後
てきみかた	敵味方
てきふてき	適不適
てきひょう	適評
てきどうし	敵同士
てきちょく	躑躅
てきちゅう	的中	適中
てきたいし	敵対視
てきせいち	適正値
てきせいか	適正化
てきじょう	敵情
てきしょく	適職
てきしょう	敵将
てきしゅつ	剔出	摘出
てきしゅう	敵襲
てきごうど	適合度
てきごうか	適合化
てきぎょう	適業
てきおうど	適応度
てきおうか	適応化
てきあいて	敵相手
てがたほう	手形法
てがきもじ	手書き文字
ていれべる	低レベル
ていりょう	定量
ていりゅう	停留	底流
ていよさん	低予算
ていよくき	低翼機
ていゆほう	提喩法
ていみつど	低密度
ていびょう	帝廟
ていひんど	低頻度
ていひょう	定評
ていばいき	逓倍器
ていはくち	停泊地
ていのうど	低濃度
ていねんぴ	低燃費
ていねんご	停年後
ていねいご	丁寧語
ていっぱい	手一杯
ていちょく	挺直
ていちょう	低調	丁重	鄭重	低潮
ていちゃく	定着
ていちしき	定置式
ていちあみ	定置網
ていたらく	為体	低鱈苦
ていたいび	停滞日	定退日
ていそしき	定礎式
ていそくど	定速度	低速度
ていそくじ	低速時	定速時
ていそくか	低速化
ていせいご	訂正後
ていすうち	定数値
ていじょう	呈上	堤上	定常
ていじゅう	定住
ていじほう	提示法	定時法
ていじせい	定時制
ていじすう	提示数
ていじごと	定時毎
ていじげん	低次元
ていじおん	提示音
ていしろう	偵四郎
ていしょく	定食	定職	牴触	定植	抵触	停職
ていしょう	低唱	提唱	定昇
ていしゅつ	挺出	提出
ていしゅく	貞淑
ていしゅう	鄭州	挺秀	定収
ていしゃば	停車場
ていしゃじ	停車時
ていしゃご	停車後
ていしぼう	低脂肪
ていしつど	低湿度
ていしせん	停止線
ていしせい	低姿勢	停止性
ていしげき	低刺激
ていしきか	定式化
ていしえき	停止液
ていしいち	停止位置
ていしいた	停止致
ていざいは	定在波
ていさつき	偵察機
ていこすと	低コスト
ていこうち	抵抗値
ていこうき	抵抗器
ていげんか	低減化
ていけいし	定型詩
ていぎょう	帝業
ていぎもじ	定義文字
ていぎほう	定義法
ていぎぶん	定義文
ていぎづけ	定義付け
ていぎたい	定義体
ていぎせつ	定義節
ていぎしき	定義式
ていぎぐん	定義群
ていぎいき	定義域
ていきんり	低金利
ていきょう	帝京	貞享	提供
ていきゅう	低級	定休	涕泣	庭球
ていきびん	定期便
ていきのう	低機能
ていきどう	低軌道
ていきてき	定期的
ていきだい	定期代
ていきせん	定期戦	定期船
ていきけん	定期券
ていきいれ	定期入	定期入れ
ていきあつ	低気圧
ていかんど	低感度
ていかんし	定冠詞
ていかかく	低価格
ていかいか	定価以下
ていおんぶ	低音部
ていおんじ	低温時
ていおんか	低温下
ていいきぶ	低域部
ていいかん	定位感
ていいかぶ	低位株
ていあんご	提案後
てぃーじろ	Ｔ字路	T字路
つるみせん	鶴見線
つるっぱげ	つるっ禿
つるたろう	鶴太郎
つるじろう	鶴次郎
つるしあげ	吊し上げ
つるぎざき	剣崎
つるきえき	鶴来駅
つるがみね	鶴ヶ峰
つるがしま	鶴ヶ島
つるがこう	敦賀港
つるがかん	敦賀間
つるがおか	鶴岡
つるおかし	鶴岡市
つりどうぐ	釣道具	釣り道具
つりぐてん	釣具店
つりおとし	吊り落とし
つらよごし	面汚し
つらのかわ	面の皮
つらがまえ	面構え
つゆはらい	露払い
つゆいこう	梅雨以降
つやません	津山線
つもあがり	自模和了
つめあわせ	詰め合わせ	詰合せ
つむじかぜ	旋風
つむぎうた	紡ぎ唄
つむぎいと	紬糸
つみつくり	罪作り
つみかさね	積み重ね
つみおろし	積み卸し
つみいしき	罪意識
つまようじ	爪楊枝
つまみぐい	摘み食い	撮み食い	つまみ食い
つまびらか	審らか	詳らか
つまはじき	爪弾き
つまさきだ	爪先立
つぼたんか	坪単価
つぼあたり	坪当り	坪当たり
つぶぞろい	粒揃い
つぶじょう	粒状
つばめざわ	燕沢
つばめがえ	燕返
つばくらめ	燕
つばきやま	椿山
つばきひめ	椿姫
つばきはら	椿原
つのごろう	角五郎
つのかくし	角隠し
つねひごろ	常日頃
つなわたり	綱渡	綱渡り
つとめびと	勤め人
つとめにん	勤め人
つとめさき	勤め先
つとめぐち	勤め口
つづりかた	綴方
つづらおり	九十九折り	葛折
つづきもの	続き物
つづきがら	続柄	続き柄
つつもたせ	美人局
つつみやき	包み焼き
つつみむし	包み蒸し
つつみまち	堤町
つつみがみ	包み紙
つつじょう	筒状
つつじもく	ツツジ目	Ericales
つつしんで	謹んで
つつがむし	恙虫
つちみかど	土御門
つちぼこり	土埃
つちふまず	土踏まず
つちのとみ	己巳
つちのとう	己卯
つちのとい	己亥
つちのえね	戊子
つちつかず	土付かず
つちけむり	土煙
つちけいろ	土気色
つちうらし	土浦市
つちいじり	土弄り
つだじゅく	津田塾
つじばしゃ	辻馬車
つじぐるま	辻車
つじがどう	辻ヶ堂
つしまなか	津島中
つこうまつ	仕
つけやきば	付焼刃	付け焼刃	付け焼き刃
つけまつげ	付け睫毛
つけとどけ	付け届け
つけっぱな	付けっ放
つけぐすり	付け薬
つくりもの	作り物
つくりなお	作り直
つくりつづ	作り続
つくりつけ	作り付け
つくりごと	作り事
つくりごえ	作り声
つくりこみ	作り込み
つくりかた	作り方
つくりかえ	作り替え
つくりおき	作り置き
つくもがみ	付喪神	九十九髪
つくばはく	筑波博
つくばだい	筑波大
つくばしぶ	筑波支部
つくばさん	筑波山
つくばけん	筑波研
つくばえき	筑波駅
つくだじま	佃島
つくしごと	筑紫箏
つくしかん	筑紫館
つくえがた	机型
つくいはま	津久井浜
つくいかん	津久井間
つぎのすけ	継之助
つぎしきし	継色紙
つきみばし	月見橋
つきみそう	月見草
つきみざけ	月見酒
つきまいり	月参り
つきばらい	月払い
つきはじめ	月初め
つきのもの	月の物
つきのはら	月野原
つきていど	月程度
つきたらず	月足らず
つきたおし	突き倒し
つきせかい	月世界
つきじぐち	築地口
つきさっぷ	月寒
つきがわり	月代り
つきかいひ	月会費
つきおとし	突き落とし
つきあわせ	突合せ
つきあたり	突き当たり	突当り	突き当り
つきあたま	月頭
つきあかり	月明り	月明かり
つがるわん	津軽湾
つがるべん	津軽弁
つがるふじ	津軽富士
つがるぬり	津軽塗
つがるせん	津軽線
つかみほん	束見本
つかみなげ	掴み投げ
つかぬこと	付かぬ事
つかさめし	司召
つかがしら	柄頭
つかうまつ	仕
つかいわけ	使い分け
つかいやす	使い易
つかいもの	使いもの	遣い物	使い物
つかいみち	使い道	使い途
つかいまわ	使い回
つかいふる	使い古
つかいばん	使い番
つかいばし	使い走
つかいはじ	使い始
つかいにく	使い難
つかいづら	使い辛
つかいすて	使い捨て	使い棄て
つかいかた	使い方
つえはしら	杖柱
つうわだい	通話代
つうわせい	通話制
つうろはば	通路幅
つうろがわ	通路側
つうようど	通用度
つうやくし	通訳氏
つうふうき	通風機
つうはんや	通販屋
つうちょう	通帳	通牒
つうちしょ	通知書
つうじょう	通常
つうじてき	通時的
つうじかい	通字解
つうしんろ	通信路
つうしんぼ	通信簿
つうしんひ	通信費
つうしんじ	通信時
つうしんし	通信士
つうしんき	通信機
つうしんか	通信課	通信科
つうしょう	通商	通称
つうしゃく	通釈
つうごのみ	通好み
つうこうか	通行可
つうぎょう	通暁
つうきんろ	通勤路
つうきんひ	通勤費
つうきんじ	通勤時
つうきせい	通気性
つうきこう	通気孔	通気口
つうがくろ	通学路
つうがくじ	通学時
つうかんじ	通関時
つうかんご	通関後
つうかてん	通過点
つうかせん	通過線
つうかこく	通過国
つうかきき	通貨危機
つうかがた	通過型
つうかえき	通過駅
つうかいき	通過域
ついらくし	墜落死
ついほばん	追補版
ついてまわ	付いて回
ついちょう	追徴
ついじゅく	追熟
ついじゅう	追従
ついしょう	追従
ついしけん	追試験
ついきゅう	追求	追究	椎弓	追給	追及
ついきしき	追記式
ついかれい	追加例
ついかぶん	追加分
ついかばん	追加版
ついかてん	追加点
ついかてき	追加的
ちんりろん	珍理論
ちんりょう	賃料
ちんむるい	珍無類
ちんみょう	珍妙
ちんぼつご	沈没後
ちんぷれー	珍プレー
ちんばめん	珍場面
ちんにゅう	闖入
ちんちょう	珍重
ちんちゃく	沈着
ちんせいか	鎮静化
ちんじょう	陳情	陳状
ちんじゅふ	鎮守府
ちんじゅつ	陳述
ちんじゅう	珍獣	珍重
ちんしゃく	賃借
ちんこんか	鎮魂歌
ちんきろく	珍記録
ちんきゅう	陳宮
ちんきゃく	珍客
ちんかさい	鎮火祭	鎮花祭
ちわげんか	痴話喧嘩
ちりょうひ	治療費
ちりょうじ	治療時
ちりょうし	治療師
ちりょうご	治療後
ちりょうき	治療器
ちりゆきえ	知里幸恵
ちりゅうし	知立市
ちりめんえ	縮緬絵
ちりましほ	知里真志保
ちりあくた	塵芥
ちらしずし	散らし寿司	ちらし寿司	散らし鮨
ちらしがき	散らし書き
ちよちょう	千代町
ちよだせん	千代田線
ちょんりま	千里馬
ちょんまげ	丁髷
ちょんがけ	丁斧掛け
ちょりゅう	貯留
ちょびひげ	ちょび髭
ちょっこう	直航	直交	直行
ちょっけつ	直結
ちょっけい	直系	直径
ちょっきん	直近
ちょっきょ	勅許
ちょっかん	直観	直諫	直感	直管
ちょっかつ	直轄
ちょっかく	直覚	直角
ちょっかい	直快
ちょぞうこ	貯蔵庫
ちょすかべ	長宗我部
ちょすいち	貯水池
ちょじゅつ	著述
ちょさくか	著作家
ちょこざい	猪口才
ちょくれつ	直列
ちょくれい	直隷	勅令
ちょくりつ	直立
ちょくやく	直訳
ちょくめん	直面
ちょくめい	勅命
ちょくほう	直方
ちょくひつ	直筆
ちょくばい	直売
ちょくはん	勅版	直販
ちょくはい	直配
ちょくにん	勅任
ちょくどく	直読
ちょくどう	直道	直動
ちょくとう	直答	勅答	直刀
ちょくつう	直通
ちょくだい	勅題
ちょくたつ	直達
ちょくぞく	直属
ちょくそう	直送
ちょくぜん	直前
ちょくぜい	直税
ちょくせん	勅撰	直線
ちょくせつ	直截	直接
ちょくせき	直積
ちょくせい	直生
ちょくしん	直進
ちょくしょ	勅書
ちょくしゃ	直写	直射
ちょくさい	直截	直裁	勅裁
ちょくげん	直言
ちょくげき	直撃
ちょくがん	勅願
ちょくおん	直音
ちょくおう	直往
ちょくえん	直掩
ちょくえい	直営	直衛
ちょうろう	長老	嘲弄
ちょうれん	長連	調練
ちょうれい	朝礼
ちょうるい	鳥類
ちょうりば	調理場
ちょうりつ	町立	調律
ちょうりし	調理師
ちょうりき	調理器
ちょうらく	長楽	凋落
ちょうらい	朝来
ちょうよう	朝陽	町陽	重用	長幼	徴用	重陽
ちょうゆう	町有
ちょうやく	調薬	重訳	跳躍	超訳
ちょうもん	弔問	長門	聴聞
ちょうもと	帳元
ちょうもじ	超文字
ちょうもく	鳥目
ちょうめん	帖面	帳面
ちょうめい	町名	朝命	長明	長命	澄明
ちょうむち	超無知
ちょうむす	蝶結
ちょうみん	兆民	町民
ちょうみつ	稠密
ちょうまる	朝丸
ちょうまつ	長松
ちょうぼん	超凡
ちょうぼう	眺望
ちょうほう	重宝	調法	長方	諜報	弔砲
ちょうへん	長編	長辺	長篇
ちょうへき	腸壁
ちょうへい	長平	長兵	徴兵
ちょうぶん	弔文	長文
ちょうぶつ	長物
ちょうぶく	調伏
ちょうふし	調布市
ちょうふく	重複
ちょうばつ	懲罰
ちょうばく	帳幕
ちょうはん	丁半
ちょうはつ	調髪	長髪	挑発	挑撥	徴発
ちょうはい	朝拝	停廃
ちょうにん	町人
ちょうなん	嘲難	長南	長男
ちょうなめ	手斧目
ちょうない	町内	腸内
ちょうどよ	丁度良
ちょうどう	庁堂	町道
ちょうとく	長徳
ちょうとう	長刀
ちょうでん	弔電	長電
ちょうてん	長点	頂点
ちょうてき	朝敵
ちょうてい	調定	超低	朝廷	長堤	調停
ちょうづら	帳面
ちょうづめ	腸詰
ちょうづけ	丁付
ちょうちん	提灯
ちょうちょ	蝶々
ちょうだつ	超脱
ちょうだい	朝大	頂戴	鳥大	長大
ちょうたん	長短	超短	頂端
ちょうたつ	暢達	調達
ちょうたく	彫琢
ちょうたい	長体
ちょうぞく	超俗
ちょうぞう	彫像	長蔵
ちょうそん	町村
ちょうそく	長足
ちょうそう	鳥葬
ちょうぜん	超然
ちょうぜつ	超絶
ちょうぜい	徴税	町税
ちょうせん	朝鮮	挑戦	貂蝉
ちょうせつ	調節
ちょうせき	潮汐	長石
ちょうせい	長征	調製	調整	長逝	長生	頂生	調声	町政	調性	町制
ちょうすけ	長介
ちょうじん	鳥人	釣人	超人	超神
ちょうじり	帳尻
ちょうじょ	長女
ちょうじゅ	長寿
ちょうじゃ	長者
ちょうじつ	長日
ちょうじく	長軸
ちょうしん	長身	調進	聴診	寵臣	朝臣	長針
ちょうしよ	調子良
ちょうしょ	長所	調書
ちょうしゅ	聴取
ちょうしゃ	聴者	庁舎
ちょうしし	銚子市
ちょうしお	調子落
ちょうざい	聴罪	調剤
ちょうさん	張三	逃散
ちょうさぶ	調査部
ちょうさひ	調査費
ちょうさか	調査課
ちょうさい	兆載	調査委
ちょうごう	調合	調号
ちょうこん	長恨
ちょうこつ	腸骨
ちょうこく	超克	彫刻
ちょうこう	聴講	長講	兆候	長江	嘲詬	徴候	釣行	朝貢	調貢	超高	釣鉤	調光	潮紅	調香	長考
ちょうげん	超弦	超限	調弦
ちょうけん	長剣	朝憲	朝権	聴検
ちょうけつ	長欠
ちょうけし	帳消し
ちょうけい	長径	蝶形	長兄	長形
ちょうぐう	寵遇
ちょうきん	超勤	彫金
ちょうきょ	聴許
ちょうきち	長吉
ちょうきか	長期化
ちょうがん	腸癌
ちょうがた	蝶形
ちょうがく	調楽	重学
ちょうがい	鳥害	町外
ちょうかん	朝刊	長巻	腸管	聴感	長官	鳥瞰
ちょうかく	弔客	聴覚	頂角	長角
ちょうかい	町会	懲戒	嘲詼	潮解	鳥海	朝会
ちょうおん	長音	聴音	調音
ちょうえん	腸炎	長円	兆円
ちょうえつ	超越
ちょうえき	懲役
ちょうえい	町営
ちょういん	調印
ちょういち	長一
ちょういき	町域
ちょうあん	長安
ちょうあつ	調圧
ちょうあく	懲悪
ちょうあい	寵愛	帳合い	丁合い	丁合	帳合
ちゆこうか	治癒効果
ちゅんりー	春麗
ちゅうろく	中肋
ちゅうろう	中老	柱廊
ちゅうれつ	中裂
ちゅうれい	昼礼
ちゅうるい	忠類
ちゅうりん	駐輪
ちゅうりつ	中立
ちゅうりき	中力
ちゅうよう	中葉	中庸
ちゅうゆう	忠勇
ちゅうもん	中門	注文
ちゅうもく	注目
ちゅうめん	柱面	中免
ちゅうみつ	稠密
ちゅうぼく	忠僕
ちゅうぼう	厨房
ちゅうほん	中本
ちゅうべい	駐米	中米
ちゅうへん	中辺	中篇	中編
ちゅうへい	駐兵
ちゅうぶん	籀文	中文
ちゅうぶる	中古
ちゅうぶう	中風
ちゅうふく	中腹
ちゅうふう	中風
ちゅうばん	注番	中盤	中判
ちゅうばつ	誅罰	誅伐
ちゅうばち	中鉢
ちゅうはば	中幅
ちゅうはい	酎ハイ
ちゅうのり	宙乗り
ちゅうのう	中脳
ちゅうねん	中年
ちゅうにち	駐日	中日
ちゅうにく	中肉
ちゅうなん	仲南
ちゅうどく	中毒
ちゅうどう	中動	中堂	中道
ちゅうとん	駐屯
ちゅうとろ	中トロ
ちゅうとし	中都市
ちゅうとう	中東	中唐	中等	偸盗	仲冬	柱棟	中闘	柱頭
ちゅうでん	中伝	中電
ちゅうてん	沖天	冲点	宙天	中点	中天	沖点	・
ちゅうてつ	鋳鉄	中鉄
ちゅうてい	中低
ちゅうづり	宙釣り	宙吊り
ちゅうちょ	躊躇
ちゅうだん	中段	中団	中断
ちゅうだい	中台	中大
ちゅうたい	紐帯	中諦	中退	中隊	柱体
ちゅうぞう	宙三	忠三	鋳造	鑄像
ちゅうそん	中尊
ちゅうそつ	中卒
ちゅうそく	中速
ちゅうそう	中層	抽送
ちゅうぜつ	中絶
ちゅうぜい	中背
ちゅうせん	抽籤	抽選
ちゅうせつ	忠節
ちゅうせき	柱石	沖積
ちゅうせい	中性	忠誠	中正	中世
ちゅうすけ	忠輔
ちゅうすう	中枢
ちゅうすい	注水	虫垂
ちゅうじょ	中所	忠恕
ちゅうじつ	忠実
ちゅうじく	中軸
ちゅうしん	忠臣	中震	注進	中心	忠心	衷心
ちゅうしょ	中所
ちゅうしゃ	注射	駐車
ちゅうざん	中山
ちゅうざら	中皿
ちゅうざい	駐在
ちゅうさん	中３	中3	中産	昼餐	注参	中三
ちゅうさつ	駐箚	誅殺
ちゅうさい	仲裁
ちゅうごし	中腰
ちゅうごく	中国	中國
ちゅうこや	中古屋
ちゅうこく	忠告
ちゅうこき	中古機
ちゅうこう	中公	中耕	中高	中古売	中興	鋳鋼	昼行	忠孝
ちゅうげん	中間	忠言	中原	中元
ちゅうけん	中堅	忠犬	中研
ちゅうけい	仲兄	中啓	中計	中継	中繼
ちゅうぐう	中宮
ちゅうくん	忠君
ちゅうくう	中空	宙空
ちゅうきん	鋳金	忠勤	駐禁
ちゅうきぼ	中規模
ちゅうきち	忠吉
ちゅうがん	中観
ちゅうがた	中型	中形
ちゅうがく	中学
ちゅうがえ	宙返
ちゅうがい	中外	虫害
ちゅうかん	中間	中巻	中環	昼間
ちゅうから	中辛
ちゅうかや	中華屋
ちゅうかひ	中果皮
ちゅうかく	中隔	中核
ちゅうかい	注解	厨芥	仲介
ちゅうおん	中音
ちゅうおし	中押	中押し
ちゅうおう	紂王	中央	中欧
ちゅうえい	中映	中衛
ちゅういん	中陰
ちゅういち	忠一	中一	中1	中１
ちゅういき	中域
ちゅうあつ	中厚
ちゃんすう	昌洙
ちゃんすー	Jiangsu	江蘇
ちゃやみち	茶屋道
ちゃやまち	茶屋町
ちゃめっけ	茶目っ気
ちゃぼうず	茶坊主
ちゃぼうき	茶箒
ちゃぶだい	茶袱台	卓袱台
ちゃばなし	茶話
ちゃばたけ	茶畑	茶畠
ちゃばしら	茶柱
ちゃばおり	茶羽織
ちゃのはら	茶之原
ちゃどころ	茶所
ちゃどうぐ	茶道具
ちゃっこう	着工
ちゃっけん	着剣
ちゃっきん	着金
ちゃっかん	着艦
ちゃだんす	茶箪笥
ちゃじゅう	茶頭
ちゃしゃく	茶杓
ちゃくりく	着陸
ちゃくよう	着用
ちゃくもく	着目
ちゃくめろ	着メロ
ちゃくふく	着服
ちゃくひつ	着筆
ちゃくばら	着払
ちゃくはつ	着発
ちゃくにん	着任
ちゃくなん	嫡男
ちゃくとう	着到
ちゃくでん	着電
ちゃくてい	着挺
ちゃくちじ	着地時
ちゃくだん	着彈	着弾
ちゃくだつ	着脱
ちゃくたい	着帯
ちゃくそん	嫡孫
ちゃくそう	着装	着想
ちゃくせん	着船
ちゃくせつ	着雪
ちゃくせき	着席
ちゃくせい	着生
ちゃくすい	着水
ちゃくじつ	着実
ちゃくしん	着信
ちゃくしゅ	着手
ちゃくしつ	嫡室
ちゃくさい	嫡妻
ちゃくごえ	着声
ちゃくこう	着工
ちゃくがん	着岸	着眼
ちゃくがい	着外
ちゃくえき	着駅
ちゃかぶき	茶歌舞伎	茶香服
ちゃうじま	茶宇縞
ちゃいろじ	茶色地
ちゃあはん	炒飯
ちゃーめん	炒麺
ちゃーはん	炒飯
ちめいてき	致命的
ちほうめん	地方面
ちほうめい	地方名
ちほうべつ	地方別
ちほうぶん	地方分
ちほうばん	地方版
ちほうどう	地方道
ちほうとし	地方都市
ちほうてき	地方的
ちほうぜい	地方税
ちほうせん	地方線
ちほうじち	地方自治
ちほうさい	地方債
ちほうごと	地方毎
ちほうこう	地方校
ちほうがわ	地方側
ちほうかん	地方官
ちべっとご	チベット語
ちへいめん	地平面
ちへいせん	地平線
ちぶつけん	地物研
ちふすきん	チフス菌
ちひょうは	地表波
ちばひがし	千葉東
ちばつうか	千葉通過
ちばししゃ	千葉支社
ちばいえん	千葉以遠
ちのめぐり	血の巡り
ちのなみだ	血の涙
ちのうはん	知能犯
ちのうてき	知能的
ちのうけい	知能系
ちなまぐさ	血腥
ちどりばし	千鳥橋
ちどりあし	千鳥足
ちどうせつ	地動説
ちとせばし	千登世橋
ちとせづる	千歳鶴
ちとせせん	千歳線
ちとせあめ	千歳飴
ちてんかん	地点間
ちていじん	地底人
ちつじょだ	秩序立
ちっぷべつ	秩父別
ちっそくし	窒息死
ちちむすめ	父娘
ちちぶさん	秩父山
ちちばなれ	乳離れ
ちちなしご	父無し子
ちちしぼり	乳搾り
ちちくりあ	乳繰り合
ちちおやに	父親似
ちたいくう	地対空
ちせいてき	知性的
ちせいたい	知性体
ちせいがく	地政学
ちずちょう	地図帳
ちずじょう	地図上
ちじんたち	知人達
ちじんたく	知人宅
ちじょうぶ	地上部
ちじょうは	地上波
ちじょうえ	地上絵
ちじょうい	知情意
ちしりょう	致死量
ちしつがく	地質学
ちしきよく	知識欲
ちしきとう	知識等
ちしきそう	知識層
ちしきじん	知識人
ちしきげん	知識源
ちざいけん	知財権
ちこくしゃ	遅刻者
ちこうふう	地衡風
ちこうせい	遅効性
ちけんやく	治験薬
ちけんしゃ	地権者
ちけいてき	地形的
ちけいがく	地形学
ちぐさいろ	千草色
ちくよせん	地区予選
ちくまがわ	千曲川
ちくふじん	竹夫人
ちくひせん	筑肥線
ちくでんち	蓄電池
ちくでんき	蓄電器
ちくぜんに	筑前煮
ちくじょう	築上	逐条	築城
ちくじてき	逐次的
ちくじせい	逐次性
ちくじがた	逐次型
ちくしょう	畜生
ちくしゅい	地区首位
ちくしぐち	筑紫口
ちくごやく	逐語訳
ちくごてき	逐語的
ちくごがわ	筑後川
ちくきょう	地区協
ちくおんき	蓄音機
ちぎれぐも	千切れ雲
ちぎょうち	知行地
ちきゅうぎ	地球儀
ちがさきし	茅ヶ崎市
ちがくしつ	地学室
ちがいだな	違い棚
ちかんもじ	置換文字
ちかんめい	置換名
ちかんぐん	置換群
ちかろせん	地下路線
ちからわざ	力技	力業
ちからもち	力餅	力持ち	力持
ちからみず	力水
ちからまけ	力負け
ちからまか	力任
ちからぬけ	力抜け
ちからてき	力的
ちからづよ	力強
ちからぞえ	力添え
ちからずく	力ずく	力尽く
ちからこぶ	力瘤	力こぶ
ちからがわ	力革
ちからがみ	力紙
ちからいと	力糸
ちからいし	力石
ちかまわり	近回り
ちかぶぶん	地下部分
ちかつうろ	地下通路
ちかそしき	地下組織
ちかそうこ	地下倉庫
ちかせかい	地下世界
ちかしゃこ	地下車庫
ちかしげん	地下資源
ちかくてき	知覚的
ちかくぞう	知覚像
ちかくせい	知覚性
ちかくかん	地下区間
ちかきょく	地下局
ちおんいん	知恩院
ちえんせん	遅延線
ちえぶくろ	知恵袋
ちえくらべ	知恵競べ	知恵比べ
ちえきけん	地役権
ちえおくれ	知恵遅れ
ちいといつ	七対子
ちいきめい	地域名
ちいきべつ	地域別
ちいきぶん	地域分
ちいきばん	地域版
ちいきない	地域内
ちいきてき	地域的
ちいきせい	地域性
ちいきけい	地域系
ちいきがた	地域型
ちいきがい	地域外
ちいきかん	地域間
ちあんいじ	治安維持
ちーむめい	チーム名
たんりょく	胆力	淡緑
たんりゃく	胆略
たんようき	単葉機
たんみつど	単密度
たんまつき	端末機
たんまつか	端末化
たんぽぶつ	担保物
たんぼいん	単母音
たんほんい	単本位
たんべんか	単弁花
たんぶんか	短文化
たんぴょう	短評	単票
たんびてき	耽美的
たんばばし	丹波橋
たんばぐち	丹波口
たんばいろ	胆礬色
たんばいち	丹波市
たんのはら	旦野原
たんねんど	単年度
たんとうび	担当日
たんとうか	担当課
たんとうい	担当医
たんでんか	単電荷
たんちょう	探鳥	単調	単頂	短調	丹頂
たんだすう	単打数
たんそぼう	炭素棒
たんそぜい	炭素税
たんそきん	炭疽菌
たんそかん	炭素間
たんせんか	単線化
たんせいど	単精度
たんせいか	単性花
たんすいろ	短水路
たんすいこ	淡水湖
たんすいか	淡水化
たんじょう	誕生
たんじゅん	単順	単純
たんじゅう	胆汁	短銃
たんじじつ	短時日
たんじかん	短時間
たんしんし	単振子
たんしろん	単子論
たんしよう	単子葉
たんしょく	単色
たんしょう	短小	短章	探勝	単勝
たんしゅん	探春
たんしゅく	短縮
たんしばん	単篩板
たんしだい	端子台
たんしすう	端子数
たんしかん	端子間
たんざがた	単座型
たんさわこ	丹沢湖
たんさくぎ	探索木
たんさいが	淡彩画
たんごない	単語内
たんごすう	単語数
たんごかん	単語間
たんけんぶ	探検部
たんけんふ	‡	短剣符	†
たんけんか	探検家
たんくかん	短区間
たんぎょく	単玉
たんきょり	短距離	単距離
たんきょく	端局	単極
たんきゅう	単球	探求	探究
たんきゃく	単脚
たんきのう	単機能
たんきとう	単気筒
たんきてき	短期的
たんきしゅ	単機種
たんきかん	短期間
たんがんし	単眼視
たんかんじ	単漢字
たんかぶつ	炭化物
たんいつか	単一化
たんいせつ	単位節
たんいせい	単位制
たんいすう	単位数
たんいげん	単位元
たんいけい	単位系
たんいえん	単位円
たわらまち	俵万智
たわだいら	多和平
たわけもの	戯け者
たろうまる	太郎丸
たれんそう	多連装
たれながし	垂れ流し
たれいしき	他励式
たるみずし	垂水市
たりゅうど	多粒度
たりゅうし	多粒子
たりつてき	他律的
たらばがに	鱈場蟹	多羅波蟹
たらいまわ	盥回
たようたい	多様体
たようせい	多様性	多用性
たようがた	多様型
たもんてん	多聞天
たもくてき	多目的
たもうるい	多毛類
たもうさく	多毛作
ためんてき	多面的
ためんたい	多面体
ためんせい	多面性
ためしざん	試し算
ためしぎり	試し斬り
たみんぞく	多民族
たまらない	堪らない
たまぶくろ	玉袋
たまひろい	球拾い
たまばはき	玉箒
たまのこし	玉の輿
たまのうら	玉之浦
たまてばこ	玉手箱
たまづつみ	玉堤
たまつばき	玉椿
たまつつみ	玉堤
たまつくり	玉造
たまちえき	田町駅
たまちいき	多摩地域
たますだれ	玉簾
たまじゃり	玉砂利
たまごろも	玉衣
たまごやき	卵焼	卵焼き
たまごとじ	卵綴じ
たまござけ	卵酒
たまごがた	卵型
たまごいろ	卵色
たまぐすく	玉城
たまかずら	玉鬘
たまかしき	玉貸機
たほうめん	多方面
たべのこし	食べ残し
たべざかり	食べ盛り
たべあるき	食べ歩き
たへんすう	多変数
たへんけい	多辺形
たぶんむり	多分無理
たぶんかい	多分解
たぶきょく	他部局
たびまわり	旅回り
たびづかれ	旅疲れ
たびすがた	旅姿
たびじたく	旅支度
たびごころ	旅心
たびがらす	旅烏
たびかせぎ	旅稼ぎ
たひんしゅ	多品種
たばるざか	田原坂
たばねがみ	束ね髪
たばたかん	田端間
たばこせん	煙草銭
たのみごと	頼み事
たのしそう	楽しそう
たねんそう	多年草
たねんせい	多年性	多年生
たねがしま	種子島
たねあぶら	種油
たねあかし	種明かし	種明し
たぬきじる	狸汁
たぬきざか	狸坂
たにんどん	他人丼
たにんずう	多人数
たにんさま	他人様
たにんごと	他人事
たにくけい	多肉茎
たなざらし	店晒し
たなごころ	掌
たなごおり	棚氷
たなかだて	田中館
たなおろし	棚卸し
たどつかん	多度津間
たどつえき	多度津駅
たどうてき	他動的
たとえうた	譬え歌
たとうるい	多糖類
たとうすう	多頭数
たとうがみ	畳紙
たてよこひ	縦横比
たてやない	建屋内
たてもよう	縦模様
たてむすび	縦結び
たてばやし	館林
たてのだい	立野台
たてつづけ	立て続け
たてじょう	楯状
たてぎょく	建玉
たてがめん	縦画面
たてえぼし	立烏帽子
たつるはま	田鶴浜
たつのにし	竜野西
たつのくち	辰口	竜ノ口
たつにしき	龍錦
たつたがわ	竜田川
たつたあげ	竜田揚げ
たっちゅう	塔頭
たったいま	たった今
たっせいど	達成度
たっきゅう	卓球	宅急
たちんぼう	立ちん坊
たちろんり	多値論理
たちみせき	立見席
たちみけん	立見券
たちまわり	立回り	立ち回り
たちばなし	立ち話
たちはたら	立ち働
たちどころ	立ち所
たちすがた	立ち姿
たちさがり	立ち下がり
たちげいこ	立ち稽古
たちくらみ	立ち眩み
たちかわり	立ち替わり	立ち代わり
たちかわし	立川市
たちおよぎ	立ち泳ぎ
たちあらわ	立ち現
たちあらい	大刀洗
たちあがり	立ち上がり	立上り
ただんとう	多弾頭
ただんたい	他団体
ただんかい	多段階
ただれいこ	多田麗子
ただみせん	只見線
ただひとり	唯一人
ただひとつ	唯一つ
ただしがき	但書	但し書	ただし書き
ただいがく	他大学
たたみもの	畳物
たたみべや	畳部屋
たたみじき	畳敷
たたみこみ	畳み込み
たたみがみ	畳紙
たたみがえ	畳替え
たたません	田玉線
たたずまい	佇まい
たたきなお	叩き直
たたきつぶ	叩き潰
たたきだい	たたき台	叩き台
たたきころ	叩き殺
たたきかえ	叩き返
たたきおと	叩き落
たたきおこ	叩き起
たたきあげ	叩き上げ
たたいけい	多体系
たたいいち	多対一
たそくるい	多足類
たそうなべ	多層鍋
たそうてき	多相的
たそうせい	多相性
たそうしき	多層式
たそうがた	多相型
たせいぶん	多成分
たずねもの	尋ね物
たずねびと	尋ね人
たずねある	訪ね歩
たすけぶね	助け船
たすけあい	助け合い
たすきぞり	襷反り
たすきがけ	襷掛け
たすうとう	多数党
たすうてん	多数点
たすうだい	多数台
たすうごい	多数語彙
たすうけつ	多数決
たすうがわ	多数側
たすうかい	多数回
たすいいき	他水域
たじゆうど	多自由度
たじゅうは	多重波
たじゅうど	多重度
たじゅうこ	多重呼
たじゅうか	多重化
たじたなん	多事多難
たじたたん	多事多端
たじげんか	多次元化
たしんろん	多神論
たしんせん	多芯線
たしょくか	多色化
たしゅるい	多種類
たしゃびん	他社便
たしゃせん	他社線
たしゃせい	他社製	他者性
たしゃかん	他社間
たしかめあ	確かめ合
たざわぬま	田沢沼
たさくひん	他作品
たさいぼう	多細胞
たごのうら	田子の浦
たこくせき	他国籍	多国籍
たこくさん	他国産
たこくごか	多国語化
たこくかん	多国間
たこうてい	多工程
たこうせい	他校生
たこうしつ	多孔質
たこうしき	多項式
たげんろん	多元論
たげんてき	多元的
たげんせい	多元性
たげんごか	多言語化
たけんれん	他県連
たけりくる	猛り狂
たけぼうき	竹箒
たけばやし	竹林
たけのはま	竹野浜
たけのだい	竹の台
たけのうち	竹内	竹之内
たけつしつ	多血質
たけだけん	竹田研
たけだえき	竹田駅
たけじろう	竹次郎
たけくらべ	丈比べ
たけがはら	竹ヶ原
たけいれつ	他系列
たくじょう	卓上
たくじじょ	託児所
たくじしょ	託児所
たくじしつ	託児室
たくしろう	卓四郎
たくしょく	拓殖
たくしょう	托生
たくしゅつ	卓出
たきょてん	他拠点
たきょくか	多極化
たきのがわ	滝野川	瀧野川
たきのうか	多機能化
たきぎのう	薪能
たきいえき	滝井駅
たきあわせ	炊き合せ
たがりゅう	多賀竜
たがたぐん	田方郡
たがじょう	多賀城
たがいちが	互い違
たがいせん	互い先	互先
たがいしゃ	他会社
たかんせつ	多関節
たかをくく	高を括
たかわらい	高笑い
たからもの	宝物
たからもと	宝本
たからまち	宝町
たからぶね	宝船
たからばこ	宝箱
たからづか	宝塚
たからだま	宝玉
たからずか	宝塚
たからじま	宝島
たからさが	宝探
たからくじ	宝くじ
たかようじ	高楊枝
たかやなぎ	高柳
たかむしろ	簟
たかみすぎ	隆三杉
たかみざわ	高見沢
たかみさわ	高見沢
たかみくら	高御座
たかまつし	高松市
たかまくら	高枕
たかびしゃ	高飛車
たかばやし	高林
たかばなし	高話
たかばたけ	高畠
たかはなだ	貴花田
たかのふじ	孝乃富士
たかのばし	タカノ橋
たかのはら	高の原
たかのはな	貴ノ花
たかのなみ	貴ノ浪
たかのつめ	鷹の爪
たかのぞみ	高望み
たかのせん	高野線
たかのがわ	高野川
たかねざわ	高根沢
たかどまり	高止まり
たかてこて	高手小手
たかつきし	高槻市
たかつかさ	鷹司
たかっけい	多角形
たかせぶね	高瀬舟
たかせがわ	高瀬川
たかじょう	鷹匠	高城
たかしみず	高清水
たかしまや	高島屋
たかしまだ	高島田
たかこくご	多カ国語	多ヶ国語
たかくてき	多角的
たかくすい	多角錐
たかくけい	多角形
たかがみね	鷹峯
たかおざん	高尾山
たかおさん	高尾山
たかおかし	高岡市
たかおえき	高尾駅
たかいびき	高鼾
たかいそう	多階層
たかいずみ	高泉
たかあがり	高上がり
たおんせつ	多音節
たいわよう	対話用
たいわへん	対話篇
たいわてき	対話的
たいわしゃ	対話者
たいわしき	対話式
たいわげき	対話劇
たいわがた	対話型
たいわかた	対話型
たいりょく	体力	耐力
たいりょう	退寮	大量	大猟	大漁
たいりゅう	滞留	対流
たいりゃく	大略
たいらがい	平貝
たいよけん	貸与権
たいようろ	太陽炉
たいようじ	太陽時
たいほれき	逮捕歴
たいほしゃ	逮捕者
たいへんよ	大変良
たいへいき	大平記	太平記
たいふうか	台風下
たいびょう	大病
たいひよう	退避用
たいひょう	体表
たいひてき	対比的
たいひせん	退避線	待避線
たいひじょ	退避所	待避所
たいひごう	待避壕
たいひかん	退避艦
たいひえき	退避駅
たいはくく	太白区
たいなごや	対名古屋
たいないぶ	体内部
たいとしん	対都心
たいとうく	台東区
たいちろう	太一郎
たいちよう	退治用
たいちょう	退庁	体調	体長	隊長	退潮
たいちゅう	対中
たいそしき	体組織
たいそうぶ	体操部
たいせんじ	対戦時
たいせんご	大戦後	対戦後
たいせつさ	大切さ
たいせきは	体積波
たいせきじ	大石寺
たいせいか	体制下	体制化
たいすうち	対数値
たいじょう	退場	帯状
たいじゅん	泰淳
たいじゅつ	体術
たいじゅう	体重
たいしょく	褪色	退職	退色	大食
たいしょう	大将	対照	対称	大正	大捷	大詔	大賞	大勝	代償	対象	大笑	対症	隊商
たいしゅつ	体出	帯出	退出	貸出
たいしゅう	体臭	大周	大衆
たいしゃび	退社日
たいしゃく	帝釈	貸借
たいしぼう	体脂肪
たいしどう	太子堂	大師堂
たいしせん	大師線
たいしこう	太史公
たいしかん	大使館
たいざいび	滞在日
たいざいひ	滞在費
たいざいち	滞在地
たいさなし	大差無
たいさくひ	対策費
たいさくし	対策知
たいさくご	対策後
たいこやき	太鼓焼
たいこもち	幇間
たいこへん	大古編
たいこばん	太鼓判
たいこばら	太鼓腹
たいこたい	太鼓隊
たいこうば	対抗馬
たいこうち	太鼓打
たいこうき	太閤記
たいげんど	体言止
たいけんき	体験記
たいけいず	体系図
たいけいか	体系化
たいぐんか	大群化
たいぎょう	怠業	大業
たいぎゃく	大逆
たいきんじ	退勤時
たいきょく	太極	大極	対極	大曲	大局	対局
たいきょう	体協	胎教	滞京
たいきゅう	耐久
たいきゃく	退却
たいきしゃ	大気社	大氣社
たいきこう	大気光
たいきけん	大気圏
たいきあつ	大気圧
たいがため	体固め
たいがいぶ	対外部
たいかせい	耐火性
たいかざい	耐火材
たいかくさ	体格差
たいかくか	対角化
たいかいご	大会後
たいおとし	体落とし
たいおうづ	対応付
たいおうず	対応図
たいおうか	対応可
たいいほう	対位法
たいあたり	体当り
とんぼがえり	とんぼ返り	蜻蛉返り
とんぷくやく	頓服薬
とんぷうそう	東風荘
とんにきょく	東二局
とんでんへい	屯田兵
とんちんかん	頓珍漢
とんだばやし	富田林
とんじるふう	豚汁風
とんこつあじ	豚骨味
とわずがたり	問わず語り
とろろあおい	黄蜀葵
とろーるせん	トロール船
とりめにあか	Trimeniaceae	トリメニア科
とりほうだい	取り放題
とりひきじょ	取引所
とりひきさき	取引先	取り引き先
とりのこがみ	鳥の子紙
とりのこいろ	鳥の子色
とりにんげん	鳥人間
とりでにこう	取手二高
とりでいほく	取手以北
とりでいえん	取手以遠
とりつぎてん	取次店
とりつかせい	都立家政
とりたてきん	取立金
とりこみさぎ	取込み詐欺	取り込み詐欺
とりけしけん	取消権
とりうちぼう	鳥撃帽
とりあつかい	取扱	取り扱い	取扱い	取あつかい
とらかんむり	虎冠
とよひらがわ	豊平川
とよはしきた	豊橋北
とよはしかん	豊橋間
とよはしえき	豊橋駅
とよとみがた	豊臣方
とよだこうき	豊田工機
とよすふとう	豊洲埠頭
とよしなかん	豊科間
とよあしはら	豊葦原
とやまちょう	戸山町
とやまちてつ	富山地鉄
とやましない	富山市内
とやましがい	富山市街
とやまぎたん	富山技短
ともばたらき	共働き
ともだちかん	友達間
とみやちょう	富谷町
とみたやすこ	富田靖子
とみさとまち	富里町
とみおかにし	富岡西
とまりきゃく	泊り客
とほれんらく	徒歩連絡
とほつうがく	徒歩通学
とほそくはつ	吐哺捉髪
とほすうふん	徒歩数分
とぶくろまど	戸袋窓
とふぎじゅつ	塗布技術
とばてんのう	鳥羽天皇
とばくばしょ	賭博場所
とばくじょう	賭博場
となりどうし	隣同士
となりあわせ	隣合わせ
とないろせん	都内路線
とどろきおん	轟音
とどけでにん	届出人
とどけでせい	届出制
とどけでぎむ	届出義務
とどうふけん	都道府県
とつへいほう	凸閉包
とつげきたい	突撃隊
とつけつごう	凸結合
とつきとうか	十月十日
とつかんすう	凸関数
とつかくみん	戸塚区民
とっぴょうし	突拍子
とっぱりょく	突破力
とっぱつてき	突発的
とっぱつしん	突発疹
とっとりだい	鳥取大
とっとりけん	鳥取県
とっとりかん	鳥取間
とっしんわざ	突進技
とっこうやく	特効薬
とっこうたい	特攻隊
とっけんてき	特権的
とっきょほう	特許法
とっきょけん	特許権
とっきゅうか	特急化
とっきじこう	特記事項
とちゅうちゃ	杜仲茶
とちゅうえき	途中駅
とちもんだい	土地問題
とちたいさく	土地対策
とちくじょう	屠畜場
とちかんかつ	土地管轄
とたんちょう	ト短調
とそうぎょう	塗装業
とじょうだい	図情大
とじょうこく	途上国
としんぶぶん	都心部分
としよりかぶ	年寄株
としょぶもん	図書部門
としょきょく	図書局
としょかかり	図書掛
としでんせつ	都市伝説
としてつどう	都市鉄道
としたいこう	都市対抗
としそうおう	年相応
としこうつう	都市交通
としこうぞう	都市構造
としこうそく	都市高速
としこうがく	都市工学
としけいかく	都市計画
としぎんこう	都市銀行
としきんこう	都市近郊
とざんそうび	登山装備
とざんきゃく	登山客
とざんかいし	登山開始
とさでんてつ	土佐電鉄
とさつじょう	屠殺場
ところばらい	所払い
ところどころ	所々
ところざわし	所沢市
とこやだんぎ	床屋談義
とこなめせん	常滑線
とこじょうず	床上手
とこしぎんざ	戸越銀座
とげとげしい	刺々しい
とけいじかけ	時計仕掛
とけいきのう	時計機能
とくれいほう	特例法
とくれいてき	特例的
とくれいそち	特例措置
とくようひん	徳用品
とくやくてん	特約店
とくめいせい	匿名性
とくむしかん	特務士官
とくむきかん	特務機関
とくまぶんこ	徳間文庫
とくべつわく	特別枠
とくべつほう	特別法
とくべつへん	特別編
とくべつばん	特別版	特別盤
とくべつてん	特別展
とくべつそち	特別措置
とくべつせん	特別戦
とくべつせき	特別席
とくべつせい	特別製
とくべつしつ	特別室
とくべつごう	特別号
とくひょうさ	得票差
とくはつせい	特発性
とくとうせき	特等席
とくてんりつ	得点率
とくてんつき	得点付
とくてんすう	得点数
とくてんしゃ	得点者
とくてんおう	得点王
とくていぶつ	特定物
とくちょうづ	特徴付
とくちょうか	特徴化
とくだいごう	特大号
とくたいせい	特待生
とくそうたい	特捜隊
とくせんひん	特選品
とくせんたい	特戦隊
とくせんがい	特選街
とくせいれい	徳政令
とくせいひん	特製品
とくせいてき	特性的
とくしゅれい	特殊例
とくしゅもじ	特殊文字
とくしゅぶつ	特殊物
とくしゅぶき	特殊武器
とくしゅせい	特殊性
とくしゅこう	特殊鋼
とくしゅけい	特殊形
とくしゅかい	特殊解
とくしゃたい	特車隊
とくしまだい	徳島大
とくしません	徳島線
とくしまけん	徳島県
とくしまかん	徳島間
とくしってん	得失点
とくさんぶつ	特産物
とくさんひん	特産品
とくさぶろう	徳三郎
とくさつよう	特撮用
とくさつもの	特撮物
とくさつしつ	特撮室
とくぎょうし	得業士
とくきじこう	特記事項
とくいぶんや	得意分野
とくいきゃく	得意客
ときわかえで	常磐楓
ときよじせつ	時世時節
ときょうそう	徒競走
ときぶんかつ	時分割
とかちへいや	十勝平野
とかいそだち	都会育ち
とおりちょう	通町
とおりそうば	通り相場
とおりすがり	通りすがり
とおせんぼう	通せん坊
とおしばしら	通し柱
とおさぶらい	遠侍
とおかいちば	十日市場
とえいいがい	都営以外
とうろんしゃ	討論者
とうろんかい	討論会
とうろくりつ	登録率
とうろくよう	登録用
とうろくめい	登録名
とうろくまえ	登録前
とうろくばん	登録版
とうろくずみ	登録済
とうろくすう	登録数
とうろくしょ	登録書
とうろくしゃ	登録者
とうろくしち	登録質
とうろくさき	登録先
とうるいすう	盗塁数
とうるいおう	盗塁王
とうりふげん	桃李不言
とうりつぞう	倒立像
とうらいおん	到来音
とうよりょう	投与量
とうよこてん	東横店
とうよこせん	東横線
とうようふう	東洋風
とうようてき	東洋的
とうようじん	東洋人
とうようけい	東洋系
とうようがく	東洋学
とうようかん	東洋館
とうやまはい	遠山灰
とうもろこし	玉蜀黍
とうめんよう	等面葉
とうめいばん	透明盤
とうめいばす	東名バス
とうめいはん	東名阪
とうめいたい	透明体
とうめいせい	透明性
とうめいかん	透明感	東名間
とうみんまえ	冬眠前
とうまちくい	稲麻竹葦
とうぼうはん	逃亡犯
とうぼうしゃ	逃亡者
とうほんにん	当本人
とうほくよう	東北用
とうほくべん	東北弁
とうほくどう	東北道
とうほくとう	東北東
とうほくちく	東北地区
とうほくだい	東北大学	東北大
とうほくせん	東北戦	東北線
とうほくじん	東北人
とうほくしぶ	東北支部
とうほくさわ	東北沢
とうほうてき	等方的
とうほうせい	等方性
とうほうこう	等方向
とうほうけい	東宝系
とうほうがす	東邦瓦斯
とうほうおき	東方沖
とうほうあん	当法案
とうべんしょ	答弁書
とうへんぼく	唐変木
とうぶんせん	等分線
とうぶんしょ	当文書
とうぶんさき	当分先
とうぶんかつ	等分割
とうぶきょく	当部局
とうひょうび	投票日
とうひょうさ	投票差
とうひょうご	投票後
とうひちゅう	逃避中
とうばんせい	当番制
とうばんこう	当番校
とうばんぐみ	当番組
とうばんかた	登板過多
とうばつたい	討伐隊
とうはいごう	統廃合
とうのむかし	疾うの昔
とうのしょう	東庄
とうのうだい	東農大
とうにんたち	当人達
とうにゅうじ	投入時
とうにゅうご	投入後
とうなんとう	東南東
とうなんしゃ	盗難車
とうなんげき	盗難劇
とうとうきき	東陶機器
とうでんがわ	東電側
とうてんこう	東天紅
とうていむり	到底無理
とうちょうぶ	頭頂部
とうちょうき	盗聴器
とうちゃくび	到着日
とうちゃくち	到着地
とうちゃくじ	到着時
とうちゃくご	到着後
とうちゃくき	到着機
とうちこうい	統治行為
とうだんたい	当団体
とうだんしゃ	登壇者
とうだいやく	東大薬
とうだいもり	灯台守
とうだいまえ	東大前
とうだいほう	東大法
とうだいのう	東大農
とうだいせい	東大生
とうだいこう	東大工
とうだいがわ	東大側
とうだいがく	当大学
とうだいうら	東大裏
とうだいいん	東大院
とうたつてん	到達点
とうたつせい	到達性
とうたいかい	党大会
とうぞくなど	盗賊等
とうぞくだん	盗賊団
とうぞくけい	盗賊系
とうそつせい	統率性
とうそくるい	頭足類
とうそうせん	東早戦
とうそうしん	闘争心
とうそうおん	唐宋音
とうせんしゃ	当選者
とうせんかろ	冬扇夏炉
とうせきしつ	透析室
とうせいふう	当世風
とうすうけん	統計数理研究所	統数研
とうすいだい	東水大
とうすいけん	統帥権
とうじんまち	唐人町
とうじんぼう	東尋坊
とうじょうび	搭乗日
とうじょうじ	登場時	搭乗時
とうじょうご	登場後
とうじょうか	頭状花
とうじぶんき	等時分岐
とうじつぶん	当日分
とうじつけん	当日券
とうじつあさ	当日朝
とうしんだい	等身大
とうしんせん	等深線
とうしりょく	透視力
とうしょらん	投書欄
とうしょばこ	投書箱
とうしゅめい	投手名
とうしゅせん	投手戦
とうしゅじん	投手陣
とうしゃばん	謄写版
とうしばばん	東芝版
とうしばなす	東芝那須
とうしばせい	東芝製
とうしばけい	東芝系
とうしばぐち	東芝口
とうしつせい	透湿性	等質性
とうしたんい	投資単位
とうしじゅつ	透視術
とうしこうか	投資効果
とうしがほう	透視画法
とうざよきん	当座預金
とうざのがれ	当座逃れ
とうざしさん	当座資産
とうざいせん	東西線
とうさんさい	唐三彩
とうさくしゃ	倒錯者
とうさいしゃ	搭載車
とうさいぎょ	当歳魚
とうさいかん	搭載艦
とうさいうお	当歳魚
とうさいいち	搭載位置
とうごじょう	統語上
とうごうりつ	統合率
とうごうほう	統合法
とうごうばん	統合版
とうごうてき	統合的
とうごうせい	等号性	統合性
とうごうがた	統合型
とうごうあん	統合案
とうこうれき	投稿歴
とうこうよう	投稿用
とうこうまえ	投稿前
とうこうへい	投降兵
とうこうぶん	投稿文
とうこうにん	党公認
とうこうなみ	投稿並
とうこうだい	東京工業大学	東工大
とうこうせん	等高線
とうこうずみ	投稿済
とうこうすう	投稿数
とうこうしゃ	投稿者
とうこうさき	投稿先
とうこうきじ	投稿記事
とうこうがわ	投稿側
とうこういと	投稿意図
とうこういた	投稿致
とうげつぶん	当月分
とうげつざん	当月残
とうげこうじ	登下校時
とうけんるい	刀剣類
とうけつまえ	凍結前
とうけいよう	統計用
とうけいてき	統計的
とうけいごさ	統計誤差
とうけいがく	統計学
とうぐうぼう	春宮坊
とうぎゅうし	闘牛士
とうぎじょう	闘技場
とうぎじこう	討議事項
とうきんせん	東金線
とうきりえき	当期利益
とうきょうと	東京都
とうきょうご	東京語
とうきょうが	東京画
とうきょうう	東京生
とうきゅうじ	投球時
とうきへいさ	冬季閉鎖	冬期閉鎖
とうきちろう	藤吉郎
とうきごりん	冬季五輪
とうがいこつ	頭蓋骨
とうがいこく	当該国
とうがいきじ	当該記事
とうがいえん	等外延
とうかんかく	等間隔
とうかりょく	透過力
とうかつはん	統括班
とうかしょく	透過色
とうかげんり	等価原理
とうかくりつ	等確率
とうかかいろ	等価回路
とうかいりん	東海林
とうかいむら	東海村
とうかいどう	東海道
とうかいちば	十日市場
とうかいちく	東海地区
とうかいだい	東海大
とうかいしぶ	東海支部
とうかいおき	東海沖
とうかいいん	当会員
とうおんせん	等温線
とうえんめい	陶淵明
とうえいめん	投影面
とうえいほう	投影法
とうえいばん	東映版
とうえいぞう	投影像
とういつてき	統一的
とういつたい	統一体
とういつせん	統一戦
とういつせい	統一性
とういつしき	統一指揮
とういつかん	統一感
とういじょう	糖衣錠
とうあつめん	等圧面
とうあつせん	等圧線
といといほー	対対和
といたとうげ	戸板峠
といたじょし	戸板女子
てんろうせい	天狼星
てんれんけつ	点連結
てんりんおう	転輪王	轉輪王
てんりひがし	天理東
てんりきょう	天理教
てんらんかい	展覧会
てんようさき	転用先
てんもんだい	天文台
てんもんけい	天文系
てんもんがく	天文学
てんもんかん	天文館
てんめつおん	点滅音
てんまんてん	点満点
てんまんぐう	天満宮
てんまばやし	天間林
てんまちょう	伝馬町
てんぽうせん	天保銭
てんぽうざん	天保山
てんぽうさん	天保山
てんぼうとう	展望塔
てんぼうだい	展望台
てんぼうせき	展望席
てんぼうしゃ	展望車
てんほくせん	天北線
てんぺんちい	天変地異
てんぷかのう	添付可能
てんびんぼう	天秤棒
てんばんごう	店番号
てんはいれつ	点配列
てんのうはい	天皇杯
てんのうだい	天王台
てんのうせい	天王星	天皇制
てんのうじや	天王寺屋
てんのうざん	天王山
てんねんりん	天然林
てんねんゆき	天然雪
てんねんもの	天然物
てんねんぼく	天然木
てんねんとう	天然痘
てんねんすい	天然水
てんねんしば	天然芝
てんねんごむ	天然ゴム
てんねんがす	天然ガス
てんねんがき	天然牡蠣
てんにんさき	転任先
てんどうせつ	天動説
てんとうむし	てんとう虫
てんとうひん	店頭品
てんとうかぶ	店頭株
てんてんてん	・・・
てんていとう	転抵当
てんちゅうし	典鋳司
てんちむよう	天地無用
てんたいよう	天体用
てんそうよう	転送用
てんそうもと	転送元
てんそうはば	転送幅
てんそうしゃ	転送者
てんそうしつ	転送室
てんそうさき	転送先
てんそうがわ	転送側
てんせんげん	点線源
てんせいまえ	転生前
てんすうせい	点数制
てんじんばし	天神橋
てんじんちぎ	天神地祇
てんじゅこく	天寿国
てんじひこう	展示飛行
てんじつえん	天日塩
てんじじょう	展示場
てんしんはん	天津飯
てんしんこう	天津港
てんしょくご	転職後
てんしゅどう	天主堂
てんしゅかく	天守閣
てんしゃだい	転車台
てんしちょう	天使長
てんしじかん	天使時間
てんさんぶつ	天産物
てんさいろん	天才論
てんさいもと	転載元
てんさいふか	転載不可
てんさいふう	天才風
てんさいとう	甜菜糖
てんさいてき	天才的
てんさいせい	天才性
てんさいしゃ	転載者
てんさいけん	転載権
てんさいきじ	転載記事
てんごくゆき	天国行
てんこうりつ	点効率
てんこうせい	転校生
てんこうさき	転校先
てんこうげん	点光源
てんこうぐみ	転向組
てんげんだい	天元台
てんけつごう	点結合
てんけいれい	典型例
てんけいてき	典型的
てんぐだいら	天狗平
てんきんさき	転勤先
てんきよほう	天気予報
てんきょさき	転居先
てんきゅうぎ	天球儀
てんがんやく	点眼薬
てんがんすい	点眼水
てんがんえき	点眼液
てんがぢゃや	天下茶屋
てんかわけめ	天下分け目
てんかれいじ	添加励磁
てんかむてき	天下無敵
てんかむそう	天下無双
てんかごめん	天下御免
てんかいまえ	展開前
てんかいばん	展開版
てんかいてん	転回点
てんかいてき	展開的
てんかいしき	展開式
てんかいけい	展開形
てんおんげん	点音源
てんいむほう	天衣無縫
てんいおんど	転移温度
てんあんもん	天安門
てれんてくだ	手練手管
てれびでんわ	テレビ電話
てれびきょく	テレビ局
てれびがめん	テレビ画面
てれびあさひ	テレビ朝日
てりゅうだん	手榴弾
てらこしょう	寺小姓
てもちぶさた	手持ち無沙汰
てまえがって	手前勝手
てはっちょう	手八丁
てはいちゅう	手配中
てにもつよう	手荷物用
てないしょく	手内職
てとりあしと	手取り足取
てづかさとみ	手塚理美
てづかおさむ	手塚治虫
てつようそう	綴葉装
てつどうもう	鉄道網
てつどうめい	鉄道名
てつどうない	鉄道内
てつどうとう	鉄道等
てつどうせん	鉄道線
てつどうじこ	鉄道事故
てつどうけん	鉄道研
てつどうけい	鉄道系
てつどうがわ	鉄道側
てつどうかい	鉄道界
てつどうおう	鉄道王
てつどうえき	鉄道駅
てつどういん	鉄道員
てつづきほう	手続法
てつづきない	手続き内
てつづきてき	手続的
てつづきがた	手続き型	手続型
てつづきかん	手続き間
てつせいひん	鉄製品
てつじょうぎ	鉄定規
てつしゃりん	鉄車輪
てつげんばん	鉄眼版
てつけいたい	鉄警隊
てつがくろん	哲学論
てつがくてき	哲学的
てつがくしょ	哲学書
てつがくしゃ	哲学者
てつがくかい	哲学会
てっぽうみず	鉄砲水
てっぽうづか	鉄炮塚
てっぽうだま	鉄砲玉
てっぽうすう	鉄砲数
てっぽうじる	鉄砲汁
てっぽうかじ	鉄砲鍛冶
てっぽううお	鉄砲魚
てっぴつばん	鉄筆版
てっぱんやき	鉄板焼
てっとりばや	手っ取り早
てっていてき	徹底的
てっこうだん	徹甲弾
てっこうせん	鉄甲船
てっこうせき	鉄鉱石
てっこうじょ	鉄工所	鐵工所
てっこうしょ	鉄鉱所	鐵綱所	鐵鉱所	鉄工所	鉄鋼所	鐵工所
てっきんこう	鉄筋工
てすときかん	テスト期間
てすじしゅう	手筋集
てすうりょう	手数料
てじゅんしょ	手順書
てしゅうせい	手修正
てさげかばん	手提げ鞄
てくねちうむ	Technetium	Tc
てきようれい	適用例
てきようまえ	適用前
てきようほう	適用法
てきようせい	適用性
てきようずみ	適用済
てきようがい	適用外
てきにんしゃ	適任者
てきとうせい	適当性
てきだんとう	擲弾筒
てきたいてき	敵対的
てきたいしゃ	敵対者
てきせんしゃ	敵戦車
てきせいすう	適正数
てきじんない	敵陣内
てきじんがわ	敵陣側
てきごうせい	適合性
てきごうしゃ	適合車
てきぎついか	適宜追加
てききょてん	敵拠点
てきがいしん	敵愾心
てきかんたい	敵艦隊
てきかくせい	適格性
てきかくしゃ	適格者
てきおうほう	適応法
てきおうてき	適応的
てきおうせい	適応性
てきおうけい	適応系
てきおうがた	適応型
てがらばなし	手柄話
てがたこうい	手形行為
てがきすうじ	手書き数字
ていれいかい	定例会
ていりょうか	定量化
ていりつほう	定率法
ていりつぜい	定率税
ていゆうせん	艇優先
ていやねしゃ	低屋根車
ていめんせき	底面積
ていめいぎみ	低迷気味
ていぶんさん	低分散
ていひんしつ	低品質
ていひじゅう	低比重
ていばいりつ	低倍率
ていねんれい	低年齢
ていねんせい	停年制	定年制
ていねんごろ	定年頃
ていどりかい	程度理解
ていどよそく	程度予測
ていどくせい	低毒性
ていとくてん	低得点
ていとうけん	抵当権
ていとうがし	抵当貸
ていでんじこ	停電事故
ていでんあつ	定電圧	低電圧
ていてんしき	定点式
ていちんぎん	低賃金
ていちゃくか	定着化
ていだんしゃ	低段者
ていだいけい	帝大系
ていたいぐみ	停滞組
ていたいいき	低帯域
ていぞくせい	低俗性
ていそんしつ	低損失
ていそくすう	定足数
ていそくしゃ	低速車
ていそくがわ	低速側
ていそくいき	低速域
ていそうたい	貞操帯
ていせきぶん	定積分
ていせいりつ	訂正率
ていせいよう	訂正用
ていせいばん	訂正版
ていせいのう	低性能
ていせいてん	訂正点
ていせいてき	定性的
ていせいきじ	訂正記事
ていせいいん	訂正印
ていせいいた	訂正致
ていすうぶん	定数文
ていすうばい	定数倍
ていすうしき	定数式
ていすうこう	定数項
ていじょうぶ	定常部
ていじょうは	定常波
ていじゅんど	低純度
ていじそうち	呈示装置
ていじじこく	呈示時刻	提示時刻
ていじじかん	提示時間
ていじかかく	提示価格
ていしんらい	低信頼
ていしんこう	貞信公
ていしょとく	低所得
ていしょくや	定食屋
ていしょうひ	低消費
ていしょうど	低照度
ていしゅつび	提出日
ていしゅうは	低周波
ていしゃまえ	停車前
ていしゃえき	停車駅
ていしゃいち	停車位置
ていしちゅう	停止中
ていしじかん	停止時間
ていしきょり	停止距離
ていしきかん	停止期間
ていざんけい	定山溪
ていざいはひ	定在波比
ていさんだい	帝産台
ていさついん	偵察員
ていこくばん	帝国版
ていこくぐん	帝国軍
ていこうるい	抵抗類
ていこうりつ	抵抗率
ていこうふか	抵抗負荷
ていこうせい	抵抗性
ていこうがい	低公害
ていこうかん	抵抗感
ていけつあつ	低血圧
ていけっとう	低血糖
ていけいぶん	定型文
ていけいてき	定型的
ていけいさき	提携先
ていけいがい	定型外
ていぎぶぶん	定義部分
ていぎちょう	定義長
ていぎちゅう	定義中
ていぎじょう	定義上
ていぎじたい	定義自体
ていぎかのう	定義可能
ていきりよう	定期利用
ていきよきん	定期預金
ていきゅうび	定休日
ていきほしゅ	定期保守
ていきほけん	定期保険
ていきしけん	定期試験
ていきざっし	定期雑誌
ていききゃく	定期客
ていがくほう	定額法
ていがくねん	低学年
ていかんかく	定間隔
ていかろりー	低カロリー
ていかみまん	定価未満
ていかひょう	定価表
ていかくりつ	低確率
ていかかくか	低価格化
ていかいてん	低回転
ていおんよう	低温用
ていおんけん	低温研
ていおんがわ	低温側	低音側
ていおんかん	低音感
ていおんいき	低音域
ていおうがく	帝王学
ていいんわれ	定員割
ていいんがい	定員外
ていいきのう	定位機能
ていいきこう	定位機構
ていあんふび	提案不備
ていあんしょ	提案書
ていあんしゃ	提案者
ていあんけん	提案権
ていあんきじ	提案記事
ていあんがわ	提案側
ていあつよう	低圧用
つんぼさじき	聾桟敷
つれづれぐさ	徒然草
つるむらさき	蔓紫
つるまいせん	鶴舞線
つるまいえき	鶴舞駅
つるべおとし	釣瓶落し
つるかめざん	鶴亀算
つりこみごし	釣り込み腰
つりこうこく	吊り広告
つりがねむし	釣鐘虫
つりがねそう	釣鐘草
つりがねがた	釣鐘形
つらぬきとお	貫き通
つらだましい	面魂
つゆくさもく	Commelinales	ツユクサ目
つゆくさいろ	露草色
つめしょうぎ	詰め将棋	詰将棋
つむじまがり	旋毛曲がり	旋毛曲り
つみほろぼし	罪滅ぼし
つみにほけん	積荷保険
つみたてきん	積立金
つまどいこん	妻問婚
つぼせんざい	壺前栽
つぼうちけん	坪内研
つぼいさかえ	壺井栄
つばめがえし	燕返し
つばぜりあい	鍔迫り合い
つばきあぶら	椿油
つのごけるい	角苔類
つなみよほう	津波予報
つどけってい	都度決定
つづらふじか	ツヅラフジ科	Menispermaceae
つづうらうら	津々浦々
つつみがまえ	包構え
つつぢゃわん	筒茶碗
つつじがおか	榴ヶ岡	つつじヶ丘	榴岡
つつしみぶか	慎み深
つつうらうら	津々浦々	津津浦浦
つっけんどん	突慳貪
つっかいぼう	突っ支い棒
つちのととり	己酉
つちのとうし	己丑
つちのえとら	戊寅
つちのえたつ	戊辰
つちのえさる	戊申
つちのえうま	戊午
つちのえいぬ	戊戌
つだぬまえき	津田沼駅
つじせっぽう	辻説法
つじげいにん	辻芸人
つじうらない	辻占い
つしまふくい	津島福居
つしまかなめ	津島要
つごうじょう	都合上
つごうしゅぎ	都合主義
つけものてん	漬物店
つけものいし	漬物石
つくろいもの	繕い物
つくりわらい	作り笑い
つくりばなし	作り話
つくりざかや	造酒屋
つくもでんき	九十九電機
つくだにふう	佃煮風
つくしじろう	筑紫二郎
つきへいきん	月平均
つきのわぐま	月輪熊
つきのさわり	月の障り
つきなんにち	月何日
つきこうはん	月後半
つきぎょうじ	月行事
つきおろしね	月卸値
つきあげぐん	築上郡
つかわれかた	使われ方
つかいばしり	使い走り
つかいはしり	使い走り
つかいごこち	使い心地
つかいがって	使い勝手
つかいかって	使い勝手
つうわりょう	通話料
つうわひょう	通話表
つうわじかん	通話時間
つうろふうさ	通路封鎖
つうようもん	通用門
つうようぐち	通用口
つうゆうせい	通有性
つうやくしゃ	通訳者
つうやくかん	通訳官
つうほうしゃ	通報者
つうほうぎむ	通報義務
つうふうこう	通風口
つうはんてん	通版店	通販店
つうてんかく	通天閣
つうちひょう	通知表
つうちじょう	通知状
つうぞくてき	通俗的
つうそうけん	通総研
つうしんろん	通信論
つうしんらん	通信欄
つうしんよう	通信用
つうしんもう	通信網
つうしんほう	通信法
つうしんへい	通信兵
つうしんぶん	通信文
つうしんだい	通信代
つうしんせん	通信線
つうしんしゃ	通信社
つうしんがく	通信学
つうしんいん	通信員
つうさんねん	通算年
つうさんげつ	通算月
つうこくしょ	通告書
つうこうぼん	通行本
つうこうふか	通行不可
つうこうにん	通行人
つうこうどめ	通行止	通行止め
つうこうぜい	通行税
つうこうしゃ	通行車
つうこうけん	通行券
つうきんよう	通勤用
つうきんしゃ	通勤車	通勤者
つうきんけん	通勤圏
つうきそしき	通気組織
つうがくよう	通学用
つうがくせい	通学生
つうがくさき	通学先
つうかちゅう	通過中
つうかたんい	通貨単位
つうかそくど	通過速度
つうかじこく	通過時刻
つうかじかん	通過時間
つうかしゅぎ	通貨主義
つうかけいろ	通過経路
つうかぎれい	通過儀礼
つうかきゃく	通過客
つうかきごう	通貨記号
つうかかのう	通過可能
つういんしゃ	通院者
つういいそう	字一色
ついらくじこ	墜落事故
ついびそうち	追尾装置
ついびせいど	追尾精度
ついとつじこ	追突事故
ついとうしき	追悼式
ついたいけん	追体験
ついせきがた	追跡型
ついせいせい	対生成
ついずいせい	追随性
ついじっけん	追実験
ついきじこう	追記事項
ついかんばん	椎間板
ついかよさん	追加予算
ついかぶぶん	追加部分
ついかぶそう	追加武装
ついかひょう	追加表
ついかそうび	追加装備
ついかきのう	追加機能
つーいーそー	字一色
ちんろうどう	賃労働
ちんれつだな	陳列棚
ちんらおとう	清老頭
ちんぼつせん	沈没船
ちんぼつかん	沈没艦
ちんぷんかん	珍糞漢	珍紛漢
ちんどうしき	沈胴式
ちんでんぶつ	沈殿物
ちんつうやく	鎮痛薬
ちんつうざい	鎮痛剤
ちんちょうげ	沈丁花
ちんたいにん	賃貸人
ちんそうだん	珍走団
ちんせいざい	鎮静剤
ちんざんそう	椿山荘
ちんこうせい	沈降性
ちんげんさい	青梗菜
ちんがいざい	鎮咳剤
ちんかきょう	沈下橋
ちんいーそー	清一色
ちりょうれい	治療例
ちりょうよう	治療用
ちりょうやく	治療薬
ちりょうほう	治療法
ちりょうだい	治療代
ちりょうしゃ	治療者
ちりょうしつ	治療室
ちょめちょめ	××
ちょめいじん	著名人
ちょはっかい	猪八戒
ちょっこうわ	直交和
ちょっきゅう	直球
ちょっかがた	直下型
ちょぞうひん	貯蔵品
ちょぞうしゅ	貯蔵酒
ちょぞうしつ	貯蔵室
ちょぞうこん	貯蔵根
ちょすいよう	貯水用
ちょすいそう	貯水槽
ちょじゅつか	著述家
ちょしょめい	著書名
ちょしゃめい	著者名
ちょしゃたち	著者達
ちょしゃあて	著者宛
ちょさくぶつ	著作物
ちょさくしゃ	著作者
ちょさくけん	著作権
ちょさくぐん	著作群
ちょこれーと	貯古齢糖
ちょくりゅう	直流
ちょくりつし	直立枝
ちょくゆほう	直喩法
ちょくにゅう	直入
ちょくちょう	直腸
ちょくたつは	直達波
ちょくせんび	直線美
ちょくせつひ	直接費
ちょくせつは	直接波
ちょくせつい	直接行
ちょくじょう	直情	直上
ちょくしんじ	直進時
ちょくしょう	勅詔
ちょくしゅつ	直出
ちょきんばこ	貯金箱
ちょきんじむ	貯金事務
ちょうわおん	長和音
ちょうれいか	張麗華
ちょうりろん	超理論
ちょうりよう	調理用
ちょうりょく	聴力	潮力	張力
ちょうりょう	跳梁
ちょうりゅう	潮流
ちょうりゃく	調略
ちょうりほう	調理法
ちょうりひん	調理品
ちょうりにん	調理人
ちょうりなべ	調理鍋
ちょうりつし	調律師
ちょうりだい	調理台
ちょうりずみ	調理済み
ちょうりしつ	調理室
ちょうりきぐ	調理器具	調理機具
ちょうらくじ	長楽寺
ちょうむすび	蝶結び
ちょうまじめ	超真面目
ちょうぼるい	帳簿類
ちょうぼいん	長母音
ちょうへんか	長編化
ちょうへいき	超兵器
ちょうぶんし	超分子
ちょうふてん	調布店
ちょうふさい	調布祭
ちょうふがわ	調布側
ちょうふかん	調布間
ちょうふえき	調布駅
ちょうびるい	長鼻類
ちょうびふう	超微風
ちょうびじん	超美人
ちょうびさい	超微細
ちょうひょう	帳表	帳票	徴表	徴憑
ちょうひさん	超悲惨
ちょうばいか	鳥媒花
ちょうはつど	挑発度
ちょうはずれ	帳外れ
ちょうはかく	超破格
ちょうのつぼ	町坪
ちょうにんき	超人気
ちょうにがて	超苦手
ちょうどひん	調度品
ちょうとうは	超党派
ちょうでんじ	超電磁
ちょうてぬき	超手抜き
ちょうてすう	超手数
ちょうつがい	蝶番
ちょうちょう	長調	喋々	蝶蝶	町長	蝶々
ちょうちゅう	頂肘
ちょうちゃく	打擲
ちょうちふす	腸チフス
ちょうちかく	聴知覚
ちょうだりつ	長打率
ちょうだえん	超楕円
ちょうだいか	長大化
ちょうたんぱ	超短波
ちょうたんい	兆単位
ちょうたろう	長太郎
ちょうたぼう	超多忙
ちょうたつぶ	調達部
ちょうたつご	調達後
ちょうただん	超多段
ちょうそんぶ	町村部
ちょうそがべ	長宗我部
ちょうそかべ	長宗我部
ちょうせんし	朝鮮史	超戦士
ちょうせんご	朝鮮語
ちょうせんき	挑戦記
ちょうせだい	超世代
ちょうせいり	超整理
ちょうせいぶ	調整部
ちょうせいち	調整値
ちょうせいし	調整師
ちょうせいご	調整後
ちょうせいき	調整器
ちょうずばち	手水鉢
ちょうすいろ	長水路
ちょうじろう	長次郎
ちょうじょう	重畳	超常	長城	長上	頂上
ちょうじゅん	超準
ちょうじゅう	聴従	鳥獣
ちょうじゃく	長尺
ちょうじちゃ	丁子茶
ちょうじかん	長時間
ちょうじいろ	丁子色
ちょうしんき	聴診器
ちょうしわる	調子悪
ちょうしょく	朝食	調色
ちょうしょう	嘲笑	徴証	弔鐘	長嘯
ちょうしゅん	長春
ちょうしゅじ	聴取時
ちょうしゅう	徴集	長洲	徴収	長州	聴衆
ちょうしゃく	長尺
ちょうしもの	調子者
ちょうしぶえ	調子笛
ちょうしぜん	超自然
ちょうししゃ	聴視者
ちょうさんど	長三度
ちょうさよう	調査用
ちょうさやく	調査役
ちょうさほう	調査法
ちょうさだん	調査団
ちょうさたい	調査隊
ちょうさしょ	調査書
ちょうさしつ	調査室
ちょうさかん	調査官
ちょうさかい	調査会
ちょうさいん	調査員
ちょうごんか	長恨歌
ちょうごえき	長後駅
ちょうごうか	超豪華
ちょうこんか	長恨歌
ちょうこだい	超古代
ちょうこくか	彫刻家
ちょうこがた	超小型
ちょうこうし	超格子
ちょうこうさ	潮候差
ちょうこうき	超広軌
ちょうけいか	蝶形花
ちょうぎゃく	嘲謔
ちょうぎかい	町議会
ちょうぎいん	町議員
ちょうきょり	長距離
ちょうきょう	長享	調教
ちょうきゅう	超球	長久
ちょうきゃく	弔客
ちょうきてき	長期的
ちょうきせん	長期戦
ちょうきかん	長期間
ちょうかんず	鳥瞰図
ちょうかんじ	超漢字
ちょうかぶん	超過分
ちょうかそく	超加速
ちょうかげき	超過激
ちょうかくき	聴覚器
ちょうかがく	超科学
ちょうおんぷ	長音符
ちょうおんぶ	聴音部	調音部
ちょうおんぱ	超音波
ちょうおんき	聴音機
ちょうおんか	長音化
ちょうおおて	超大手
ちょういきん	弔慰金
ちょうあんか	超安価
ちょうあにき	超兄貴
ちゆじゅつし	治癒術師
ちゅうわざい	中和剤
ちゅうろうい	中労委
ちゅうりょく	注力	中力
ちゅうりゅう	駐留	中流
ちゅうりゃく	中略
ちゅうりきこ	中力粉
ちゅうやさい	中夜祭
ちゅうもんと	注文取
ちゅうもんか	注文可
ちゅうもくど	注目度
ちゅうほしゃ	仲保者
ちゅうほーる	中ホール
ちゅうぶちく	中部地区
ちゅうぶぜい	中部勢
ちゅうばいか	虫媒花
ちゅうはたい	中波帯
ちゅうのうど	中濃度
ちゅうにゅう	注入
ちゅうにかい	中二階
ちゅうなごん	中納言
ちゅうどうじ	中堂寺
ちゅうとんち	駐屯地
ちゅうとうぶ	中等部
ちゅうとうど	中等度
ちゅうていど	中程度
ちゅうっぱら	中っ腹
ちゅうちょう	注腸	中朝
ちゅうだんご	中断後
ちゅうそんじ	中尊寺
ちゅうぜんじ	中禅寺
ちゅうせんび	抽選日
ちゅうせんば	抽籤馬
ちゅうせんご	抽選後
ちゅうせきど	沖積土
ちゅうせいぶ	中西部
ちゅうせいど	忠誠度
ちゅうせいし	中性子	中性紙
ちゅうすうぶ	中枢部
ちゅうじょう	柱状	中将	中条	中條	衷情
ちゅうじゅん	中旬
ちゅうじてん	中辞典
ちゅうじつや	忠実屋
ちゅうじつど	忠実度
ちゅうじえん	中耳炎
ちゅうしんぶ	中心部
ちゅうしんち	中心地
ちゅうしょく	昼食	中食
ちゅうしょう	中小	中傷	中将	抽象	中称
ちゅうしゅつ	抽出
ちゅうしゅう	中周	仲秋	中秋
ちゅうしゃじ	駐車時
ちゅうしゃく	注釈	註釈
ちゅうしゃき	注射器
ちゅうしゃか	駐車可
ちゅうしはん	中止犯
ちゅうしてん	注視点
ちゅうしこく	中四国
ちゅうさかん	中属
ちゅうごくし	中国史
ちゅうごくご	中国語
ちゅうごくき	中国旗
ちゅうごくか	中国化
ちゅうこひん	中古品
ちゅうこばん	中古盤
ちゅうこてん	中古店
ちゅうこだい	中古台
ちゅうこしゃ	中古車
ちゅうけんほ	駐建保
ちゅうけいは	中継波
ちゅうけいち	中継地
ちゅうけいじ	中継時
ちゅうけいき	中継器
ちゅうぎだて	忠義立て
ちゅうぎがお	忠義顔
ちゅうきょり	中距離
ちゅうきょう	中共	中京
ちゅうきゅう	中級	誅求
ちゅうきてき	中期的
ちゅうがたき	中型機
ちゅうがたか	中型化
ちゅうがえり	宙返り
ちゅうかんぶ	中間部
ちゅうかんち	中間値
ちゅうかんし	中間子
ちゅうかんぎ	中間木
ちゅうかめん	中華麺
ちゅうかふう	中華風
ちゅうかはん	中華飯
ちゅうかなべ	中華鍋
ちゅうかどん	中華丼
ちゅうかっこ	中かっこ	中括弧
ちゅうかそば	中華蕎麦
ちゅうかくは	中核派
ちゅうかがし	中華菓子
ちゅうかがい	中華街
ちゅうおうよ	中央寄
ちゅうおうぶ	中央部
ちゅうおうば	中央馬
ちゅうおうち	中央値
ちゅうおうく	中央区
ちゅういほう	注意報
ちゅういぶん	注意文
ちゅういぶか	注意深
ちゅういてん	注意点
ちゅういしょ	注意書
ちゅういぎむ	注意義務
ちゅういがき	注意書き
ちゃわんむし	茶碗蒸	茶碗蒸し
ちゃわんたけ	茶碗茸
ちゃやまだい	茶山台
ちゃばんげき	茶番劇
ちゃっかてん	着火点
ちゃちゃまる	茶々丸
ちゃくりゅう	嫡流
ちゃくひょう	着氷
ちゃくばらい	着払	着払い
ちゃくにんじ	着任時
ちゃくちゃく	着着	着々
ちゃくちてん	着地点
ちゃくじゅん	着順
ちゃくじつに	着実に
ちゃくじこく	着時刻
ちゃくしょく	着色
ちゃくしょう	着床
ちゃくしゅつ	嫡出
ちゃくざいち	着座位置
ちゃうすやま	茶臼山
ちゃいなふく	チャイナ服
ちゃーたーき	チャーター機
ちゃーしゅー	焼豚	叉焼
ちめいじてん	地名事典	地名辞典
ちめいしょう	致命傷
ちほうろせん	地方路線
ちほうそしき	地方組織
ちほうしょく	地方色
ちほうしょう	痴呆症
ちほうけいば	地方競馬
ちほうきょく	地方局
ちひょうめん	地表面
ちひょうすい	地表水
ちばほうめん	千葉方面
ちばだいがく	千葉大学
ちばたいかい	千葉大会
ちばこうだい	千葉工大
ちばけんみん	千葉県民
ちばけんじん	千葉県人
ちばいちりつ	千葉市立
ちはやじょう	千早城
ちのうてすと	知能テスト
ちのうていど	知能程度
ちのうしすう	知能指数
ちどりちょう	千鳥町
ちどりがふち	千鳥ヶ淵
ちてんじょう	血天井
ちてきしょり	知的処理
ちてきしげき	知的刺激
ちつじょいじ	秩序維持
ちつけいれん	膣痙攣
ちっこうせん	築港線
ちちゅうかい	地中海
ちちぶのみや	秩父宮
ちちおやごろ	父親殺
ちたはんとう	知多半島
ちずてつどう	智頭鉄道
ちすいかふう	地水火風
ちじょうわざ	地上技
ちじょうよう	地上用
ちじょうぶつ	地上物
ちじょうせん	地上戦	地上線
ちじょうけん	地上権
ちじょうけい	地上茎
ちじょうえき	地上駅
ちじゅんほう	置閏法
ちしきりょう	知識量
ちしきほうふ	知識豊富
ちしきべーす	知識ベース
ちしきぶそく	知識不足
ちしきしょり	知識処理
ちしきぎのう	知識技能
ちしきかがく	知識科学
ちしきいがい	知識以外
ちこくしどう	遅刻指導
ちこうりゅう	地衡流
ちけいこうか	地形効果
ちくれいねつ	蓄冷熱
ちくねつしき	蓄熱式
ちくなんねん	築何年
ちくたいかい	地区大会
ちくせきがた	蓄積型
ちくじしょり	逐次処理
ちくじげんご	逐次言語
ちくじきんじ	逐次近似
ちくしてつや	筑紫哲也
ちきょうだい	乳兄弟
ちきゅうはつ	地球発
ちきゅうてき	地球的
ちきゅうせん	地球船
ちきゅうせい	地球製
ちきゅうじん	地球人
ちきゅうじば	地球磁場
ちきゅうしゃ	地球社
ちきゅうこく	地球国
ちきゅうけい	地球系
ちきゅうぐん	地球軍
ちきゅうきぼ	地球規模
ちきゅうがわ	地球側
ちきゅうがた	地球型
ちきゅうがい	地球外
ちがくざっし	地学雑誌
ちかんこうい	痴漢行為
ちからまかせ	力任せ
ちからぶそく	力不足
ちからづよい	力強い
ちからだめし	力試し
ちからだのみ	力頼み
ちからじまん	力自慢
ちからじこく	力時刻
ちからしごと	力仕事
ちからくらべ	力比べ	力競べ
ちからかげん	力加減
ちからおとし	力落とし	力落し
ちからいがい	力以外
ちかよくせい	地価抑制
ちかどうくつ	地下洞窟
ちかてつもう	地下鉄網
ちかてつせん	地下鉄線
ちかてつえき	地下鉄駅
ちかせんよう	地下線用
ちかけいざい	地下経済
ちかくじょう	知覚上
ちかくしょり	知覚処理
ちかくきこう	知覚機構
ちかくかてい	知覚過程
ちかくうかん	地下空間
ちかかつどう	地下活動
ちかかこうじ	地下化工事
ちかうんどう	地下運動
ちかいっかい	地下一階
ちえんりそく	遅延利息
ちえんじかん	遅延時間
ちえこしょう	智恵子抄
ちぇーんてん	チェーン店
ちいきぶんり	地域分離
ちいきぶんぷ	地域分布
ちいきぶんか	地域文化
ちいきつうか	地域通貨
ちいきたんい	地域単位
ちいきしょく	地域色
ちいきこゆう	地域固有
ちいきくぶん	地域区分
ちいきかくさ	地域格差
ちあんじょう	治安上
ちあんきょく	治安局
たんろくぼん	丹緑本
たんれんけつ	単連結
たんらくてき	短絡的
たんらくせん	短絡線
たんもうしゅ	短毛種
たんめんよう	単面葉
たんまつよう	端末用
たんまつめい	端末名
たんまつまど	端末窓
たんまつしつ	端末室
たんまつけい	端末系
たんまつきき	端末機器
たんまつがわ	端末側
たんまつかん	端末間
たんまちえき	反町駅
たんほうせい	単峰性
たんほうこう	単方向
たんほうかい	探訪会
たんぶんせつ	単文節
たんぱつてき	単発的
たんぱしょう	短波賞
たんぱくせき	蛋白石
たんぱくしつ	蛋白質	タンパク質
たんぱくげん	蛋白源
たんはちょう	短波長
たんのうしゃ	堪能者
たんにんさん	タンニン酸
たんにしょう	歎異抄
たんどくはん	単独犯
たんどくじこ	単独事故
たんどうがん	胆道癌
たんとうるい	単糖類
たんとうぶん	担当分
たんとうしゃ	担当者
たんとうがい	担当外
たんとうかん	担当官
たんとういん	担当員
たんとういし	担当医師
たんていやく	探偵役
たんていもの	探偵物
たんていだん	探偵団
たんていしゃ	探偵社
たんていしつ	探偵室
たんだいそつ	短大卒
たんだいせい	短大生
たんたんめん	担々麺
たんたかばし	反高橋
たんそびょう	炭疽病
たんそせんい	炭素繊維
たんそうがた	単相型
たんせんりつ	単旋律
たんせんこう	単穿孔	単せん孔
たんすよきん	箪笥預金
たんすうけい	単数形
たんすうぐん	単数群
たんすいせい	淡水性
たんすいぎょ	淡水魚
たんじょうび	誕生日
たんじょうじ	誕生時
たんじょうご	誕生後
たんじゅんご	単純語
たんじゅんか	単純化
たんじつげつ	短日月
たんじきょく	単磁極
たんしんどう	単振動
たんしんしゃ	単身者
たんしょくし	探触子
たんしゅくか	短縮化
たんしゃれき	単車歴
たんしゃてき	単射的
たんししょく	淡紫色
たんざくがた	短冊型	短冊形
たんさんわり	炭酸割り
たんさんせん	炭酸泉
たんさんすい	炭酸水
たんさんかり	炭酸カリ
たんさんえん	炭酸塩
たんさんいり	炭酸入
たんさくほう	探索法
たんさくてき	探索的
たんさいぼう	単細胞
たんごりょく	単語力
たんごひょう	単語表
たんごていぎ	単語定義
たんごちょう	単語帳
たんごたんい	単語単位
たんごしゅう	単語集
たんこんたい	担根体
たんこうるい	単孔類
たんこうぼん	単行本
たんこうしき	単項式
たんこうがた	単溝型
たんげさぜん	丹下左膳
たんけんてき	探検的
たんけんたい	探検隊	探険隊
たんぐすてん	W	Tungsten
たんきょりば	短距離馬
たんきじこう	短期時効
たんきぎょう	単企業
たんききんり	短期金利
たんききおく	短期記憶
たんがんてき	単眼的
たんがんしょ	嘆願書
たんかひるい	Monochlamydeae	単花被類
たんかすいそ	炭化水素
たんおんせつ	単音節
たんおんかい	短音階
たんいりょう	単位量
たんいふごう	単位符合	単位符号
たんいでんち	単位電池
たんいつたい	単一体
たんいつかし	単一化子
たんいちょう	単位長
たんいじげん	単位次元
たんいじかん	単位時間
たんいきゅう	単位球
たわむれごと	戯れ事	戯れ言
たわむれがき	戯れ書き
たろうかじゃ	太郎冠者
たるみずえき	垂水駅
たりょういき	他領域
たりかつよう	タリ活用
たらみちょう	多良見町
たらいまわし	盥回し
たやまかたい	田山花袋
たもやちだけ	田茂谷地岳
たもうしょう	多毛症
ためらいきず	躊躇い傷
ためいけかん	溜池間
ためいけえき	溜池駅
たみやじろう	田宮二郎
たまれいえん	多磨霊園
たまものまえ	玉藻前
たまむしいろ	玉虫色
たまひめさま	玉姫様
たまのおぐし	玉の小櫛
たまのうてな	玉の台
たまつきてき	玉突的
たまつきじこ	玉突き事故
たまさぶろう	玉三郎
たまごどうふ	玉子豆腐	卵豆腐
たまがわだい	玉川大
たまがわせん	玉川線	多摩川線
たまがわぐち	玉川口
たまがわえん	多摩川園
たぼうちゅう	多忙中
たべほうだい	食べ放題
たべずぎらい	食べず嫌い
たへんりょう	多変量
たぶんわたし	多分私
たぶろいどし	タブロイド紙
たびょういん	他病院
たびげいにん	旅芸人
たばいちょう	多倍長
たのもしこう	頼母子講
たのみのつな	頼みの綱
たのしみかた	楽しみ方
たぬきばやし	狸囃子
たぬきばばあ	狸婆
たぬきねいり	狸寝入り
たぬきこうじ	狸小路
たにんめいぎ	他人名義
たにんどうし	他人同士
たにんしほん	他人資本
たにむらゆみ	谷村有美
たにまちせん	谷町線
たにがわだけ	谷川岳
たにがわごう	谷川号
たにおおつか	谷大塚
たなべはじめ	田辺元
たなばたさま	七夕様
たなかぎいち	田中義一
たなかきぬよ	田中絹代
たとえばなし	例え話	譬え話
たてやまわん	館山湾
たてやくしゃ	立役者
たてものない	建物内
たてまえろん	建前論
たてほうこう	縦方向
たてばやしし	館林市
たてばいかく	縦倍角
たてしんどう	縦振動
たてしゃかい	縦社会
たてしなやま	蓼科山
たてざひょう	縦座標
たてけいしき	縦形式
たてぎょうじ	立行司
たてかんばん	立て看板	立看板
たてかえきん	立替金
たていちれつ	縦一列
たていちよう	縦位置用
たつのちょう	辰野町
たつなみべや	立浪部屋
たつおかもん	龍岡門	竜岡門
たっぴみさき	竜飛岬
たっせいりつ	達成率
たっせいしゃ	達成者
たっせいかん	達成感
たっきゅうぶ	卓球部
たちまちづき	立待月
たちばなわん	橘湾
たちばじょう	立場上
たちはばとび	立ち幅跳び
たちぐいそば	立ち食いそば
たちかんすう	多値関数
たちかわえき	立川駅
たちあいにん	立会人
たちあいがわ	立会川
ただんれんさ	多段連鎖
ただんしよう	多段使用
ただばたらき	只働き
ただすつかさ	弾正台
ただごとうた	徒言歌
たたみいわし	畳鰯
たそがれどき	黄昏時
たそがれづき	黄昏月
たそうきばん	多層基板
たすうはいび	多数配備
たすうしよう	多数使用
たすうしゅう	多数集
たすうさんか	多数参加
たすうおうぼ	多数応募
たすういけん	多数意見
たじょうほう	他情報
たじょうけん	他条件
たじゅうせい	多重性
たじゅうおん	多重音
たじまちほう	但馬地方
たじげんてき	多次元的
たしんぴるい	多心皮類	Polycarpicae
たしんきょう	多神教
たしょくずり	多色刷	他色刷
たしょうむり	多少無理
たしょうなん	多少難
たしょうてま	多少手間
たしょうちが	多少違
たしょうたか	多少高
たしょうおく	多少遅
たしゅたよう	多種多様
たしゅうだん	他集団
たしせいせい	多士済済
たざんのいし	他山の石
たざわこはん	田沢湖畔
たざわこせん	田沢湖線
たごんむよう	他言無用
たこのきもく	タコノキ目	Pandanales
たこくごもじ	多国語文字
たこくごばん	多国語版
たげいたさい	多芸多才
たけのこめし	筍飯
たけとよせん	武豊線
たけとみじま	竹富島
たけっしょう	多結晶
たけだけしい	猛々しい
たけしょぼう	竹書房
たけしたどお	竹下通
たけかんむり	竹冠
たけおかせん	竹岡戦
たくろうしょ	宅老所
たくはいびん	宅配便
たくないよう	宅内用
たくせんしょ	託宣所
たくじしせつ	託児施設
たくえつふう	卓越風
たくいつしき	択一式
たくあつかい	宅扱い
たぎょうしゅ	他業種
たきゅうだん	他球団
たきぼうよう	多岐亡羊
たきのうせい	多機能性
たきしゅよう	他機種用
たきかわえき	滝川駅
たがんしほう	多眼視法
たがじょうし	多賀城市
たがいちがい	互い違い
たかんせだい	多感世代
たかんしょう	多汗症
たからづかし	宝塚市
たからさがし	宝探し
たからがいけ	宝が池
たかやません	高山線
たかやまかん	高山間
たかもりかん	高森間
たかまのはら	高天原
たかまつこう	高松港
たかまつかん	高松間
たかまつえき	高松駅
たかまがはら	高天原
たかねのはな	高嶺の花
たかなわぐち	高輪口
たかとうりき	貴闘力
たかつきてん	高槻店
たかちほせん	高千穂線
たかちほかん	高千穂間
たかだのばば	高田馬場
たかたまゆこ	高田万由子
たかさごだい	高砂台
たかさごかん	高砂間
たかさきせん	高崎線
たかくらやま	高倉山
たかくらだい	高倉台
たかくらけん	高倉健
たかくちゅう	多角柱
たかかんすう	多価関数
たかおかえき	高岡駅
たかおいせい	高尾以西
たおやめぶり	手弱女振り
たうりゅうし	τ粒子
たいわんせい	台湾製
たいわんじん	台湾人
たいわんさん	台湾産
たいわちょう	大和町
たいわしょり	対話処理
たいれいせい	耐冷性
たいりょうり	タイ料理
たいりょうし	大量死
たいりつてん	対立点
たいりつじく	対立軸
たいりくほう	大陸法
たいりくだな	大陸棚
たいりくせい	大陸性
たいりくしき	大陸式
たいりくさん	大陸産
たいよこはま	対横浜
たいよかのう	貸与可能
たいようれき	太陽暦
たいようゆし	太陽油脂
たいようふう	太陽風
たいようねん	太陽年
たいようねつ	太陽熱
たいようぞく	太陽族
たいようせん	大洋戦
たいようじば	太陽磁場
たいようしん	太陽神
たいようこう	太陽光
たいようけい	太陽系
たいめんしき	対面式
たいぼうろん	待望論
たいほじょう	逮捕状
たいべいこく	対米国
たいへんもう	大変申
たいへんおそ	大変遅
たいへいらく	太平楽
たいへいよう	太平洋
たいへいざん	太平山
たいぶんすう	帯分数
たいぶとどけ	退部届
たいひろしま	対広島
たいひひょう	対比表
たいひづくり	堆肥作り
たいひせつび	退避設備	待避設備
たいひかのう	退避可能
たいはくさん	太白山
たいはいてき	退廃的
たいのうしゃ	怠納者	滞納者
たいねつせい	耐熱性
たいねつざら	耐熱皿
たいにんげん	対人間
たいどみてい	態度未定
たいとうせい	対等性
たいとうがく	対当額
たいちそくど	対地速度
たいちしえん	対地支援
たいちきどう	対地軌道
たいだんきじ	対談記事
たいぞうかい	胎蔵界
たいそうふく	体操服
たいぜんくつ	体前屈
たいせんりつ	対旋律
たいせんひわ	大戦秘話
たいせんすう	対戦数
たいせんしゃ	対戦車	対戦者
たいせんがた	対戦型
たいせきぶつ	堆積物	体積物
たいせきそう	堆積層
たいせきがん	堆積岩
たいせいよう	大西洋
たいせいまる	大成丸
たいせいぶつ	対生物
たいせいどう	大盛堂
たいせいてき	体制的
たいせいきん	耐性菌
たいせいがわ	体制側
たいすうじく	対数軸
たいすいせい	耐水性
たいじゅうさ	体重差
たいじそしき	胎児組織
たいしんへき	耐震壁
たいしんせい	耐震性
たいしんくう	対真空
たいしょほう	対処法
たいしょてき	対蹠的
たいしょくび	退職日
たいしょくご	退職後
たいしょうど	対称度
たいしょうき	大正期
たいしょうか	対象化
たいしょあん	対処案
たいしゅうし	大衆紙	大衆誌
たいしゅうか	大衆化
たいしゃりつ	代謝率
たいしゃいろ	代赭色
たいしつてき	体質的
たいざいしゃ	滞在者
たいざいさき	滞在先	帯在先
たいさんせい	耐酸性
たいさくよう	対策用
たいさくまえ	対策前
たいさくほう	対策法
たいさくひん	対策品
たいさくあん	対策案
たいさいぼう	体細胞
たいさいじつ	大祭日
たいこしょう	耐故障
たいこくかん	大国間
たいこうぼう	太公望
たいこうせん	対抗戦
たいこうせい	耐候性	退行性
たいこうしん	対抗心
たいこうしゃ	対抗者	対向車	対抗車
たいこうしき	対向式
たいこうさく	対抗策	対抗作
たいこうこく	大公国
たいげんどめ	体言止め
たいけんれい	体験例
たいけんへん	体験編
たいけんばん	体験版
たいけんだん	体験談
たいけんしゃ	体験者
たいけいろん	体系論
たいけいない	体系内
たいけいてき	体系的
たいけいせい	体系性
たいけいがく	体系学
たいくうほう	対空砲
たいくうない	体腔内
たいくうだん	対空弾
たいくうかき	対空火器
たいきんてつ	対近鉄
たいきょくし	大局視
たいきょくき	太極旗
たいきちゅう	大気中	待機中
たいきそせい	大気組成
たいきそくど	対気速度
たいきおせん	大気汚染
たいがいてき	対外的
たいかんてき	体感的
たいかんせい	耐寒性
たいかんしき	戴冠式
たいかんこく	対韓国
たいかくてき	体格的
たいかくせん	対角線
たいかくこう	対角項
たいかいめい	大会名
たいかいまえ	大会前
たいかいへん	大会篇
たいかいしん	大会新
たいかいしゃ	退会者
たいおんけい	体温計
たいおうほう	対応法
たいおうぶつ	対応物
たいおうひん	対応品
たいおうばん	対応版
たいおうてん	対応点
たいおうづけ	対応付け
たいおうずみ	対応済
たいおうしゃ	対応車
たいおうしき	対応仕切
たいおうさく	対応策
たいおうごく	対応語句
たいおうがた	対応型
たいいんれき	太陰暦
たいいんたち	隊員達
たいいくのひ	体育の日
たいいくさい	体育祭
たいいくけい	体育系
たいいくがく	体育学
たいいくかん	体育館
たいいくかい	体育会
たいいきはば	帯域幅
たいいきない	帯域内
たいいきてき	大域的
たいいきせい	大域性
たいあつせい	耐圧性
たあいしょう	多相性
たーすーしー	大四喜
とんやくみあい	問屋組合
とんねるこうか	トンネル効果
とんそうきょく	遁走曲
とんさんきょく	東三局
とんいっきょく	東一局
とりものちょう	捕物帖	捕物帳
とりもなおさず	取りも直さず
とりもどしけん	取戻権
とりひきていし	取引停止
とりひきかかく	取引価格
とりつだいちり	都立大地理
とりつだいがく	都立大学
とりつこうこう	都立高校
とりつけりょう	取付料
とりつけぶぶん	取付部分
とりつけこうじ	取付工事
とりつけかくど	取付角度
とりちがえかた	取り違え方
とりすこうつう	鳥栖交通
とりしらべしつ	取調室
とりしまりやく	取締役
とりしまりほう	取締法
とりこしぐろう	取越し苦労	取り越し苦労
とりくみひょう	取組表
とりかぶとぞく	Aconitum	トリカブト属
とよひほんせん	豊肥本線
とよはしぎだい	豊橋技大
とよなかしない	豊中市内
とよなかしてん	豊中支店
とよたしゃたい	トヨタ車体
とよたこうせん	豊田高専
とよかわいなり	豊川稲荷
とよあきつしま	豊秋津洲
とやまだいがく	富山大学
とやましんこう	富山新港
とやまけんだい	富山県大
とやまけんけい	富山県警
とやまくうこう	富山空港
ともだちどうし	友達同士
ともだちていど	友達程度
ともだちづくり	友達作り
とみひさちょう	富久町
とみつかちょう	富塚町
とみじゅうろう	富十郎
とみさとちょう	富里町
とばくしゅべつ	賭博種別
とばくしじょう	賭博市場
とはんしゃせん	登坂車線
とのやまちょう	殿山町
とのさまばった	殿様蝗虫
とのさまがえる	殿様蛙
とねりしんのう	舎人親王
となりきんじょ	隣近所
とないぼうしょ	都内某所
とないきんこう	都内近郊
とどほっけむら	椴法華村
とどけでじこう	届出事項
とどうけいけん	渡道経験
とつめんきょう	凸面鏡
とつにゅうぐち	突入口
とつとつかいじ	咄々怪事	咄咄怪事
とつぜんへんい	突然変異
とつがたでんき	凸型電機
とっぱほうほう	突破方法
とっしんりょく	突進力
とっこうやろう	特攻野郎
とっくんちゅう	特訓中
とっきょりょう	特許料
とっきょちょう	特許庁
とっきょせいど	特許制度
とっきょしょう	特許証
とっきょげんぼ	特許原簿
とっきゅうよう	特急用
とっきゅうしゅ	特級酒
とっきゅうしゃ	特急車
とっきゅうけん	特急券
とっきゅうがた	特急型
とっかんこうじ	突貫工事
とちわかじだい	栃若時代
とちょうちょう	ト長調
とちょういてん	都庁移転
とちゅうりゃく	途中略
とちゅうさんか	途中参加
とちゅうこうき	途中降機
とちゅうげしゃ	途中下車
とちゅうけいろ	途中経路
とちゅうけいか	途中経過
とちゅうきけん	途中棄権
とちぼっしゅう	土地没収
とちほんいせい	土地本位制
とちほゆうぜい	土地保有税
とちばいしゅう	土地買収
とちだいちょう	土地台帳
とちしようけん	土地使用権
とちしゅうよう	土地収用
とちぎょうせい	土地行政
とちぎけんない	栃木県内
とちぎけんじん	栃木県人
とちかがみもく	Hydrocharitales	トチカガミ目
とそうめんせき	塗装面積
とそうへんこう	塗装変更
とそうせつめい	塗装説明
としんほうこう	都心方向
としんぶくかん	都心部区間
としょもくろく	図書目録
としょぶんかん	図書分館
としょしんぶん	図書新聞
としょけんさく	図書検索
としょかんまえ	図書館前
としょかんだい	図書館大
としょかんがく	図書館学
としょかんいん	図書館員
としゅつりょう	吐出量
としゅくうけん	徒手空拳
とししゅうゆう	都市周遊
としかんゆそう	都市間輸送
としかんきょう	都市環境
としかんいどう	都市間移動
とざんでんしゃ	登山電車
とざんてつどう	登山鉄道
とざんあんない	登山案内
とこしこうえん	戸越公園
とけいほうこう	時計方向
とけいないぞう	時計内蔵
とけいぜんたい	時計全体
とけいしょうぶ	時計勝負
とくれいくかん	特例区間
とくようぶくろ	徳用袋
とくやまそーだ	徳山曹達
とくめいせいど	匿名制度
とくめいきぼう	匿名希望
とくましょてん	徳間書店
とくべつりえき	特別利益
とくべつよさん	特別予算
とくべつふろく	特別付録
とくべつはんぷ	特別頒布
とくべつとそう	特別塗装
とくべつてあて	特別手当
とくべつたんぽ	特別担保
とくべつじあい	特別試合
とくべつしょち	特別処置
とくべつしょく	特別色	特別食	特別職
とくべつしょう	特別賞
とくべつしてい	特別指定
とくべつさんか	特別参加
とくべつこうぎ	特別講義
とくべつけつぎ	特別決議
とくべつくかん	特別区間
とくべつくいき	特別区域
とくべつきてい	特別規定
とくべつきごう	特別記号
とくべつきかく	特別企画
とくべつかてん	特別加点
とくべつかかく	特別価格
とくべつかいひ	特別会費
とくべついにん	特別委任
とくべつあつか	特別扱
とくひょうりつ	得票率
とくひょうすう	得票数
とくてんりょく	得点力
とくてんぶんぷ	得点分布
とくてんひりつ	得点比率
とくてんひょう	特典表	得点表
とくてんばめん	得点場面
とくてんはんい	得点範囲
とくてんちゅう	得点中
とくてんけいか	得点経過
とくていわしゃ	特定話者
とくていようと	特定用途
とくていぶんや	特定分野
とくていぶぶん	特定部分
とくていふのう	特定不能
とくていちいき	特定地域
とくていたすう	特定多数
とくていせんく	特定線区
とくていせつび	特定設備
とくていこじん	特定個人
とくていこうざ	特定口座
とくていくかん	特定区間
とくていいぞう	特定遺贈
とくちょうめん	特徴面
とくちょうぶつ	特徴物
とくちょうてん	特徴点
とくちょうてき	特徴的
とくちょうづけ	特徴付け
とくちゅうひん	特注品
とくそくじょう	督促状
とくそうけいじ	特捜刑事
とくせいれっか	特性劣化
とくせいびょう	特性病
とくせいひょう	特性表
とくせいすうち	特性数値
とくじゅけいき	特需景気
とくしゅろせん	特殊路線
とくしゅようと	特種用途	特殊用途
とくしゅほそう	特殊舗装
とくしゅへいき	特殊兵器
とくしゅぶらく	特殊部落
とくしゅぶたい	特殊部隊
とくしゅこうぐ	特殊工具
とくしゅこうぎ	特殊講義
とくしゅこうか	特殊効果
とくしゅぎのう	特殊技能
とくしゅきのう	特殊機能
とくしゅきごう	特殊記号
とくしゅうごう	特集号
とくしゅうきじ	特集記事
とくしってんさ	得失点差
とくさつえいが	特撮映画
とくがわむせい	徳川夢声
とくがわじだい	徳川時代
とくがわけいき	徳川慶喜
とくいまんめん	得意満面
とくいふとくい	得意不得意
とくいたいしつ	特異体質
とくいせきぶん	特異積分
ときわじんじゃ	常磐神社
ときわこうえん	常磐公園
とおりいっぺん	通り一遍
とおやまざくら	遠山桜
とおしばんごう	通し番号
とえいみたせん	都営三田線
とえいちかてつ	都営地下鉄
とえいせんない	都営線内
とえいこうつう	都営交通
とえいうんちん	都営運賃
とうろくわしゃ	登録話者
とうろくりょう	登録料
とうろくめいぼ	登録名簿
とうろくひょう	登録表	登録票
とうろくはがき	登録葉書
とうろくちゅう	登録中
とうろくそうさ	登録操作
とうろくせいど	登録制度
とうろくじょう	登録上
とうろくじゅり	登録受理
とうろくしょう	登録証
とうろくごすう	登録語数
とうろくくぶん	登録区分
とうろくきのう	登録機能
とうろくきせい	登録規制
とうろくいらい	登録依頼
とうろうながし	灯籠流し
とうりゅうもん	登竜門
とうりつりょく	統率力
とうりつしんし	倒立振子
とうらうどねす	等ラウドネス
とうようぶんこ	東洋文庫
とうようふとう	東洋埠頭
とうようでんき	東洋電器	東洋電機
とうようちょう	東陽町
とうようじょし	東洋女子
とうようしゅぎ	東洋主義
とうようしそう	東洋思想
とうようさんそ	東洋酸素
とうようかんじ	当用漢字
とうようかがく	東洋化学
とうようえいわ	東洋英和
とうよういがく	東洋医学
とうめいぶぶん	透明部分
とうほくちほう	東北地方
とうほくちいき	東北地域
とうほくしょく	東北色
とうほくしてん	東北支店
とうほくししゃ	東北支社
とうほうぶんぷ	等方分布
とうほうふたん	当方負担
とうほうじょし	桐朋女子
とうほうじたく	当方自宅
とうほうしてい	当方指定
とうぶほんしゃ	東武本社
とうぶにっこう	東武日光
とうぶでんしゃ	東武電車
とうぶてつどう	東武鉄道
とうぶせんない	東武線内
とうぶせんせん	東部戦線
とうぶきょうだ	頭部強打
とうぶかいてん	頭部回転
とうぶえんせん	東武沿線
とうぶあさくさ	東武浅草
とうふくじえき	東福寺駅
とうひょうれい	投票例
とうひょうりつ	投票率
とうひょうらん	投票欄
とうひょうよう	投票用
とうひょうぶん	投票分
とうひょうばこ	投票箱
とうひょうせい	投票制
とうひょうすう	投票数
とうひょうじょ	投票所
とうひょうしゃ	投票者
とうひょうさき	投票先
とうひょうけん	投票権	投票券
とうひょうきじ	投票記事
とうひょうがく	投票額
とうひすうれつ	等比数列
とうひこうどう	逃避行動
とうひかつどう	逃避活動
とうばんちょう	当番町
とうばんじゃん	豆瓣醤	豆板醤
とうにんどうし	当人同士
とうにんいがい	当人以外
とうにゅうぐち	投入口
とうなんぼうし	盗難防止
とうなんほけん	盗難保険
とうなんとどけ	盗難届
とうなんたはつ	盗難多発
とうなんこうい	盗難行為
とうなんあじあ	東南アジア
とうないていい	頭内定位
とうどうばつい	党同伐異
とうとすいさん	東都水産
とうちょうよう	頭頂葉
とうちょうほう	盗聴法
とうちゃくりつ	到着率
とうちゃくぶん	到着分
とうちゃくとし	到着都市
とうだいりいち	東大理一
とうだいぶつり	東大物理
とうだいでんし	東大電子
とうだいでんき	東大電気
とうだいちぶつ	東大地物
とうだいそけん	東大素研
とうだいしんり	東大心理
とうだいこまば	東大駒場
とうだいこうか	東大工化
とうだいきこう	東大気候
とうだいきかい	東大機械
とうだいかがく	東大化学
とうだいおうか	東大応化
とうたつはんい	到達範囲
とうたつじかん	到達時間
とうたつしゅぎ	到達主義
とうたつきょり	到達距離
とうたつかのう	到達可能
とうそつりょく	統率力
とうそうけいろ	逃走経路
とうせきへんか	等積変化
とうせきちゅう	透析中
とうせきそうち	透析装置
とうせきかいろ	透析回路
とうせきかいし	透析開始
とうすいきょう	陶酔境
とうじょうりつ	搭乗率
とうじょうまえ	登場前	搭乗前
とうじょうびん	搭乗便
とうじょうせん	東上線
とうじょうしゃ	搭乗者
とうじょうけん	搭乗券
とうじょうぐち	搭乗口
とうじょううん	塔状雲
とうじょういん	搭乗員
とうじゆうめい	当時有名
とうじゅうろう	藤十郎
とうじつちゅう	当日中
とうじつじさん	当日持参
とうじつしてい	当日指定
とうじつさんか	当日参加
とうじしゃかん	当事者間
とうしれいしつ	塔指令室
とうしょよてい	当初予定
とうしょよそう	当初予想
とうしょきたい	当初期待
とうしょうめん	刀削麺
とうしょうにぶ	東証二部
とうしょうぐう	東照宮
とうしゅりょく	投手力
とうしゅぶもん	投手部門
とうしゅきよう	投手起用
とうしへんかん	透視変換
とうしばちょう	東芝町
とうしばきかい	東芝機械
とうしはいぶん	投資配分
とうしつりょう	等質量
とうししんたく	投資信託
とうししゃえい	透視射影
とうしけいかく	投資計画
とうしきろんり	等式論理
とうざかりこし	当座借越
とうざいかくさ	東西格差
とうさすうれつ	等差数列
とうさいきすう	搭載機数
とうさいかのう	搭載可能
とうごかいせき	統語解析
とうごうろんり	等号論理
とうごうひかく	等号比較
とうごうしょり	統合処理
とうこうりょう	投稿量
とうこうひんど	投稿頻度
とうこうばしょ	投稿場所
とうこうはんい	投稿範囲
とうこうちゅう	登校中	投稿中
とうこうたいど	投稿態度
とうこうせんず	等高線図
とうこうじてん	投稿時点
とうこうじかん	投稿時間
とうこうしけん	投稿試験
とうこうしかく	投稿資格
とうこうこうい	投稿行為
とうこうけんき	東航研機
とうこうきんし	投稿禁止
とうこうきょひ	登校拒否
とうこうきみつ	投稿機密
とうこうきてい	投稿規定
とうこうかのう	投稿可能
とうこういらい	投稿依頼
とうこういしき	投稿意識
とうげんきょう	桃源郷
とうけんがけい	陶犬瓦鶏
とうけつぼうし	凍結防止
とうけつどうろ	凍結道路
とうけいりょう	統計量
とうけいぶんぷ	統計分布
とうけいぶつり	統計物理
とうけいひょう	統計表
とうけいせいど	統計精度
とうけいすうじ	統計数字
とうけいじょう	統計上
とうけいしょり	統計処理
とうけいけっか	統計結果
とうぎこうそく	党議拘束
とうきょくしゃ	当局者
とうきょうわん	東京湾
とうきょうほか	東京他
とうきょうべん	東京弁
とうきょうへん	東京篇
とうきょうびん	東京便
とうきょうばん	東京版
とうきょうはつ	東京発
とうきょうどう	東京堂
とうきょうてん	東京店
とうきょうちく	東京地区
とうきょうだい	東教大	東京大
とうきょうせん	東京戦
とうきょうじん	東京人
とうきょうしぶ	東京支部
とうきょうしば	東京芝
とうきょうしき	東京式
とうきょうこう	東京港	東京校
とうきょうけん	東京圏
とうきょうけい	東京系
とうきょうぐち	東京口
とうきょうがわ	東京側
とうきょうがす	東京ガス	東京瓦斯
とうきょうかい	当協会
とうきょうえき	東京駅
とうきょういち	東京一
とうきゅうまえ	東急前	投球前
とうきゅうせん	東急線
とうきゅうがわ	東急側
とうきとりひき	投機取引
とうきずみしょ	登記済書
とうきしんせい	登記申請
とうきげんてい	冬季限定
とうきぎむしゃ	登記義務者
とうききゅうか	冬期休暇
とうがいていい	頭外定位
とうがいちいき	当該地域
とうがいじどう	当該児童
とうがいくかん	当該区間
とうがいかしょ	当該箇所
とうがいえいが	当該映画
とうかへんかん	等価変換
とうかつほんぶ	統括本部
とうかつしてん	統括支店
とうかそんしつ	透過損失
とうかそうおん	等価騒音
とうかこうかん	等価交換
とうかかんけい	等価関係
とうかいぱるぷ	東海パルプ
とうかいちほう	東海地方
とうかいちいき	東海地域
とうかいじしん	東海地震
とうかいきせん	東海汽船
とうかいいとう	東海以東
とうおんへんか	等温変化
とうおんたいき	等温大気
とうえいどうが	東映動画
とうえいけんさ	投影検査
とうえいえいが	東映映画
とういつりろん	統一理論
とういつこっか	統一国家
とういつげんご	統一言語
とういつきかく	統一規格
とういそうめん	等位相面
とういいんかい	当委員会
とうあんようし	答案用紙
とうあれんめい	東亜連盟
とうあぺいんと	東亜ペイント
とうあつへんか	等圧変化
とうあけんせつ	東亜建設
とうあがくえん	東亜学園
といたがくえん	戸板学園
といあわせさき	問い合わせ先
てんりゅうがわ	天竜川
てんりこうこう	天理高校
てんらんじあい	天覧試合
てんもんたんい	天文単位
てんもんざっし	天文雑誌
てんもんがっか	天文学科
てんめんじゃん	甜麺醤
てんめいふめい	店名不明
てんむてんのう	天武天皇
てんぽめんせき	店舗面積
てんぷらあぶら	天ぷら油
てんぷふぁいる	添付ファイル
てんぷしりょう	添付資料
てんぷしょるい	添付書類
てんびんきゅう	天秤宮
てんのうようご	天皇擁護
てんのうへいか	天皇陛下
てんのうひはん	天皇批判
てんのうちょう	天王町
てんのうせいど	天皇制度
てんのうじしん	天皇自身
てんのうじえき	天王寺駅
てんのうしょう	天皇賞
てんねんしょく	天然色
てんねんしぜん	天然自然
てんねんしげん	天然資源
てんねんかじつ	天然果実
てんねんうらん	天然ウラン
てんにゅうせい	転入生
てんどうぼうし	転動防止
てんとうちゅう	点灯中
てんとうきせい	点灯規制
てんとうかかく	店頭価格
てんてきちゅう	点的中
てんちょうさき	転調先
てんちゅうせつ	天中節
てんちゅうさつ	天中殺
てんちゅうぐみ	天忠組	天誅組
てんちちりょう	転地治療
てんちそうぞう	天地創造
てんちしんめい	天地神明
てんだいしゅう	天台宗
てんだいしかん	天台止観
てんたいしょう	点対称
てんたいしゃく	転貸借
てんたいがぞう	天体画像
てんそうりょう	転送量	転送料
てんそうちゅう	転送中
てんそうそくど	転送速度
てんそうそうち	転送装置
てんそうじかん	転送時間
てんそうしょり	転送処理
てんそうきのう	転送機能
てんそうきこう	転送機構
てんそうきかん	転送期間
てんそうかのう	転送可能
てんせっしょく	点接触
てんせきとどけ	転籍届
てんせいりんね	転生輪廻
てんせいじんご	天声人語
てんすうせいど	点数制度
てんじんまつり	天神祭
てんじんだいら	天神平
てんじょうめん	天井面
てんじょうびと	殿上人
てんじょうつり	天井吊
てんじょうけい	纏繞茎
てんじょうがわ	天井川
てんじょうかい	天上界
てんじょううら	天井裏
てんじょういん	添乗員
てんじぶろっく	点字ブロック
てんじてんのう	天智天皇
てんじそくばい	展示即売
てんじくもめん	天竺木綿
てんじくあおい	天竺葵
てんじかんけい	点字関係
てんじいんさつ	点字印刷
てんしょくまえ	転職前
てんしょくさき	転職先
てんしょうどう	天賞堂
てんしゅつこう	転出校
てんしゅきょう	天主教
てんしゅうごう	点集合
てんさくしどう	添削指導
てんさいちへん	天災地変
てんさいじょう	点差以上
てんさいじゆう	転載自由
てんさいきんし	転載禁止
てんさいきょか	転載許可
てんさいきさい	天才奇才
てんさいかのう	転載可能
てんさいかいし	転載開始
てんさいいらい	転載依頼
てんごくきぶん	天国気分
てんこうりょく	転向力
てんこうしだい	天候次第
てんけんせいび	点検整備
てんけんじこう	点検事項
てんくうじょう	天空城
てんきよほうし	天気予報士
てんきょつうち	転居通知
てんきょういん	癲狂院
てんきばんぐみ	天気番組
てんがいこどく	天涯孤独
てんかぶつなど	添加物等
てんかとういつ	天下統一
てんかつきゅう	天蝎宮
てんかたいへい	天下泰平
てんかけいしき	点火形式
てんかいゆうり	展開有利
てんかいぶぶん	展開部分
てんかいっぴん	天下一品
てんかいちゅう	展開中
てんかいそくど	展開速度
てんかいじたい	展開自体
てんかいきぼう	展開希望
てんいへんかん	転移変換
てれびほうそう	テレビ放送
てれびばんぐみ	テレビ番組
てるてるぼうず	照る照る坊主	てるてる坊主
てらまちどおり	寺町通
てらだとらひこ	寺田寅彦
てはいりょこう	手配旅行
てにゅうりょく	手入力
てにもつけんさ	手荷物検査
てとりあしとり	手取り足取り
てつどうろばん	鉄道路盤
てつどうようご	鉄道用語
てつどうゆそう	鉄道輸送
てつどうもけい	鉄道模型
てつどうまんが	鉄道漫画
てつどうぶもん	鉄道部門
てつどうでんか	鉄道電化
てつどうせんろ	鉄道線路
てつどうせいび	鉄道整備
てつどうしょう	鉄道省
てつどうしゅみ	鉄道趣味
てつどうざっし	鉄道雑誌
てつどうぎょう	鉄道業
てつどうきょく	鉄道局
てつどうきやく	鉄道規約
てつどうかもつ	鉄道貨物
てつどうかくし	鉄道各誌
てつどういがい	鉄道以外
てつづきじょう	手続き上
てつじょうもう	鉄条網
てつがくろんぎ	哲学論議
てつがくばたけ	哲学畑
てつがくだんぎ	哲学談義
てつがくじょう	哲学上
てつかいしょく	鉄灰色
てっとうてつび	徹頭徹尾
てっていひかく	徹底比較
てったいちゅう	撤退中
てったいきげん	撤退期限
てっこうじょう	鉄工場
てっこうぎょう	鉄鋼業
てっきょかのう	撤去可能
てっきょうした	鉄橋下
てっかどんぶり	鉄火丼
てしくつちょう	弟子屈町
てしおなかがわ	天塩中川
てくびこっせつ	手首骨折
てきようはんい	適用範囲
てきようじれい	適用事例
てきようこうか	適用効果
てきようけっか	適用結果
てきようきそく	適用規則
てきようきかい	適用機会
てきようかのう	適用可能
てきほんしゅぎ	敵本主義
てきほんきょち	敵本拠地
てきほうこうい	適法行為
てきばくげきき	敵爆撃機
てきはつじけん	摘発事件
てきはつきこう	摘発機構
てきはかいりつ	敵破壊率
てきちゅうりつ	的中率
てきたいこうい	敵対行為
てきたいいしき	敵対意識
てきせんとうき	敵戦闘機
てきせいろこう	適正露光
てきせいりょく	適正力
てきせいしけん	適性試験
てきせいけんさ	適性検査
てきせいぎのう	適正技能
てきせいきあつ	適正気圧
てきせいかかく	適正価格
てきじにるいだ	適時二塁打
てきぎへんこう	適宜変更
てきぎはんだん	適宜判断
てきおうりょく	適応力
てきおうはんい	適応範囲
てきおうしょう	適応症
てきおうかのう	適応可能
てがたわりびき	手形割引
てがたひきうけ	手形引受
てがたさいけん	手形債権
ていりょうてき	定量的
ていりょうせん	定量戦
ていりょうせい	定量性
ていりょうきん	低料金
ていりゅうじょ	停留所
ていりゅうしょ	停留所
ていめいじだい	低迷時代
ていのうしゅく	低濃縮
ていねんれいか	低年齢化
ていねこうざん	手稲砿山
ていどもんだい	程度問題
ていどひつよう	程度必要
ていとでんてつ	帝都電鉄
ていとうかかく	抵当価格
ていでんりゅう	定電流
ていでんあつか	低電圧化
ていちゅうそく	低中速
ていちゃくりつ	定着率
ていちゃくぶつ	定着物
ていちゃくせい	定着性
ていちゃくえき	定着液
ていたいちゅう	停滞中
ていそすんぜん	提訴寸前
ていそうりゅう	底層流
ていせんりょう	低線量
ていせいふごう	訂正符号	訂正符合
ていせいちょう	低成長
ていせいしてき	訂正指摘
ていせいきのう	訂正機能
ていせいかのう	訂正可能
ていせいかしょ	訂正箇所
ていすうぜせい	定数是正
ていすうきごう	定数記号
ていすうかくさ	定数格差
ていすいじゅん	低水準
ていじれんらく	定時連絡
ていじょうてき	定常的
ていじょうたい	定常態
ていじょうせい	定常性
ていじょうこう	定常光
ていじょうおん	定常音
ていじゅうしん	低重心
ていじそうかい	定時総会
ていじかいすう	提示回数
ていじうんこう	定時運行
ていしんしょう	逓信省
ていしょうしゃ	提唱者
ていしゅつりつ	提出率
ていしゅつよう	低出葉	提出用
ていしゅつぶつ	提出物
ていしゅつじょ	提出所
ていしゅつしゃ	提出者
ていしゅつさき	提出先
ていしゃちゅう	停車中
ていしゃちえん	停車遅延
ていしゃじょう	停車場
ていしゃじふん	停車時分
ていしゃじかん	停車時間
ていしゃきょり	停車距離
ていしゃかのう	停車可能
ていしもんだい	停止問題
ていしほうほう	停止方法
ていしすんぜん	停止寸前
ていししんごう	停止信号
ていししょぶん	停止処分
ていしげきせい	低刺激性
ていざんぎょう	定残業
ていざいはほう	定在波法
ていこくほてる	帝国ホテル
ていこくせんい	帝国繊維
ていこくせきゆ	帝国石油
ていこくしゅと	帝国首都
ていこくしゅぎ	帝国主義
ていこくぎかい	帝国議会
ていこうりょく	抵抗力
ていこうかねつ	抵抗加熱
ていけいしょり	定型処理
ていくうひこう	低空飛行
ていぎもんだい	定義問題
ていぎほうほう	定義方法
ていぎないよう	定義内容
ていぎくうかん	定義空間
ていきれっしゃ	定期列車
ていきょうもと	提供元
ていきょうだい	帝京大
ていきょうしゃ	提供者
ていきょうさき	提供先
ていきほしゅび	定期保守日
ていきほうこく	定期報告
ていきほうえい	定期放映
ていきとりひき	定期取引
ていきとうこう	定期投稿
ていきてんけん	定期点検
ていきつみきん	定期積金
ていきこうどく	定期購読
ていきけんしん	定期検診
ていきかんこう	定期観光
ていきかいさい	定期開催
ていきかいいん	定期会員
ていかはんばい	定価販売
ていかごうけい	定価合計
ていかくそくど	定格速度
ていかかくひん	低価格品
ていかかくしゃ	低価格車
ていかいぞうど	低解像度
ていかいじょう	定価以上
ていおんやけど	低温火傷
ていおうしょう	帝王賞
ていいきとうか	低域透過
ていいきつうか	低域通過
ていあんいけん	提案意見
てあたりしだい	手当り次第	手当たり次第
てーぶるさんざ	テーブル山座
つるやなんぼく	鶴屋南北
つるにょうぼう	鶴女房
つるしょくぶつ	蔓植物
つりてんじょう	釣天井
つりぐかんけい	釣具関係
つばきしゅぞう	椿酒造
つなみけいほう	津波警報
つつみびょうし	包表紙
つついやすたか	筒井康隆
つちやぶんめい	土屋文明
つちのとひつじ	己未
つちうらにこう	土浦二高
つだじゅくだい	津田塾大
つけこみちょう	付込帳
つくばまるぜん	筑波丸善
つくばばんぱく	筑波万博
つくばだいがく	筑波大学
つくばこうそく	筑波高速
つくつくぼうし	つくつく法師
つきだてちょう	築館町
つきしょじゅん	月初旬
つがるはんとう	津軽半島
つうわぼうじゅ	通話傍受
つうわないよう	通話内容
つうようじたい	通用字体
つうようきかん	通用期間
つうどうそしき	通導組織
つうせつどおり	通説通り
つうすいようそ	通水要素
つうじょうぶん	通常文
つうじょうばん	通常版	通常盤
つうじょうだん	通常弾
つうじょうじん	通常人
つうじょうこん	通常婚
つうじょうがた	通常型
つうしんりろん	通信理論
つうしんりょう	通信量	通信料
つうしんぶんや	通信分野
つうしんひよう	通信費用
つうしんとぜつ	通信途絶
つうしんちゅう	通信中
つうしんそくど	通信速度
つうしんそうち	通信装置
つうしんせつび	通信設備
つうしんじょう	通信上
つうしんじっぴ	通信実費
つうしんじかん	通信時間
つうしんしょり	通信処理
つうしんしせつ	通信施設
つうしんこうざ	通信講座
つうしんけいろ	通信経路
つうしんぎょう	通信業
つうしんきょり	通信距離
つうしんきばん	通信基盤
つうしんきのう	通信機能
つうしんきこう	通信機構
つうしんきかん	通信機関
つうしんきかく	通信規格
つうしんがくぶ	通信学部
つうしんかのう	通信可能
つうしんあいて	通信相手
つうさんだりつ	通算打率
つうさんしょう	通産省	通産相	通商産業省
つうさんぎかん	通商産業技官	通産技官
つうさんきょく	通産局
つうこうりょう	通行料	通行量
つうこうふのう	通行不能
つうこうちゅう	通行中
つうこうくぶん	通行区分
つうこうきんし	通行禁止
つうこうきょか	通行許可
つうこうかのう	通行可能
つうげんごてき	通言語的
つうきんろせん	通勤路線
つうきんゆそう	通勤輸送
つうきんていき	通勤定期
つうきんちゅう	通勤中
つうきんせんく	通勤線区
つうきんじごく	通勤地獄
つうきんじかん	通勤時間
つうきんけいろ	通勤経路
つうきんきゃく	通勤客
つうきこうぞう	通気構造
つうがくろせん	通学路線
つうがくゆそう	通学輸送
つうがくちゅう	通学中
つうがくじかん	通学時間
つうがくけいろ	通学経路
つうかれっしゃ	通過列車
つうかほんすう	通過本数
つうかはんべつ	通過判別
つうかでんしゃ	通過電車
つうかたいいき	通過帯域
つうかせいさく	通貨政策
つうかせいげん	通過制限
つうかじんいん	通過人員
つうかじゅんい	通過順位
つうかうんてん	通過運転
ついとつぼうし	追突防止
ついちょうきん	追徴金
ついちょうがく	追徴額
ついぜんくよう	追善供養
ついじゅうせい	追従性
ついしょうめつ	対消滅
ついこうちゅう	遂行中
ついかれっきょ	追加列挙
ついかほうこく	追加報告
ついかぶんけん	追加文献
ついかはつばい	追加発売
ついかはいぶん	追加配分
ついかはいとう	追加配当
ついかじっそう	追加実装
ついかしつもん	追加質問
ついかさくひん	追加作品
ついかさくじょ	追加削除
ついかこうもく	追加項目
ついかこうかい	追加公開
ついかこうえん	追加公演
ついかかんざん	追加換算
ついかかんさん	追加換算
ついかあんない	追加案内
ちんどうちゅう	珍道中
ちんとうびょう	沈頭鋲
ちんだんきだん	珍談奇談
ちんたいしゃく	賃貸借
ちんたいぎょう	賃貸業
ちんじょうしょ	陳情書
ちんじゅつしょ	陳述書
ちんしゃじょう	陳謝状
ちんしゃくにん	賃借人
ちんしゃくけん	賃借権
ちんしもっこう	沈思黙考
ちんこんきしん	鎮魂帰神
ちんぎんしすう	賃金指数
ちんぎんかくさ	賃金格差
ちりょうはんい	治療範囲
ちりょうちゅう	治療中	治寮中
ちりょうこうか	治療効果
ちりょうこうい	治療行為
ちりめんじゃこ	縮緬雑魚
ちりてきぶんぷ	地理的分布
ちりてきがいぶ	地理的外部
ちりきょういく	地理教育
ちょめいさっか	著名作家
ちょぼくじょう	貯木場
ちょっこうびん	直行便
ちょっこうせい	直交性
ちょっこうじく	直交軸
ちょっこうけい	直交系
ちょっこうぐみ	直行組
ちょっこうがた	直交型
ちょっけつしき	直結式
ちょっけいやく	直径約
ちょっかんてき	直観的	直感的
ちょっかっこう	直滑降
ちょちくほけん	貯蓄保険
ちょぞうそしき	貯蔵組織
ちょすいりょう	貯水量
ちょすいそしき	貯水組織
ちょしゃじしん	著者自身
ちょしゃきごう	著者記号
ちょさくちゅう	著作中
ちょくれつしき	直列式
ちょくれつけい	直列系
ちょくれつがた	直列型
ちょくりゅうぶ	直流部
ちょくりゅうき	直流機
ちょくりゅうか	直流化
ちょくりつせい	直立性
ちょくりつけい	直立茎
ちょくゆにゅう	直輸入
ちょくゆしゅつ	直輸出
ちょくやくてき	直訳的
ちょくほうたい	直方体
ちょくばいてん	直売店
ちょくはんてん	直販店
ちょくにんかん	勅任官
ちょくつうびん	直通便
ちょくつうせん	直通線
ちょくせんまえ	直線前
ちょくせんふり	直線不利
ちょくせんてき	直線的
ちょくせんせい	直線性
ちょくせんしき	直線式
ちょくせんぐん	直線群
ちょくせんがわ	直線側
ちょくせんがい	直線外
ちょくせつほう	直接法	直説法
ちょくせつばち	直接鉢
ちょくせつてき	直截的	直接的
ちょくせつぜい	直接税
ちょくせつせん	直接線	直接戦
ちょくせつこう	直接光
ちょくせつおん	直接音
ちょくしんせい	直進性
ちょくしんしゃ	直進車
ちょくさいてき	直截的
ちょくげきだん	直撃弾
ちょくえいてん	直営店
ちょきんりょう	貯金量
ちょきんきょく	貯金局
ちょうりつほう	調律法
ちょうりちゅう	調理中
ちょうりじかん	調理時間
ちょうゆうめい	超有名
ちょうもんかい	聴聞会
ちょうもくひじ	長目飛耳
ちょうめんづら	帳面面
ちょうめいもん	超名門
ちょうめいばん	超名盤
ちょうむじゅん	超矛盾
ちょうみんよう	町民用
ちょうみんぜい	町民税
ちょうみりょう	調味料
ちょうみつせい	稠密性
ちょうまんいん	超満員
ちょうまじゅつ	超魔術
ちょうぼじょう	帳簿上
ちょうぼうえん	超望遠
ちょうほんにん	張本人
ちょうほどうき	調歩同期
ちょうほうけい	長方形
ちょうほういん	諜報員
ちょうへんばん	長編版
ちょうへんせい	長編成
ちょうへいれつ	超並列
ちょうへいめん	超平面
ちょうへいそく	腸閉塞
ちょうへいせい	徴兵制
ちょうぶんさん	超分散
ちょうふくぶん	重複分
ちょうふがおか	調布ヶ丘
ちょうびんぼう	超貧乏
ちょうばつてき	懲罰的
ちょうはながた	蝶花形
ちょうはつてき	挑発的
ちょうはちょう	長波長
ちょうねんてん	腸捻転
ちょうねくたい	蝶ネクタイ
ちょうにんげん	超人間
ちょうなんもん	超難問
ちょうないかい	町内会
ちょうどきゅう	超弩級
ちょうどうけん	聴導犬
ちょうとくだい	超特大
ちょうでんどう	超電導	超伝導
ちょうてんれつ	頂点列
ちょうてんすう	頂点数
ちょうてんかん	頂点間
ちょうてじゅん	長手順
ちょうていやく	調停役
ちょうていそく	超低速
ちょうていしゃ	調停者
ちょうていくう	超低空
ちょうていおん	超低音
ちょうちんぴん	超珍品
ちょうちょうは	超長波
ちょうだりょく	長打力
ちょうだいたん	超大胆
ちょうたんしょ	長短所
ちょうたつさき	調達先
ちょうたいまん	超怠慢
ちょうたいそく	長大息
ちょうたいさく	超大作
ちょうたいこく	超大国
ちょうぞうかん	超増感
ちょうそんめい	町村名
ちょうそんせい	町村制
ちょうぜつてき	超絶的
ちょうせんぼん	朝鮮本
ちょうせんてき	挑戦的
ちょうせんせい	朝鮮製
ちょうせんじん	朝鮮人
ちょうせんしゃ	挑戦者
ちょうせんけん	挑戦権
ちょうせんけい	朝鮮系
ちょうせんあめ	朝鮮飴
ちょうせつけい	調節系
ちょうせいよう	調整用
ちょうせいやく	調整役
ちょうせいめい	超生命
ちょうせいまえ	調整前
ちょうせいほう	調整法
ちょうせいはば	調整幅
ちょうせいでん	長生殿
ちょうせいそく	超正則
ちょうせいすう	調整数
ちょうせいしゃ	調整者
ちょうせいしつ	調整室
ちょうせいしき	調整式
ちょうせいざい	調整剤
ちょうせいがく	調整額
ちょうせいかん	調性感
ちょうすうがく	超数学
ちょうじんてき	超人的
ちょうじつせい	超日性
ちょうじっすう	超実数
ちょうしんせい	超新星
ちょうしんけい	聴神経
ちょうしんくう	超真空
ちょうしょくじ	朝食時
ちょうしゅりつ	聴取率
ちょうしゅほう	聴取法
ちょうしゅしゃ	聴取者
ちょうしゅうき	長周期
ちょうしゅいち	聴取位置
ちょうしゃてい	長射程
ちょうしはずれ	調子外れ
ちょうしなうす	超品薄
ちょうざんぞう	長残像
ちょうざんこく	超残酷
ちょうさんりし	張三李四
ちょうさんぼし	朝三暮四
ちょうさようし	調査用紙
ちょうさぶそく	調査不足
ちょうさふぜん	調査不全
ちょうさひょう	調査票	調査表
ちょうさちゅう	調査中
ちょうさけっか	調査結果
ちょうさきかん	調査期間	調査機関
ちょうさいらい	調査依頼
ちょうごくあく	超極悪
ちょうごうよう	調合用
ちょうごうきん	超合金
ちょうこんざつ	超混雑
ちょうこくとう	彫刻刀
ちょうこくぐざ	彫刻具座
ちょうこうそく	超光速	超攻速	超高速
ちょうこうそう	超高層
ちょうこうぜつ	長広舌
ちょうこうせい	聴講生
ちょうこうかく	超広角
ちょうこういき	超広域
ちょうげんぼう	長元坊
ちょうげきせん	超激戦
ちょうけいこつ	蝶形骨
ちょうくうかん	聴空間	超空間
ちょうきよほう	長期予報
ちょうきょりば	長距離馬
ちょうきょせい	超巨星
ちょうきょこう	超虚構
ちょうきょうし	調教師
ちょうきほぞん	長期保存
ちょうきふざい	長期不在
ちょうきしきん	長期資金
ちょうききんり	長期金利
ちょうききおく	長期記憶
ちょうがたべん	蝶形弁
ちょうがいふじ	超涯不次
ちょうかんまく	腸間膜
ちょうかんどう	超感動
ちょうかんたん	超簡単
ちょうかんすう	超函数	超関数
ちょうかんかく	聴感覚
ちょうからくち	超辛口
ちょうかほけん	超過保険
ちょうかねもち	超金持ち
ちょうかそくど	超過速度
ちょうかくやす	超格安
ちょうかくてき	聴覚的
ちょうかくけん	聴覚研
ちょうかくけい	聴覚系
ちょうかくかん	聴覚感
ちょうかきんむ	超過勤務
ちょうかいそく	超快速
ちょうかいさん	鳥海山
ちょうかいけん	懲戒権
ちょうおんてん	調音点
ちょうおんそく	超音速
ちょうおんかい	長音階
ちょうおおもの	超大物
ちょうおおぐち	超大口
ちょうおおがた	超大型
ちょうえんけい	長円形
ちょうえつろん	超越論
ちょうえつてき	超越的
ちょうえつせい	超越性
ちょうえつすう	超越数
ちょうえつしゃ	超越者
ちょうえきけい	懲役刑
ちょううんぼう	朝雲暮雨
ちょううちゅう	超宇宙
ちょううすがた	超薄型
ちょういんしき	調印式
ちょういちろう	長一郎
ちょうあまくち	超甘口
ちょうあなうま	超穴馬
ちゅちぇしそう	チュチェ思想
ちゅうりょくこ	中力粉
ちゅうりゅうど	中粒度
ちゅうりつてき	中立的
ちゅうりつせい	中立性
ちゅうりつこく	中立国
ちゅうりつがわ	中立側
ちゅうもんぶん	注文分
ちゅうもんひん	注文品
ちゅうもんぬし	注文主
ちゅうもんとり	注文取り
ちゅうもんしょ	注文書
ちゅうもくてん	注目点
ちゅうもくさく	注目作
ちゅうもくかぶ	注目株
ちゅうむしょう	中務省
ちゅうぼうえん	中望遠
ちゅうへいけん	駐兵権
ちゅうぶんるい	中分類
ちゅうぶらりん	宙ぶらりん
ちゅうぶちほう	中部地方
ちゅうばんせん	中盤戦
ちゅうばちけん	中鉢研
ちゅうはいよう	中胚葉
ちゅうはいじく	中胚軸
ちゅうにゅうき	注入器
ちゅうにちせん	中日戦
ちゅうなんべい	中南米
ちゅうどくてき	中毒的
ちゅうどくせい	中毒性
ちゅうどくしゃ	中毒者
ちゅうどくいき	中毒域
ちゅうとはんぱ	中途半端
ちゅうとうきき	中東危機
ちゅうてつしょ	鋳鉄所
ちゅうていそく	中低速
ちゅうていしゃ	駐停車
ちゅうていおん	中低音
ちゅうていいき	中低域
ちゅうちょうき	中長期
ちゅうちきほう	中置記法
ちゅうたんぺん	中短編
ちゅうたいしゃ	中退者
ちゅうそくしゃ	中速車
ちゅうそくいき	中速域
ちゅうそうすい	中層水
ちゅうそううん	中層雲
ちゅうぜんじこ	中禅寺湖
ちゅうせんけん	抽選券
ちゅうせんかい	抽選会
ちゅうせきそう	沖積層
ちゅうせきせい	沖積世
ちゅうせいびし	中性微子
ちゅうせいてき	中性的	中世的
ちゅうせいだい	中生代
ちゅうせいそう	中性相
ちゅうせいしん	忠誠心
ちゅうせいしば	中性子場
ちゅうすうせい	中枢性
ちゅうすいえん	虫垂炎
ちゅうじょっき	中ジョッキ
ちゅうしんてん	中心点
ちゅうしんてき	中心的
ちゅうしんせん	中心線
ちゅうしんせい	中心性
ちゅうしんじく	中心軸
ちゅうしんしや	中心視野
ちゅうしんぐら	忠臣蔵
ちゅうしんがた	中心型
ちゅうしんがい	中心街
ちゅうしんかく	中心格	中心角
ちゅうしんえき	中心駅
ちゅうしょれい	中書令
ちゅうしょじま	中書島
ちゅうしょくひ	昼食費
ちゅうしょくじ	昼食時
ちゅうしょくご	昼食後
ちゅうしょかく	中書格
ちゅうしょおう	中書王
ちゅうしょうど	抽象度
ちゅうしょうぎ	中将棋
ちゅうしょうが	抽象画
ちゅうしょうか	抽象化
ちゅうしゅつぶ	抽出部
ちゅうしゅこつ	中手骨
ちゅうしゃわく	駐車枠
ちゅうしゃめん	中斜面
ちゅうしゃばり	注射針
ちゅうしゃとう	注射筒
ちゅうしゃだい	駐車代
ちゅうしゃたい	駐車帯
ちゅうしゃけん	駐車券
ちゅうしゃくか	注釈化
ちゅうしみすい	中止未遂
ちゅうしじてん	注視時点
ちゅうざいしょ	駐在所
ちゅうざいいん	駐在員
ちゅうさいにん	仲裁人
ちゅうさいしき	中彩色
ちゅうごくへん	中国編
ちゅうごくへい	中国兵
ちゅうごくふう	中国風
ちゅうごくばん	中国版
ちゅうごくない	中国内
ちゅうごくどう	中国道
ちゅうごくてき	中国的
ちゅうごくちゃ	中国茶
ちゅうごくせき	中国籍
ちゅうごくせい	中国製
ちゅうごくじん	中国人
ちゅうごくしょ	中国書
ちゅうごくしぶ	中国支部
ちゅうごくしき	中国式
ちゅうごくさん	中国産
ちゅうごくけん	中国拳
ちゅうごくけい	中国系
ちゅうごくぐん	中国軍
ちゅうごくきし	中国棋士
ちゅうごくがわ	中国側
ちゅうこぶひん	中古部品
ちゅうこばんや	中古盤屋
ちゅうこそうば	中古相場
ちゅうこしゃや	中古車屋
ちゅうこかかく	中古価格
ちゅうこうりね	中古売値
ちゅうこうもく	中項目
ちゅうこうびん	昼行便
ちゅうこうねん	中高年
ちゅうこうそく	中高速
ちゅうこうせい	中高生	昼行性	鋳鋼製
ちゅうこういき	中高域
ちゅうけんしゅ	中堅手
ちゅうけいてん	中継点
ちゅうけいじょ	中継所
ちゅうけいしゃ	中継車	中継者
ちゅうけいけん	中継権
ちゅうけいけい	中継系
ちゅうきんとう	中近東
ちゅうきょりば	中距離馬
ちゅうきょうく	中京区
ちゅうきゅうき	中級機
ちゅうきぼうず	中規模渦
ちゅうきじょう	駐機場
ちゅうがっこう	中学校
ちゅうがたしゃ	中型車
ちゅうがたけん	中型犬
ちゅうがたぎょ	中型魚
ちゅうがくせい	中学生
ちゅうかんとう	中間棟
ちゅうかんてん	中間点
ちゅうかんてき	中間的
ちゅうかんだな	中間棚
ちゅうかんたい	昼間帯
ちゅうかんそう	中間層
ちゅうかんしゃ	中間車
ちゅうかんこう	中間項
ちゅうかんけん	中間圏
ちゅうかんおん	中間音
ちゅうかんえき	中間駅
ちゅうかんいち	中間位置
ちゅうかんあた	中間辺
ちゅうかしそう	中華思想
ちゅうかくてき	中核的
ちゅうかいしゃ	仲介者
ちゅうおんいき	中音域
ちゅうおうりん	中央輪
ちゅうおうよせ	中央寄せ
ちゅうおうよこ	中央横
ちゅうおうばし	中央橋
ちゅうおうどお	中央通
ちゅうおうどう	中央道
ちゅうおうだい	中央大
ちゅうおうたい	中央帯
ちゅうおうせん	中央線
ちゅうおうした	中央下
ちゅうおうけん	中央研
ちゅうおうぐん	中央軍
ちゅうおうぐち	中央口
ちゅうおうがわ	中央側
ちゅうおうがた	中央型
ちゅうおうがい	中央街
ちゅうおうかん	中央館
ちゅうおうえき	中央駅
ちゅうおういり	中央入
ちゅういりょく	注意力
ちゅういじこう	注意事項
ちゅういげんじ	注意現示
ちゅういかんき	注意喚起
ちゃやまちかん	茶屋町間
ちゃっかそうち	着火装置
ちゃじしちしき	茶事七式
ちゃくようりつ	着用率
ちゃくようふか	着用不可
ちゃくようしゃ	着用者
ちゃくようぎむ	着用義務
ちゃくだんてん	着弾点
ちゃくだんごさ	着弾誤差
ちゃくせきりつ	着席率
ちゃくせいこん	着生根
ちゃくしんがわ	着信側
ちゃくしんおん	着信音
ちゃくしゅつし	嫡出子
ちゃくがんてん	着眼点
ちゃくかくにん	着確認
ちゃきんしぼり	茶巾絞り
ちゃかっしょく	茶褐色
ちゃいろとそう	茶色塗装
ちゃーたーびん	チャーター便
ちむさーちょい	尖沙咀
ちみもうりょう	魑魅魍魎
ちほうれいかい	地方例会
ちほうりょこう	地方旅行
ちほうぶんけん	地方分権
ちほうどくとく	地方独特
ちほうてつどう	地方鉄道
ちほうつうしん	地方通信
ちほうだんたい	地方団体
ちほうだいがく	地方大学
ちほうたいかい	地方大会
ちほうぜいりつ	地方税率
ちほうせんきょ	地方選挙
ちほうじむしょ	地方事務所
ちほうじちほう	地方自治法
ちほうじちたい	地方自治体
ちほうしんぶん	地方新聞
ちほうざいせい	地方財政
ちほうごうぞく	地方豪族
ちほうくうこう	地方空港
ちほうぎんこう	地方銀行
ちほうかいさい	地方開催
ちほうえんせい	地方遠征
ちへいふみきり	地平踏切
ちひょうじょう	地表上
ちばちゅうおう	千葉中央
ちばきゅうこう	千葉急行
ちのうかつどう	知能活動
ちねつはつでん	地熱発電
ちどりそうこう	千鳥走行
ちどりうんてん	千鳥運転
ちとせふなばし	千歳船橋
ちてきふごうか	知的符号化
ちてきにんしき	知的認識
ちてきせいめい	知的生命
ちてきしんだん	知的診断
ちてきざいさん	知的財産
ちてきさぎょう	知的作業
ちてききょうみ	知的興味
ちてきかつどう	知的活動
ちっそぶんあつ	窒素分圧
ちっそこんごう	窒素混合
ちちぶてつどう	秩父鉄道
ちちおやゆらい	父親由来
ちちおやじしん	父親自身
ちずばんじょう	地図板上
ちずじょうほう	地図情報
ちずきゅうこう	智頭急行
ちじんたくはく	知人宅泊
ちじんかんけい	知人関係
ちじょうぶぶん	地上部分
ちじょうぶたい	地上部隊
ちじょうせつび	地上設備
ちじょうしだん	地上師団
ちじょうしせつ	地上施設
ちじょうくかん	地上区間
ちじょうきょく	地上局
ちしょうりょく	致傷力
ちしまれっとう	千島列島
ちしつねんだい	地質年代
ちしつちょうさ	地質調査
ちしつがくてき	地質学的
ちしきたいけい	知識体系
ちしきこうぞう	知識構造
ちしきこうがく	知識工学
ちこくげんきん	遅刻厳禁
ちくゆうしょう	地区優勝
ちくましょぼう	筑摩書房
ちくほうちほう	筑豊地方
ちくのうしょう	蓄膿症
ちくだいひょう	地区代表
ちくせきそうち	蓄積装置
ちくじれんらく	逐次連絡
ちくじへんかん	逐次変換
ちくじひょうか	逐次評価
ちくじじっこう	逐次実行
ちくじけいさん	逐次計算
ちくしょうどう	畜生道
ちくさんのうか	畜産農家
ちくさんぎょう	畜産業
ちきゅうみさき	地球岬
ちきゅうぶつり	地球物理
ちきゅうどけい	地球時計
ちきゅうたいき	地球大気
ちきゅうじょう	地球上
ちきゅうじしん	地球自身
ちきゅうじかん	地球時間
ちきゅうしみん	地球市民
ちきゅうさいご	地球最後
ちきゅうきこう	地球紀行
ちきゅうかがく	地球科学
ちがいほうけん	治外法権
ちかんもじれつ	置換文字列
ちからせいぶん	力成分
ちからせいぎょ	力制御
ちからかんけい	力関係
ちからいっぱい	力一杯
ちかてつろせん	地下鉄路線
ちかてつないぶ	地下鉄内部
ちかてつこうじ	地下鉄工事
ちかてつくかん	地下鉄区間
ちかしょくどう	地下食堂
ちかくへんどう	地殻変動
ちかくないよう	知覚内容
ちかくしんけい	知覚神経
ちかくしゃくど	知覚尺度
ちかくくうかん	知覚空間
ちかかすいしん	地下化推進
ちえんめいれい	遅延命令
ちえんひょうか	遅延評価
ちえんかきこみ	遅延書きこみ
ちいこうじょう	地位向上
ちいきょうてい	地位協定
ちいきとくゆう	地域特有
ちいきせいしん	地域精神
ちいきせいかつ	地域生活
ちいきしゃかい	地域社会
ちいきげんてい	地域限定
ちいきかいはつ	地域開発
ちあんかつどう	治安活動
ちあんいじほう	治安維持法
たんわくしてい	単枠指定
たんれんちゅう	鍛錬中
たんりょくぼん	丹緑本
たんりょうたい	単量体
たんらくしこう	短絡思考
たんまつそうち	端末装置
たんまつそうさ	端末操作
たんまつせつび	端末設備
たんまつじょう	端末上
たんまつきょく	端末局
たんまつきしつ	端末機室
たんぽぶっけん	担保物権
たんぺんせいか	短編成化
たんぺんしゅう	短篇集	短編集
たんぺいきゅう	短兵急
たんべんかるい	Monopetalae	単弁花類
たんぶんしょう	短文章
たんぴんゆそう	単品輸送
たんぱほうそう	短波放送
たんぱくにょう	蛋白尿
たんはんげんき	短半減期
たんにゅうかん	単乳管
たんどくぼいん	単独母音
たんどくそくい	単独測位
たんどくしゅぎ	単独主義
たんどくしゅい	単独首位
たんどくしめい	単独指名
たんどくこうわ	単独講和
たんどくこうい	単独行為
たんとうぶんや	担当分野
たんとうぶぶん	担当部分
たんとうはんい	担当範囲
たんとうちゅう	担当中
たんとうしょく	担当職
たんとうこうし	担当講師
たんとうかんじ	担当幹事
たんとうかもく	担当科目
たんとうかしょ	担当箇所
たんていちょう	探偵帖
たんていえいが	探偵映画
たんちょうづる	丹頂鶴
たんちょうせい	単調性
たんちょうこう	単調項
たんたいどうさ	単体動作
たんたいかかく	単体価格
たんせんじだい	単線時代
たんせんくかん	単線区間
たんせきしょう	胆石症
たんすちょきん	箪笥貯金
たんすいちゅう	淡水中
たんすいかぶつ	炭水化物
たんじょうねん	誕生年
たんじょうつき	誕生月
たんじょうせき	誕生石
たんじょうけん	端条件
たんじょうかい	誕生会
たんじゅんろん	単純論
たんじゅんみす	単純ミス
たんじゅんぶん	単純文
たんじゅんせん	単純泉
たんじゅんせい	単純性
たんじゅんしじ	単純支持
たんじゅんこう	単純項
たんじゅんかこ	単純過去
たんじゅんおん	単純音
たんじゅみょう	短寿命
たんじゅうしつ	胆汁質
たんじつしょり	短日処理
たんじくぶんし	単軸分枝
たんじくじょう	単軸状
たんじかんまど	短時間窓
たんしんふにん	単身赴任
たんしようるい	単子葉類
たんしょくこう	単色光
たんしょうとう	探照燈
たんしょうてん	単焦点
たんしょうしき	単勝式
たんしゅくりつ	短縮率
たんしゅくばん	短縮版
たんしゅくけい	短縮茎	短縮形
たんしでんあつ	端子電圧
たんしぞくせい	端子属性
たんしせつぞく	端子接続
たんしこしょう	箪食壷漿	箪食瓠漿	箪食壺漿
たんさんでんち	単三電池
たんさくはんい	探索範囲
たんさくけいろ	探索経路
たんさくきのう	探索機能
たんごへんかん	単語変換
たんごはんとう	丹後半島
たんごにんしき	単語認識
たんごとうろく	単語登録
たんごぜんたい	単語全体
たんごおんせい	単語音声
たんこうぼんか	単行本化
たんけんちゅう	探検中
たんけっしょう	単結晶
たんくかんまど	短区間窓
たんきれんさい	短期連載
たんきゅうしん	探究心
たんきゅうしゃ	探求者	探究者
たんきだいがく	短期大学
たんきたいざい	短期滞在
たんきせいけん	短期政権
たんきこうげき	単機攻撃
たんきけっせん	短期決戦
たんがんしほう	単眼視法
たんがんきょう	単眼鏡
たんかんきょう	単環境
たんかだいがく	単科大学
たんいめんせき	単位面積
たんいはんぐん	単位半群
たんいにんてい	単位認定
たんいちでんち	単一電池
たんいたいせき	単位体積
たんいじかんあ	単位時間当
たんいしゃぞう	単位写像
たんいえんばん	単位円板
たんいえんない	単位円内
たりゅうじあい	他流試合
たりきほんがん	他力本願
たもくてきしつ	多目的室
たまりじょうゆ	溜まり醤油
たまつくりぐん	玉造郡
たまたいしょう	玉大賞
たまごりょうり	卵料理
たまがわさきこ	玉川紗己子
たぶろいどばん	タブロイド判
たびこうぎょう	旅興行
たねつけりょう	種付料
たぬまおきつぐ	田沼意次
たぬきおしょう	狸和尚
たにんずうよう	多人数用
たにんぎょうぎ	他人行儀
たにゅうりょく	多入力
たにむらしんじ	谷村新司
たなべせいやく	田辺製薬
たなばたまつり	七夕祭り	七夕祭
たなばたしょう	七夕賞
たなかかくえい	田中角栄
たとうはっこう	多灯発光
たてんせいぎょ	多点制御
たてものないぶ	建物内部
たてものじたい	建物自体
たてまえじょう	建前上
たてながようし	縦長用紙
たてなががめん	縦長画面
たてじょうよう	楯状葉
たていしでんき	立石電機
たつのくちまち	辰口町
たっせいかのう	達成可能
たっけんぎょう	宅建業
たっきゅうびん	宅急便
たっきゅうだい	卓球台
たちしょうべん	立ち小便
たちかわぶんこ	立川文庫
たちかわじょし	立川女子
たちおうじょう	立ち往生	立往生
たちいりけんさ	立入検査
たちいりきんし	立入禁止
たちいふるまい	立居振舞
たちあいていし	立会停止
たちあいじょう	立会場
ただんちょうり	多段調理
たたみはんぶん	畳半分
たたいもんだい	多体問題
たそうひょうひ	多層表皮
たそうこうぞう	多層構造
たすうらんりつ	多数乱立
たすうみんぞく	多数民族
たすうはっせい	多数発生
たすうとうろく	多数登録
たすうそんざい	多数存在
たすうごおうぼ	多数御応募
たすううんてん	多数運転
たじんかくしゃ	多人格者
たじょうたこん	多情多恨
たじゅうろこう	多重露光
たじゅうていぎ	多重定義
たじゅうたんし	多重端子
たじゅうしょり	多重処理
たじゅうしてん	多重視点
たじゅうさいむ	多重債務
たじゅうがぞう	多重画像
たしろいりぐち	田代入口
たしょうふべん	多少不便
たしょうふあん	多少不安
たしゅつりょく	多出力
たしゅせんゆう	他主占有
たしゃせいひん	他社製品
たさいぼうもう	多細胞毛
たこくせきぐん	多国籍軍
たこくごしよう	多国語使用
たこうせんこう	多孔穿孔	多孔せん孔
たこうしつざい	多孔質材
たこうかんれん	多項関連
たけひさゆめじ	竹久夢二
たけだしんげん	武田信玄
たけしたのぼる	竹下登
たけしたけいこ	竹下景子
たけおおんせん	武雄温泉
たけうちがいし	竹内外史
たくらくしつろ	拓落失路
たくはいきぼう	宅配希望
たくちぞうせい	宅地造成
たくじょうがた	卓上型
たくじしょけん	託児所券
たくしょくだい	拓殖大
たきれんたろう	滝廉太郎
たきゅうじょう	他球場
たきのうでんわ	多機能電話
たきざわばきん	滝沢馬琴
たがわすいほう	田河水泡
たからづかせん	宝塚線
たからしゅぞう	寳酒造	宝酒造
たかやままつり	高山祭
たかやまちょう	高山町
たかみねひでこ	高峰秀子
たかまどのみや	高円宮
たかまつのみや	高松宮
たかまつじょう	高松城
たかまつしょう	高松商
たかまつしない	高松市内
たかはまきょし	高浜虚子
たかはなだぜき	貴花田関
たかはたふどう	高畑不動	高幡不動
たかはしまりこ	高橋真梨子
たかはしけいこ	高橋恵子
たかつきしみん	高槻市民
たかつきいとう	高槻以東
たかちほのみね	高千穂峰
たかちほきょう	高千穂峡	高千穂峽
たかだかかさん	高々可算
たかしまちょう	高島町
たかしまだいら	高島平
たかさごしゃこ	高砂車庫
たかさきせいし	高崎製紙
たかくすいだい	多角錐台
たかくけいえい	多角経営
たかぎあきみつ	高木彬光
たかおさんぐち	高尾山口
たかおかちょう	高岡町
たいわほうしき	対話方式
たいわけいしき	対話形式
たいりょくへき	耐力壁
たいりょくてき	体力的
たいりょうてん	大量点
たいりゅうけん	対流圏
たいりつこうほ	対立候補
たいりついけん	対立意見
たいりくぶんか	大陸文化
たいりくなんぶ	大陸南部
たいりくちたい	大陸地帯
たいようとしょ	大洋図書
たいようでんち	太陽電池
たいようせきゆ	太陽石油
たいようしゅう	大洋州
たいようさんそ	太陽酸素
たいようこうべ	太陽神戸
たいようこうか	太陽光下
たいやくしゅう	対訳集
たいめいがっき	体鳴楽器
たいまもうせい	耐磨耗性
たいべいしよう	対米仕様
たいへんべんり	大変便利
たいへんきけん	大変危険
たいふういっか	台風一過
たいひょうめん	体表面
たいひこうぞう	退避構造
たいばついがい	体罰以外
たいねつしょり	耐熱処理
たいねつがらす	耐熱ガラス
たいないどけい	体内時計
たいとうきょう	対東京
たいちょうたち	隊長達
たいちょうかく	対頂角
たいちゅうごく	対中国
たいちこうげき	対地攻撃
たいだんしゅう	対談集
たいせんまっき	大戦末期
たいせんひょう	対戦表
たいせんちゅう	大戦中	対戦中
たいせんしょき	対戦初期
たいせんけっか	対戦結果
たいせんあいて	対戦相手
たいせきりょく	体積力
たいせきようそ	体積要素
たいせきそくど	体積速度
たいせきかのう	堆積可能
たいせいぶせん	対西武戦
たいせいひはん	体制批判
たいせいどうろ	大成道路
たいせいしっこ	大声疾呼
たいすうめもり	対数目盛
たいすうひょう	対数表
たいじんじらい	対人地雷
たいじょうしゃ	退場者
たいじょうかい	帯状回
たいじゅうけい	体重計
たいしょどうさ	対処動作
たいしょくせい	耐蝕性	耐食性
たいしょくしゃ	退職者
たいしょくきん	退職金
たいしょくかん	大食漢
たいしょかのう	対処可能
たいしょうりつ	対称律
たいしょうめん	対称面
たいしょうめい	対象名
たいしょうぶつ	対象物
たいしょうてき	対称的	対象的	対照的
たいしょうそう	対象層
たいしょうせい	対称性
たいしょうじく	対称軸
たいしょうしゃ	対象者	対象車
たいしょうごと	大正琴
たいしょうこく	対象国
たいしょうこう	対象項
たいしょうげき	耐衝撃
たいしょうけい	対称形
たいしょうぐん	対称群	対照群
たいしょうがた	対称型
たいしょうがい	対象外
たいしょういけ	大正池
たいしゅつれい	退出例
たいしゅつしゃ	退出者
たいしゅうやく	大衆薬
たいしゅうてき	大衆的
たいしゅうせい	大衆性
たいしゅうぎょ	大衆魚
たいしゅうかん	大修館
たいしゃりょう	代謝量
たいしゃくてん	帝釈天
たいしぼうりつ	体脂肪率
たいしぼうけい	体脂肪計
たいざんほくと	泰山北斗
たいざいちゅう	滞在中
たいざいじかん	滞在時間
たいざいきょか	滞在許可
たいざいきかん	滞在期間
たいざいかのう	滞在可能
たいさくほんぶ	対策本部
たいさくぶひん	対策部品
たいさくそうち	対策装置
たいこうりょく	対抗力
たいこうじょう	対抗上
たいこうじあい	対抗試合
たいこうしょく	退紅色
たいこうくうき	対航空機
たいこういしき	対抗意識
たいげんそうご	大言壮語
たいけんじょう	体験上
たいけんきおく	体験記憶
たいけつじょう	対決場
たいくつおとこ	退屈男
たいくうりょく	対空力
たいくうへいき	対空兵器
たいくうじかん	滞空時間
たいぎゃくざい	大逆罪
たいぎめいぶん	大義名分
たいきりゅうし	大気粒子
たいきょくてき	対極的	大極的	大局的
たいきょくすう	対局数
たいきょくしゃ	対局者
たいきょくけん	大極拳	太極拳
たいきょくかん	大局観
たいきょくかた	対局過多
たいきょうよう	胎教用
たいきょうさん	対共産
たいきゅうせい	耐久性
たいきばんせい	大器晩成
たいきけんない	大気圏内
たいがくしょち	退学処置
たいがいじあい	対外試合
たいかんちあん	体感治安
たいかんそくど	体感速度
たいかんじかん	体感時間
たいかんしよう	耐寒仕様
たいかんこうぎ	退官講義
たいかんきねん	退官記念
たいかんおんど	体感温度
たいかこうろう	大廈高楼
たいかくようそ	対角要素
たいかいほんぶ	大会本部
たいかいっそう	滞貨一掃
たいかいさんか	大会参加
たいかいかんじ	大会幹事
たいおせんせい	耐汚染性
たいおうよてい	対応予定
たいおうぶひん	対応部品
たいおうひょう	対応表
たいおうきそく	対応規則
たいおうきしゅ	対応機種
たいおうかのう	対応可能
たいいほうてき	対位法的
たいいくじつぎ	体育実技
たいいくきょく	体育局
たいいきつうか	帯域通過
たいいきしょり	帯域処理
たいあつしけん	耐圧試験
たいあつけんさ	耐圧検査
とんなんしゃぺい	東南西北
とんとんびょうし	とんとん拍子
とんしょうぼだい	頓証菩提
とりひきほうほう	取引方法
とりひきないよう	取引内容
とりひきだかぜい	取引高税
とりつだいぶつり	都立大物理
とりつけほうほう	取付方法
とりつぎがいしゃ	取次会社
とりけししょぶん	取消処分
とりあつかいもと	取扱元
とりあつかいてん	取扱店
とりあつかいじょ	取扱所
とりあつかいしゃ	取扱者	取扱車
とりあつかいかた	取り扱い方
とよまえかわさき	豊前川崎
とよはしほうめん	豊橋方面
とよはしけいとう	豊橋系統
とよはしぎかだい	豊橋技科大
とよとみひでより	豊臣秀頼
とよとみひでよし	豊臣秀吉
とよだつうしょう	豊田通商
とよたちゅうけん	豊田中研
とよたじどうしゃ	トヨタ自動車
とやまじゅうたく	戸山住宅
ともだちわりびき	友達割引
とむらいがっせん	弔い合戦
とみしろこうこう	豊見城高校
とみおかこうこう	富岡高校
とばくざいいはん	賭博罪違反
とばくさんぎょう	賭博産業
とどうふけんめい	都道府県名
とどうふけんちじ	都道府県知事
とどうふけんごと	都道府県毎
とつぜんいんたい	突然引退
とつがたしゃたい	凸型車体
とっぱんいんさつ	凸版印刷
とっぱつはっしん	突発発疹
とっとりだいがく	鳥取大学
とっとりさきゅう	鳥取砂丘
とっきょもんだい	特許問題
とっきょないよう	特許内容
とっきょちょうさ	特許調査
とっきょじむしょ	特許事務所
とっきょしんせい	特許申請
とっきょしんがい	特許侵害
とっきょしりょう	特許資料
とっきょこうほう	特許公報
とっきょかんけい	特許関係
とっきゅうたいひ	特急退避
とっきゅうしょく	特急色
とっきゅういがい	特急以外
とちゅうていしゃ	途中停車
とちゅうだんかい	途中段階
とちゅうこうたい	途中交代
とちひょうかしょ	土地評価書
とちしょゆうけん	土地所有権
とちしょとくほう	土地所得法
とちかいりょうく	土地改良区
としんじょうくう	都心上空
としょしゅっぱん	図書出版
としょしついがい	図書室以外
としごいのまつり	祈年祭
としこうぼうせん	都市攻防戦
としこうつうけん	都市交通研
としかんれんらく	都市間連絡
としかんてつどう	都市間鉄道
とざんきょうそう	登山競争
とざまだいみょう	外様大名
とこうじょうほう	渡航情報
とくゆうざいさん	特有財産
とくやまこうせん	徳山高専
とくめいほうしき	匿名方式
とくめいとうしょ	匿名投書
とくめいとうこう	匿名投稿
とくめいくみあい	匿名組合
とくむそうちょう	特務曹長
とくべつわりびき	特別割引
とくべつれいかい	特別例会
とくべつりょうり	特別料理
とくべつばんぐみ	特別番組
とくべつはいとう	特別配当
とくべつたいぐう	特別待遇
とくべつそんしつ	特別損失
とくべつそちほう	特別措置法
とくべつせんばつ	特別選抜
とくべつせんしつ	特別船室
とくべつせつびひ	特別設備費
とくべつこんなん	特別困難
とくべつこっかい	特別国会
とくべつこうこく	特別抗告
とくべつこうえん	特別講演
とくべつきゅうか	特別休暇
とくべつかいそく	特別快速
とくべつかいけい	特別会計
とくべつかいいん	特別会員
とくべつうんちん	特別運賃
とくべつあつかい	特別扱い
とくひつたいしょ	特筆大書
とくばいびかかく	特売日価格
とくてんりょこう	特典旅行
とくてんほうほう	得点方法
とくてんはいぶん	得点配分
とくてんけいさん	得点計算
とくていせんしゅ	特定選手
とくていじんぶつ	特定人物
とくていざいさん	特定財産
とくていざいげん	特定財源
とくていかいせん	特定回線
とくていうんちん	特定運賃
とくちょうりょう	特徴量
とくだしゅうせい	徳田秋声
とくそくてつづき	督促手続
とくしゅもくてき	特殊目的
とくしゅほうじん	特殊法人
とくしゅへんすう	特殊変数
とくしゅはいれつ	特殊配列
とくしゅじじょう	特殊事情
とくしゅさつえい	特殊撮影
とくしゅさいのう	特殊才能
とくしゅさいせい	特殊再生
とくしゅこうげき	特殊攻撃
とくしゅけいしき	特殊形式
とくしゅくうかん	特殊空間
とくしゅがっこう	特殊学校
とくしゅかんすう	特殊関数
とくしゅうちゅう	特集中
とくしまだいがく	徳島大学
とくしまくうこう	徳島空港
とくさつぎじゅつ	特撮技術
とくがわよしのぶ	徳川慶喜
とくがわいえやす	徳川家康
とくいちぶんかい	特異値分解
とくいげんしょう	特異現象
とおのものがたり	遠野物語
とうろんばんぐみ	討論番組
とうろんないよう	討論内容
とうろんけいしき	討論形式
とうろくほうほう	登録方法
とうろくへんこう	登録変更
とうろくばんごう	登録番号
とうろくないよう	登録内容
とうろくてつづき	登録手続
とうろくせんしゅ	登録選手
とうろくしんせい	登録申請
とうろくしゃめい	登録者名
とうろくしゃすう	登録者数
とうろくさぎょう	登録作業
とうろくけんすう	登録件数
とうろくぎむしゃ	登録義務者
とうろくかくにん	登録確認
とうろくかいじょ	登録解除
とうろくおんせい	登録音声
とうろくうけつけ	登録受付
とうろくいしょう	登録意匠
とうりとうりゃく	党利党略
とうらいほうこう	到来方向
とうよこがくえん	東横学園
とうようぼうせき	東洋紡績
とうようてつがく	東洋哲学
とうようだいがく	東洋大学
とうようせいとう	東洋精糖
とうようせいかん	東洋製罐
とうようすいさん	東洋水産
とうようこうはん	東洋鋼板
とうようこうそく	東葉高速
とうようけいざい	東洋経済
とうめいよこはま	東名横浜
とうめいにんげん	透明人間
とうめいしずおか	東名静岡
とうめいごてんば	東名御殿場
とうめいこうそく	東名高速
とうめいかわさき	東名川崎
とうほんせいそう	東奔西走
とうほくりょこう	東北旅行
とうほくほんせん	東北本線
とうほくほうめん	東北方面
とうほくほうそう	東北放送
とうほくほうげん	東北方言
とうほくひりょう	東北肥料
とうほくだいせい	東北大生
とうほくだいこう	東北大工
とうほくだいがく	東北大学	東北大學
とうほくたいかい	東北大会
とうほくしんしゃ	東北新社
とうほくけいとう	東北系統
とうほくぐんばつ	東北軍閥
とうほくがくいん	東北学院
とうほくかんない	東北管内
とうほうれーよん	東邦レーヨン
とうほうだいがく	東邦大学
とうほうせいめい	東邦生命
とうほうせいざい	等方性材
とうほうじじょう	当方事情
とうほうしんれき	東方新暦
とうほうさんらん	等方散乱
とうほうぎんこう	東邦銀行
とうほうがくえん	桐朋学園
とうほうおんだい	東邦音大	桐朋音大
とうへんついほう	陶片追放
とうぶんあんたい	当分安泰
とうぶなつじかん	東部夏時間
とうぶとっきゅう	東武特急
とうぶそうちゃく	頭部装着
とうひょうりゆう	投票理由
とうひょうようし	投票用紙
とうひょうむこう	投票無効
とうひょうぶぶん	投票部分
とうひょうてつづ	投票手続
とうひょうちゅう	投票中
とうひょうせいど	投票制度
とうひょうじょう	投票場
とうひょうじてん	投票時点
とうひょうじっし	投票実施
とうひょうしかく	投票資格
とうひょうけっか	投票結果
とうひょうきょひ	投票拒否
とうひょうきそく	投票規則
とうひょうきかん	投票期間
とうひょうかんり	投票管理
とうひょうかいし	投票開始
とうひきゅうすう	等比級数
とうはんしゃせん	登坂車線
とうにょうびょう	糖尿病
とうにゅうりょう	投入量
とうにゅうひりつ	投入比率
とうなんほしょう	盗難補償
とうなんたいさく	盗難対策
とうないだいぎし	党内代議士
とうていふかのう	到底不可能
とうちょうぼうし	盗聴防止
とうちょうじけん	盗聴事件
とうちゅうかそう	冬虫夏草
とうちゃくじゅん	到着順
とうちゃくじこく	到着時刻
とうちゃくじかん	到着時間
とうちゃくしだい	到着次第
とうちゃくきゃく	到着客
とうちぎょうれつ	倒置行列
とうだいりがくぶ	東大理学部
とうだいほんごう	東大本郷
とうだいほうめん	東大方面
とうだいだいけい	東大大型
とうだいぜんたい	東大全体
とうだいせんぱく	東大船舶
とうだいせいみつ	東大精密
とうだいせいさん	東大生産
とうだいせいけん	東大生研
とうだいすうがく	東大数学
とうだいじんぶん	東大人文
とうだいじょうか	東大情科
とうだいしゅさい	東大主催
とうだいけいすう	東大計数
とうだいけいざい	東大経済
とうだいぐさもく	Euphorbiales	トウダイグサ目
とうだいきんぞく	東大金属
とうだいがくない	東大学内
とうだいかいぼう	東大解剖
とうだいいがくぶ	東大医学部
とうだいいかけん	東大医科研
とうたつふかのう	到達不可能
とうたつじかんさ	到達時間差
とうたつけんかい	到達見解
とうぞくかぎょう	盗賊家業
とうそくうんどう	等速運動
とうそうほうほう	逃走方法	闘争方法
とうぜんそんざい	当然存在
とうせんばんごう	当選番号
とうせんけってい	当選決定
とうせんかくりつ	当選確立	当選確率
とうせんかくじつ	当選確実
とうせんかいすう	当選回数
とうせきかんじゃ	透析患者
とうせいはいしゅ	倒生胚珠
とうせいけいざい	統制経済
とうせいがくえん	東星学園
とうじょたいだい	東女体大
とうじょうよてい	登場予定
とうじょうひでき	東条英機
とうじょうばめん	登場場面
とうじょうとうじ	登場当時
とうじょうきょり	搭乗距離
とうじょうきゃく	搭乗客
とうじょうかじょ	頭状花序
とうじょういらい	登場以来
とうじょういぜん	登場以前
とうじつはっこう	当日発行
とうじつじゅんび	当日準備
とうじつうけつけ	当日受付
とうじしゃしゅぎ	当事者主義
とうじしゃいしき	当事者意識
とうしんてつどう	東清鉄道
とうしょけいかく	当初計画
とうしょうだいじ	唐招提寺
とうしょういちぶ	東証一部
とうしゅせいめい	投手生命
とうしゃせいひん	当社製品
とうしばふちゅう	東芝府中
とうしばちゅうぶ	東芝中部
とうしばそうけん	東芝総研
とうしばえいぞう	東芝映像
とうしじょうほう	投資情報
とうざいほうこう	東西方向
とうざいなんぼく	東西南北
とうざいとういつ	東西統一
とうざいたいけつ	東西対決
とうざいせんない	東西線内
とうざいこくない	東西国内
とうさきゅうすう	等差級数
とうごはんちゅう	統語範疇
とうごうていあん	統合提案
とうごうぎじゅつ	統合技術
とうごうかんけい	等号関係
とうこうろんぶん	投稿論文
とうこうほうほう	投稿方法
とうこうほうしき	投稿方式
とうこうないよう	投稿内容
とうこうてじゅん	投稿手順
とうこうちょうさ	投稿調査
とうこうだいこう	東工大高
とうこうそうすう	投稿総数
とうこうせんぱく	東工船舶
とうこうせきにん	投稿責任
とうこうせいげん	投稿制限
とうこうじゅんび	投稿準備
とうこうじっせき	投稿実績
とうこうしゃめい	投稿者名
とうこうしゃべつ	投稿者別
とうこうしゃすう	投稿者数
とうこうしゃしん	投稿写真
とうこうしめきり	投稿締切
とうこうしつもん	投稿質問
とうこうさくひん	投稿作品
とうこうげんこう	投稿原稿
とうこうけいけん	投稿経験
とうこうぎゃくし	倒行逆施
とうこうきじすう	投稿記事数
とうこうかいすう	投稿回数
とうげこうちゅう	登下校中
とうけいりきがく	統計力学
とうけいぶんせき	統計分析
とうけいちょうさ	統計調査
とうけいすうがく	統計数学
とうけいしりょう	統計資料
とうけいしゅほう	統計手法
とうけいけいさん	統計計算
とうけいがくてき	統計学的
とうけいかいせき	統計解析
とうけいえんざん	統計演算
とうきょうりゅう	東京流
とうきょうめいか	東京銘菓
とうきょうみやげ	東京土産
とうきょうぶんか	東京文化
とうきょうはるみ	東京晴海
とうきょうとりつ	東京都立
とうきょうとみん	東京都民
とうきょうとない	東京都内
とうきょうとしょ	東京図書
とうきょうとくぶ	東京都区部
とうきょうでんき	東京電気
とうきょうちほう	東京地方
とうきょうすがお	東京菅生
とうきょうじょし	東京女子
とうきょうししゃ	東京支社
とうきょうこうか	東京工科
とうきょうけいき	東京計器
とうきょうくらぶ	東京倶楽部
とうきょうきんむ	東京勤務
とうきょうかせい	東京化成
とうきょうおんど	東京音頭
とうきょううえの	東京上野
とうきょういがい	東京以外
とうきゅうほてる	東急ホテル
とうきゅうはんず	東急ハンズ
とうきゅうどうさ	投球動作
とうきぼとうほん	登記簿謄本
とうがいだんたい	当該団体
とうがいじつえん	当該実演
とうがいきょだく	当該許諾
とうがいかくごう	当該各号
とうかつぶちょう	統括部長
とうかじょうたい	等価状態
とうかくしゃぞう	等角写像
とうかかくそくど	等価角速度
とうかいほうめん	東海方面
とうかいどうせん	東海道線
とうかいどうぐち	東海道口
とうかいどういち	東海道一
とうかいだいよん	東海大四
とうかいだいがく	東海大学
とうかいこうえい	東海公営
とうかいぎんこう	東海銀行
とうかいがくせい	東海学生
とうかいかんこう	東海観光
とうかいかーぼん	東海カーボン
とうおうしょこく	東欧諸国
とうえいほうこう	投影方向
とうえいないよう	投影内容
とうえいぎじゅつ	投影技術
とういんがくえん	桐蔭学園
とういつほうしき	統一方式
とういつひょうき	統一表記
とういつばりろん	統一場理論
とういつせんせん	統一戦線
とういつこうどう	統一行動
とういつけんかい	統一見解
とういつおうじゃ	統一王者
とういそくみょう	当意即妙
とうあぼうしょく	東亜紡織
といれきゅうけい	トイレ休憩
てんりゅうきょう	天龍峡
てんゆうしんじょ	天佑神助
てんやくへんかん	点訳変換
てんもんねんかん	天文年鑑
てんもんしゃしん	天文写真
てんもんげっぽう	天文月報
てんもんけいさん	天文計算
てんもんがっかい	天文学会
てんもんがくてき	天文学的
てんもんがくしゃ	天文学者
てんもんかんけい	天文関係
てんもくぢゃわん	天目茶碗
てんもうかいかい	天網恢恢
てんぴょうぶんか	天平文化
てんばつてきめん	天罰覿面
てんばいかいもど	転売買戻
てんのうほうどう	天皇報道
てんのうほうぎょ	天皇崩御
てんのうそくいご	天皇即位後
てんのうせいろん	天皇制論
てんのうしょうば	天皇賞馬
てんのうしゅけん	天皇主権
てんのうこうごう	天皇皇后
てんねんひりょう	天然肥料
てんねんせっけん	天然石鹸
てんねんかじゅう	天然果汁
てんにゅうとどけ	転入届
てんないほうそう	店内放送
てんないせんよう	店内専用
てんどうこうげん	天童高原
てんとうはんばい	店頭販売
てんとうしじょう	店頭市場
てんとうこうかい	店頭公開
てんてんはんそく	輾転反側
てんちりょうよう	転地療養
てんちぎょうれつ	転置行列
てんちぎゃくてん	天地逆転
てんちかいびゃく	天地開闢
てんたいぶつりや	天体物理屋
てんたいしゃしん	天体写真
てんたいかんそく	天体観測
てんそんこうりん	天孫降臨
てんそうほうほう	転送方法
てんそうとちゅう	転送途中
てんそうせいのう	転送性能
てんそうじっけん	転送実験
てんそうこうりつ	転送効率
てんすうはいぶん	点数配分
てんすうけいさん	点数計算
てんじんいわたや	天神岩田屋
てんじょうてんげ	天上天下
てんじょうてんか	天上天下
てんじょうさじき	天井桟敷
てんじぶんしょう	点字文章
てんじひょうじぶ	点字表示部
てんじとしょかん	点字図書館
てんじかいじょう	展示会場
てんしんらんまん	天真爛漫
てんしんあまぐり	天津甘栗
てんさいはながた	天才花形
てんさいせいとう	甜菜製糖
てんこうふじゅん	天候不順
てんこうしょにち	転校初日
てんけんこうもく	点検項目
てんくうかいかつ	天空海闊
てんがじゃやかん	天下茶屋間
てんがいまきょう	天外魔境
てんかんしゃさい	転換社債
てんかんかぶしき	転換株式
てんかいどうよう	展開同様
てんかいしゅほう	展開手法
てんかいこうげき	展開攻撃
てんかいけいすう	展開係数
てんかいかんすう	展開関数
てれびとうきょう	テレビ東京
てれびちゅうけい	テレビ中継
てらやましゅうじ	寺山修司
てらおかせいこう	寺岡精工
てつぶんほきゅう	鉄分補給
てつどうりょこう	鉄道旅行
てつどうようらん	鉄道要覧
てつどうゆうびん	鉄道郵便
てつどうふっけん	鉄道復建
てつどうだいこう	鉄道代行
てつどうたんてい	鉄道探偵
てつどうそうけん	鉄道総研
てつどうじじょう	鉄道事情
てつどうじぎょう	鉄道事業
てつどうしょうか	鉄道唱歌
てつどうしゃしん	鉄道写真
てつどうこうがく	鉄道工学
てつどうこうあん	鉄道公安
てつどうけいえい	鉄道経営
てつどうぎじゅつ	鉄道技術
てつどうきねんび	鉄道記念日
てつどうがいしゃ	鉄道会社
てつどうかんれん	鉄道関連
てつどうかんけい	鉄道関係
てつどういっぱん	鉄道一般
てつがくろんそう	哲学論争
てつがくしゃたち	哲学者達
てっていついせき	徹底追跡
てっていこうせん	徹底抗戦
てっていこうかい	徹底公開
てっていぎろんは	徹底議論派
てっていかいめい	徹底解明
てっていかいぞう	徹底改造
てっていかいせき	徹底解析
てっこつこうぞう	鉄骨構造
てっけんせいさい	鉄拳制裁
てすとしようしょ	テスト仕様書
てきようへんこう	適用変更
てきようふかのう	適用不可能
てきようじょがい	適用除外
てきようげんかい	適用限界
てきようぎょうむ	適用業務
てきたいこうどう	敵対行動
てきたいかんけい	敵対関係
てきぜんとうぼう	敵前逃亡
てきせいろしゅつ	適性露出	適正露出
てきせいてつづき	適正手続
てきせいしんだん	適性診断
てきじょうしさつ	敵状視察
てきしょてきざい	適所適材
てきしゃせいぞん	適者生存
てきざいてきしょ	適材適所
てきごうにんてい	適合認定
てきごうかんすう	適合関数
てききどうへいき	敵機動兵器
てききしゅうらい	敵機襲来
てきおうほうさん	適応放散
てきおうぶんかつ	適応分割
てきおうせいぎょ	適応制御
ていりゅうじょう	停留場
ていりゅうじかん	停留時間
ていりしょうめい	定理証明
ていぶんかいのう	低分解能
ていねんれいそう	低年齢層
ていねんたいかん	定年退官
ていとものがたり	帝都物語
ていでんあつひん	低電圧品
ていでんあつげん	定電圧源
ていてんかんそく	定点観測
ていちゃくじかん	定着時間
ていたいぜんせん	停滞前線
ていそくたんまつ	低速端末
ていそくそうこう	定速走行
ていそくかいてん	定速回転	低速回転
ていそくかいせん	低速回線
ていせんこうさく	停戦工作
ていせんきょうぎ	停戦協議
ていせいほうほう	訂正方法
ていせいぶんせき	定性分析
ていせいとうこう	訂正投稿
ていせいすいろん	定性推論
ていせいがくえん	貞静学園
ていすうけいすう	定数係数
ていすうけいさん	定数計算
ていじょうぶんぷ	定常分布
ていじゅうしんか	低重心化
ていじじょうけん	提示条件
ていじじゅんじょ	提示順序
ていしょとくそう	低所得層
ていしょとくしゃ	低所得者
ていしょうちゅう	提唱中
ていしゅつようし	提出用紙
ていしゅつきげん	提出期限
ていしゅかんぱく	亭主関白
ていしゅうはすう	低周波数
ていしゅうにゅう	定収入
ていしゃれっしゃ	停車列車
ていしゃでんしゃ	停車電車
ていしゃかんかく	停車間隔
ていしゃかいすう	停車回数
ていしぼうにゅう	低脂肪乳
ていしのうりょく	停止能力
ていしちょくぜん	停止直前
ていしじょうたい	停止状態
ていしじょうけん	停止条件
ていしげんしょう	停止現象
ていさつよういん	偵察要員
ていさつえいせい	偵察衛星
ていこくりくぐん	帝國陸軍
ていこくけんぽう	帝国憲法
ていこくぎんこう	帝國銀行
ていこくかいぐん	帝國海軍
ていこうていてい	低高低低
ていこうせいぶん	抵抗成分
ていこうせいぎょ	抵抗制御
ていこうがいしゃ	低公害車
ていこううんどう	抵抗運動
ていげんめいほう	定言命法
ていけいふうとう	定型封筒
ていきんりじだい	低金利時代
ていきょうちゅう	提供中
ていきょうきょく	提供曲
ていきょうかのう	提供可能
ていきとっきゅう	定期特急
ていきてんけんぼ	定期点検簿
ていきつえんしゃ	定喫煙者
ていきけんくかん	定期券区間
ていきけんうりば	定期券売場
ていがくこがわせ	定額小為替
ていかくでんあつ	定格電圧
ていかかくろせん	低価格路線
ていかいはつこく	低開発国
ていかいてんがた	低回転型
ていかいてんいき	低回転域
ていおんどうぶつ	定温動物
ていおんさっきん	低温殺菌
ていおうせっかい	帝王切開
ていいんいっぱい	定員一杯
ていいのうりょく	定位能力
ていあんほうほう	提案方法
ていあんないよう	提案内容
てあしくちびょう	手足口病
つるまきおんせん	鶴巻温泉
つるまいこうえん	鶴舞公園
つるかわこうこう	鶴川高校
つりがけでんしゃ	釣掛電車
つりかんけいしゃ	釣関係者
つめしょうぎかい	詰将棋界
つみたてほうしき	積立方式
つなみじょうほう	津波情報
つちとりもちもく	Balanophorales	ツチトリモチ目
つちうらにちだい	土浦日大
つしまかいきょう	対馬海峡
つくばだいりこう	筑波大理工
つくばだいでんし	筑波大電子
つくばだいかがく	筑波大化学
つくばじょうほう	筑波情報
つくばこうじょう	筑波工場
つくばけんきゅう	筑波研究
つくばかがくはく	筑波科学博
つくばいいんかい	筑波委員会
つくしのうたかい	筑紫歌会
つきそいかんごひ	付添看護費
つがるじゃみせん	津軽三味線
つがるかいきょう	津軽海峡
つがいけこうげん	栂池高原
つかもとしょうじ	塚本商事
つうわりょうきん	通話料金
つうわじょうたい	通話状態
つうどうこうぞう	通導構造
つうちょうていき	通帳定期
つうぞくどうとく	通俗道徳
つうそうていおん	通奏低音
つうじょうほこう	通常歩行
つうじょうへいき	通常兵器
つうじょうたいほ	通常逮捕
つうじょうしよう	通常使用
つうじょうげんご	通常言語
つうじょうがめん	通常画面
つうじょうかやく	通常火薬
つうじょうかかく	通常価格
つうしんもくてき	通信目的
つうしんほうほう	通信方法
つうしんほうしき	通信方式
つうしんばいたい	通信媒体
つうしんはんばい	通信販売
つうしんはくしょ	通信白書
つうしんないよう	通信内容
つうしんてじゅん	通信手順
つうしんたんまつ	通信端末
つうしんそうけん	通信総研
つうしんせんよう	通信専用
つうしんせいのう	通信性能
つうしんじじょう	通信事情
つうしんしんごう	通信信号
つうしんしゅだん	通信手段
つうしんこうがく	通信工学
つうしんこうかん	通信交換
つうしんぎじゅつ	通信技術
つうしんがっかい	通信学会
つうしんがいしゃ	通信会社
つうしんかんけい	通信関係
つうしんかくしゃ	通信各社
つうしんかいせん	通信回線
つうしんえいせい	通信衛星
つうしょうかいぎ	通商会議
つうさんとくてん	通算得点
つうさんせいせき	通算成績
つうこくしょぶん	通告処分
つうけんこうかい	通研公開
つうきんれっしゃ	通勤列車
つうきんらっしゅ	通勤ラッシュ
つうきんひほじょ	通勤費補助
つうきんとっかい	通勤特快
つうきんとちゅう	通勤途中
つうきんでんしゃ	通勤電車
つうきんてつどう	通勤鉄道
つうきんつうがく	通勤通学
つうきんじゅよう	通勤需要
つうきんじじょう	通勤事情
つうきんかいとく	通勤快特
つうきんかいそく	通勤快速
つうかじどうしゃ	通過自動車
つうかきんしえき	通過禁止駅
ついほうかいじょ	追放解除
ついとうばんぐみ	追悼番組
ついちょうかぜい	追徴課税
ついせきほうほう	追跡方法
ついせきほうどう	追跡報道
ついせきちょうさ	追跡調査
ついせきしゅざい	追跡取材
ついしけんしょう	追試検証
ついきゅうしせい	追求姿勢
ついかりょうきん	追加料金
ついかはっぴょう	追加発表
ついかはっちゅう	追加発注
ついかちゅうもん	追加注文
ついかじょうほう	追加情報
ついかしゅちょう	追加主張
ついかこうにゅう	追加購入
ついかがくしゅう	追加学習
ちんぷんかんぷん	珍紛漢紛
ちんしゃくりょう	賃借料
ちんこうちくせき	沈降蓄積
ちんぎんたいけい	賃金体系
ちんぎょらくがん	沈魚落雁
ちりょうほうほう	治療方法
ちりてきはいけい	地理的背景
ちょとつもうしん	猪突猛進
ちょっこうけいろ	直行経路
ちょっこうきんじ	直交近似
ちょっこうきてい	直交基底
ちょっけいぶぶん	直径部分
ちょっけいひぞく	直系卑属
ちょっけいしそん	直系子孫
ちょっかんろんり	直観論理
ちょっかんひりつ	直間比率
ちょっかんせかい	直観世界
ちょっかんしゅぎ	直感主義	直観主義
ちょちくせいこう	貯蓄性向
ちょちくさいけん	貯蓄債券
ちょぞうこうぞう	貯蔵構造
ちょさくしゃめい	著作者名
ちょさくしゃべつ	著作者別
ちょさくしゃけん	著作者権
ちょさくけんほご	著作権保護
ちょさくけんほう	著作権法
ちょさくけんぶつ	著作権物
ちょさくけんなど	著作権等
ちょさくけんてき	著作権的
ちょさくけんじゃ	著作権者
ちょさくけんしゃ	著作権者
ちょくれつましん	直列マシン
ちょくれつしよう	直列使用
ちょくれつげんご	直列言語
ちょくりゅうよう	直流用
ちょくりつほこう	直立歩行
ちょくりつふどう	直立不動
ちょくりつしせい	直立姿勢
ちょくつうろせん	直通路線
ちょくつうかのう	直通可能
ちょくちょうがん	直腸癌
ちょくぜんゆそう	直前輸送
ちょくせんみとお	直線見通
ちょくせんほかん	直線補完	直線補間
ちょくせんぶんし	直線分子
ちょくせんぶぶん	直線部分
ちょくせんどうろ	直線道路
ちょくせんせんろ	直線線路
ちょくせんじょう	直線状	直線上
ちょくせんしゅう	勅撰集
ちょくせんくかん	直線区間
ちょくせんきょり	直線距離
ちょくせんかそく	直線加速
ちょくせんかいき	直線回帰
ちょくせんいっき	直線一気
ちょくせつりよう	直接利用
ちょくせつりえき	直接利益
ちょくせつひかく	直接比較
ちょくせつとうし	直接投資
ちょくせつそうさ	直接操作
ちょくせつきどう	直接起動
ちょくせつあいて	直接相手
ちょくしんちゅう	直進中
ちょくしょうてん	直焦点
ちょきんほうしき	貯金方式
ちょうわへいきん	調和平均
ちょうろうきしゃ	長老記者
ちょうれいぼかい	朝令暮改
ちょうりゅうまい	長粒米
ちょうりゅうどう	超流動
ちょうりゅうつう	超流通
ちょうりほうほう	調理方法
ちょうりぎじゅつ	調理技術
ちょうらくしょう	超楽勝
ちょうやくりょく	跳躍力
ちょうめいれいご	長命令語
ちょうめいきょく	超名曲
ちょうみりょうひ	調味料費
ちょうまんばけん	超万馬券
ちょうほしゅてき	超保守的
ちょうほうきてき	超法規的
ちょうほうきかん	諜報機関
ちょうへんせいか	長編成化
ちょうふしんせつ	超不親切
ちょうふこうこう	調布高校
ちょうびりゅうし	超微粒子
ちょうひもりろん	超紐理論
ちょうはんげんき	長半減期
ちょうはつこうい	挑発行為
ちょうのうりょく	超能力
ちょうにんきぞく	町人貴族
ちょうにゅうもん	超入門
ちょうとっきゅう	超特急
ちょうてんようそ	頂点要素
ちょうていかかく	超低価格
ちょうちょうぼぼ	朝々暮々	朝朝暮暮
ちょうだいがめん	超大画面
ちょうたきゃくき	超多客期
ちょうそんやくば	町村役場
ちょうそんちょう	町村長
ちょうぜつぎこう	超絶技巧	超絶技功
ちょうせんもんか	超専門家
ちょうせんちゅう	挑戦中
ちょうせんじょう	挑戦状
ちょうせんじだい	朝鮮時代
ちょうせんいよく	挑戦意欲
ちょうせつきのう	調節機能
ちょうせつきこう	調節機構
ちょうせつかのう	調節可能
ちょうせきりょく	潮汐力
ちょうせいりょく	調整力
ちょうせいりょう	調整料
ちょうせいりほう	超整理法
ちょうせいぶそく	調整不足
ちょうせいはんい	調整範囲
ちょうせいちゅう	調整中
ちょうせいじょう	調整上
ちょうせいしだい	調整次第
ちょうせいきゅう	調整給
ちょうじょうしゃ	長上者
ちょうじゅんすう	超準数
ちょうじゅみょう	長寿命
ちょうじゅうろう	長十郎
ちょうじゅうぎが	鳥獣戯画
ちょうじゃくかん	長尺管
ちょうじゃがさき	長者ヶ崎
ちょうじつしょり	長日処理
ちょうじかんそう	長時間走
ちょうしんるこつ	彫心鏤骨
ちょうしんりがく	超心理学
ちょうしょくよう	朝食用
ちょうしょくつき	朝食付
ちょうしゅうきん	徴収金
ちょうしゅうがく	徴収額
ちょうしゅうかく	聴衆各
ちょうしそうぞく	長子相続
ちょうしぜんがく	超自然学
ちょうしぎょこう	銚子漁港
ちょうさんわおん	長三和音
ちょうさぼしゅう	調査募集
ちょうさほうほう	調査方法
ちょうさほうこく	調査報告
ちょうさしょもつ	調査書物
ちょうさこうもく	調査項目
ちょうこくしつざ	彫刻室座
ちょうこうりょう	聴講料
ちょうこうみつど	超高密度
ちょうこうぶんし	超高分子
ちょうこうさんか	聴講参加
ちょうこうきゅう	超高級
ちょうこうきぼう	聴講希望
ちょうげんりろん	超弦理論
ちょうげんじつは	超現実派
ちょうけいりょう	超軽量
ちょうきれんさい	長期連載
ちょうきりょこう	長期旅行
ちょうきょりほう	長距離砲
ちょうきょりびん	長距離便
ちょうきょりせん	長距離戦
ちょうきょりけい	長距離系
ちょうきょうほう	調教法
ちょうきゅうめい	長久命
ちょうきたいざい	長期滞在
ちょうきこくさい	長期国債
ちょうきけっせき	長期欠席
ちょうきけいやく	長期契約
ちょうきけいかく	長期計画
ちょうききんぞく	長期勤続
ちょうききゅうか	長期休暇
ちょうきあんてい	長期安定
ちょうがゆうせい	頂芽優勢
ちょうがくりょう	張学良
ちょうかんじょう	聴感上
ちょうかりじゅん	超過利潤
ちょうかていいん	超過定員
ちょうかじゅよう	超過需要
ちょうかくひろう	聴覚疲労
ちょうかくじょう	聴覚上
ちょうかくしょり	聴覚処理
ちょうかくきのう	聴覚機能
ちょうかくきこう	聴覚機構
ちょうかくきかん	聴覚器官
ちょうかくかてい	聴覚過程
ちょうかがくてき	超科学的
ちょうかいりょく	聴解力
ちょうかいぼへん	朝改暮変
ちょうかいぎいん	町会議員
ちょうおんぱしき	超音波式
ちょうおんきごう	長音記号
ちょうえつしゅぎ	超越主義
ちょうえいきどう	町営軌道
ちょういっきゅう	超一級
ちょういちりゅう	超一流
ちゆじょうきょう	治癒状況
ちゅうろくたいざ	中肋胎座
ちゅうりんじょう	駐輪場
ちゅうようとっき	虫様突起
ちゅうやけんこう	昼夜兼行
ちゅうもんひょう	注文票	注文表
ちゅうもんちゅう	注文中
ちゅうもんかのう	注文可能
ちゅうもくひょう	中目標
ちゅうべいかくち	中米各地
ちゅうぶだいがく	中部大学
ちゅうばんいこう	中盤以降
ちゅうはほうそう	中波放送
ちゅうねんしんし	中年紳士
ちゅうねんおとこ	中年男
ちゅうねんいこう	中年以降
ちゅうにゅうよう	注入用
ちゅうにゅうぐち	注入口
ちゅうにちたいし	駐日大使
ちゅうとさいよう	中途採用
ちゅうとうわへい	中東和平
ちゅうとうちいき	中東地域
ちゅうでんりょく	中電力
ちゅうだんちゅう	中断中
ちゅうだんじかん	中断時間
ちゅうたいちょう	中隊長
ちゅうぞうぶぶん	鋳造部分
ちゅうぞうちゅう	鋳造中
ちゅうぜつきんし	中絶禁止
ちゅうせんけっか	抽選結果
ちゅうせんきょく	中選挙区
ちゅうせいしぼう	中性脂肪
ちゅうせいしそく	中性子束
ちゅうせいしせん	中性子線
ちゅうせいしせい	中性子星
ちゅうせいしすう	中性子数
ちゅうせいしげん	中性子源
ちゅうじょうひめ	中将姫
ちゅうじょうだん	中上段
ちゅうじゅんぶん	中旬分
ちゅうじゅんごろ	中旬頃
ちゅうじくたいざ	中軸胎座
ちゅうしんりょく	中心力
ちゅうしんふきん	中心付近
ちゅうしんちゅう	中心柱
ちゅうしんさぶん	中心差分
ちゅうしんきあつ	中心気圧
ちゅうしょしょう	中書省
ちゅうしょくべつ	昼食別
ちゅうしょくどき	昼食時
ちゅうしょくだい	昼食代
ちゅうしょくかい	昼食会
ちゅうしょうろん	抽象論
ちゅうしょうてき	抽象的
ちゅうしょうつい	抽象対
ちゅうしょうせい	抽象性
ちゅうしょうこく	中小国
ちゅうしょうきじ	中傷記事
ちゅうしょうがた	抽象型
ちゅうしゅつほう	抽出法
ちゅうしゅつぶつ	抽出物
ちゅうしゃりょう	駐車料
ちゅうしゃひょう	駐車票
ちゅうしゃばしょ	駐車場所
ちゅうしゃちゅう	駐車中
ちゅうしゃじょう	駐車場
ちゅうしゃくぶん	注釈文
ちゅうしゃくつき	注釈付き
ちゅうしゃくしょ	注釈書
ちゅうしゃきんし	駐車禁止
ちゅうしゃいはん	駐車違反
ちゅうさいきかん	仲裁機関
ちゅうごくりょう	中国領
ちゅうごくりゅう	中国流
ちゅうごくやさい	中国野菜
ちゅうごくまんが	中国漫画
ちゅうごくほんど	中国本土
ちゅうごくほくぶ	中国北部
ちゅうごくぶんか	中国文化
ちゅうごくぶっか	中国物価
ちゅうごくびじん	中国美人
ちゅうごくなんぶ	中国南部
ちゅうごくないぶ	中国内部
ちゅうごくとうき	中国陶器
ちゅうごくちほう	中国地方
ちゅうごくぜんど	中国全土
ちゅうごくせいふ	中国政府
ちゅうごくさんち	中国山地
ちゅうごくごよう	中国語用
ちゅうごくごふう	中国語風
ちゅうごくごばん	中国語版
ちゅうごくかんじ	中国漢字
ちゅうごくえいが	中国映画
ちゅうごくいがい	中国以外
ちゅうこぶひんや	中古部品屋
ちゅうこしじょう	中古市場
ちゅうこうぶんこ	中公文庫
ちゅうこうしょく	昼光色
ちゅうこうぎしつ	中講義室
ちゅうこうきゅう	中高級
ちゅうけいちてん	中継地点
ちゅうけいきょく	中継局
ちゅうくうしまく	中空糸膜
ちゅうぎんじょう	中吟醸
ちゅうきょうちく	中京地区
ちゅうきょうだい	中京大
ちゅうきょうしば	中京芝
ちゅうきゅうへん	中級編
ちゅうきゅうひん	中級品
ちゅうきゅうしゃ	中級者
ちゅうきさくひん	中期作品
ちゅうきこくさい	中期国債
ちゅうがたにりん	中型二輪
ちゅうがくじだい	中学時代
ちゅうがくくらい	中学位
ちゅうがくえいご	中学英語
ちゅうがくいらい	中学以来
ちゅうかんろんり	中間論理
ちゅうかんとびら	中間扉
ちゅうかんてすと	中間テスト
ちゅうかんていど	中間程度
ちゅうかんちょう	中間調
ちゅうかんちてん	中間地点
ちゅうかんしんさ	中間審査
ちゅうかんしょく	中間色
ちゅうかんしせつ	中間施設
ちゅうかんしけん	中間試験
ちゅうかんげんご	中間言語
ちゅうかんけっか	中間結果
ちゅうかんきほう	中間記法
ちゅうかんかそく	中間加速
ちゅうかりょうり	中華料理
ちゅうかみんぞく	中華民族
ちゅうかみんこく	中華民國	中華民国
ちゅうかべんとう	中華弁当
ちゅうかざんまい	中華三昧
ちゅうかこうくう	中華航空
ちゅうかいりょう	仲介料
ちゅうかいぎしつ	中会議室
ちゅうおうみゃく	中央脈
ちゅうおうへいち	中央平地
ちゅうおうぶぶん	中央部分
ちゅうおうふきん	中央付近
ちゅうおうひろば	中央広場
ちゅうおうばしょ	中央場所
ちゅうおうどうろ	中央道路
ちゅうおうとっぱ	中央突破
ちゅうおうでんし	中央電子
ちゅうおうつうろ	中央通路
ちゅうおうちょう	中央町
ちゅうおうせいふ	中央政府
ちゅうおうけいば	中央競馬
ちゅうおうぐんい	中央軍委
ちゅうおうぎけん	中央技研
ちゅうおうきんき	中央近畿
ちゅうおうきょく	中央局
ちゅういほうほう	注意方法
ちゅういひょうじ	注意表示
ちゅういてんとう	注意点等
ちゅういじんぶつ	注意人物
ちゃくりくふのう	着陸不能
ちゃくようぎむか	着用義務化
ちゃくだつかのう	着脱可能
ちゃくせきくぶん	着席区分
ちゃくしんしょり	着信処理
ちゃくしんきょひ	着信拒否
ちゃくしょくよう	着色用
ちゃくがんちゅう	着岸中
ちゃーしゅーめん	チャーシュー麺	叉焼麺
ちめいせっとうご	地名接頭語
ちほうれんらくぶ	地方連絡部
ちほうだいひょう	地方代表
ちほうじょうたい	痴呆状態
ちほうしょうたい	地方招待
ちほうしゅっしん	地方出身
ちほうこうむいん	地方公務員
ちほうこうふぜい	地方交付税
ちほうこうぎょう	地方興行
ちほうぎょうせい	地方行政
ちほうかいじょう	地方会場
ちばだいりがくぶ	千葉大理学部
ちばけんたいかい	千葉県大会
ちのうひょうげん	知能表現
ちのうじょうほう	知能情報
ちのうしょうがい	知能障害
ちとせからすやま	千歳烏山
ちてきのうりょく	知的能力
ちてきたんきゅう	知的探求
ちてきたいしょう	知的対象
ちてきしょうがい	知的障害
ちてきしゅうだん	知的集団
ちてきけいさんき	知的計算機
ちつぶんぴつえき	膣分泌液
ちっそじゅうてん	窒素充填
ちっそさんかぶつ	窒素酸化物
ちちおやさんかん	父親参観
ちせいかせんそう	知性化戦争
ちじょうほうそう	地上放送
ちじょうはんてい	地上判定
ちじょうさいだい	地上最大
ちじょうこうげき	地上攻撃
ちじょうけんちく	地上建築
ちじょうきちがわ	地上基地側
ちじょうかそくど	地上加速度
ちしりょうれんさ	致死量連鎖
ちしきひょうげん	知識表現
ちしきすいじゅん	知識水準
ちしきさいりよう	知識再利用
ちしきかいきゅう	知識階級
ちこうらんりゅう	地衡乱流
ちくほうほんせん	筑豊本線
ちくほうでんてつ	筑豊電鉄
ちくとうぼくせつ	竹頭木屑
ちくせきそうしん	蓄積送信
ちくじこうひょう	逐次公表
ちくじけいさんき	逐次計算機
ちきゅうれんぽう	地球連邦
ちきゅうぼうえい	地球防衛
ちきゅうほうこう	地球方向
ちきゅうぶつりや	地球物理屋
ちきゅうはんけい	地球半径
ちきゅうでんじき	地球電磁気
ちきゅうていこく	地球帝国
ちきゅうぜんたい	地球全体
ちきゅうせいめい	地球生命
ちきゅうせいふく	地球征服
ちきゅうせいじん	地球星人
ちきゅうしんだん	地球診断
ちきゅうしつてん	地球質点
ちきゅうさいだい	地球最大
ちかんひょうげん	置換表現
ちかてつほうめん	地下鉄方面
ちかてつでんしゃ	地下鉄電車
ちかてつしゃない	地下鉄車内
ちかてつけんよう	地下鉄兼用
ちかてつかくせん	地下鉄各線
ちかてつえんしん	地下鉄延伸
ちかくのうりょく	知覚能力
ちかくしんりがく	知覚心理学
ちかかいさつまえ	地下改札前
ちぇこすろばきあ	捷克
ちいきみっちゃく	地域密着
ちいきだいひょう	地域代表
ちいきそうごかん	地域相互間
ちいきじょうほう	地域情報
ちいきじゅうみん	地域住民
ちあんじょうたい	治安状態
たんわくしていば	単枠指定馬
たんりょくしょく	淡緑色
たんまつひょうじ	端末表示
たんまつてじゅん	端末手順
たんまつぞくせい	端末属性
たんまつせってい	端末設定
たんぱつよみきり	単発読切
たんぱじゅしんき	短波受信機
たんぱくさいぼう	タンパク細胞
たんねんどしゅぎ	単年度主義
たんどくらいにち	単独来日
たんどくへんせい	単独編成
たんどくはんばい	単独販売
たんどくとくてん	単独得点
たんどくとうこう	単独投稿
たんどくそうこう	単独走行
たんどくせいはん	単独正犯
たんどくせいぎょ	単独制御
たんどくこうどう	単独行動
たんどくこうえん	単独公演
たんどくけっさん	単独決算
たんどくかいそん	単独海損
たんとうわりあて	担当割り当て
たんとうろんぶん	担当論文
たんとうまどぐち	担当窓口
たんとうぶきょく	担当部局
たんとううけつけ	担当受付
たんていじむしょ	探偵事務所
たんちょうろんり	単調論理
たんちょうぞうか	単調増加
たんちょうかじょ	単頂花序
たんたいはんばい	単体販売
たんそじゅんかん	炭素循環
たんそうりょうか	単層量化
たんそうひょうひ	単層表皮
たんせんうんてん	単線運転
たんすうふくすう	単数複数
たんじょうきねん	誕生記念
たんじゅんどうさ	単純動作
たんじかんろこう	短時間露光
たんしょくやさい	淡色野菜
たんしゅくじかん	短縮時間
たんしゅくこうか	短縮効果
たんさくほうほう	探索方法
たんさくほうしん	探索方針
たんさくほうこう	探索方向
たんさくこうりつ	探索効率
たんさくくうかん	探索空間
たんさいぼうもう	単細胞毛
たんさいぼうてき	単細胞的
たんこうてつどう	炭坑鉄道
たんこうえんざん	単項演算
たんげんしぶんし	単原子分子
たんくかんしょり	短区間処理
たんきょりろせん	短距離路線
たんきだいがくぶ	短期大学部
たんきかんじゅう	短機関銃
たんかんじじしょ	単漢字辞書
たんかくそうしょ	丹鶴叢書
たんいようりょう	単位容量
たんいつさいぼう	単一細胞
たんいせいしょく	単為生殖
たんいじかんない	単位時間内
たんいしつりょう	単位質量
たんいぎょうれつ	単位行列
たんいかんきょう	単位環境
たんいかぶせいど	単位株制度
たわらやそうたつ	俵屋宗達
たりきほんがんじ	他力本願寺
たまちでんしゃく	田町電車区
たまさきじんじゃ	玉前神社
たまきゅうりょう	多摩丘陵
たまがわだいこう	玉川大工
たまがわだいがく	玉川大学
たまがわがくえん	玉川学園
たばこちゅうどく	煙草中毒
たばこきょうかい	煙草協会
たねださんとうか	種田山頭火
たにんずうどうじ	多人数同時
たにあしかじゅう	谷足加重
たなおろししさん	たな卸資産	棚卸資産
たどつこうじょう	多度津工場
たとうしょうめい	多灯照明
たてよここんざい	縦横混在
たてやまさんろく	立山山麓
たてながたんまつ	縦長端末
たてしほうがため	縦四方固め
たてがたしんごう	縦形信号
たつみしゅっぱん	辰巳出版
たつのくちちょう	辰口町
たちはらみちぞう	立原道造
たちてんつうしん	多地点通信
たちじゃこうそう	立麝香草
たちかわほうめん	立川方面
たちあがりじかん	立ち上がり時間
たちあいえんぜつ	立会演説
たすうはこうさく	多数派工作
たすうけつげんり	多数決原理
たじょうぶっしん	多情仏心
たじゅうろくおん	多重録音
たじゅうよびだし	多重呼出し
たじゅうほうそう	多重放送
たじゅうひょうじ	多重表示
たじゅうどきごう	多重度記号
たじゅうせきぶん	多重積分
たじゅうじんかく	多重人格
たじゅうさんらん	多重散乱
たじゅうけつごう	多重結合
たじげんはいれつ	多次元配列
たしょうふぐあい	多少不具合
たしょうきょうみ	多少興味
たしょうかいぜん	多少改善
たこくごたいおう	多国語対応
たこうしきじかん	多項式時間
たこうしきかいき	多項式回帰
たこあしはいせん	蛸足配線	タコ足配線
たげんごたいおう	多言語対応
たけんきゅうしつ	他研究室
たけはしかいかん	竹橋会館
たけとよせんない	武豊線内
たけだたいじゅん	武田泰淳
たくちなみかぜい	宅地並課税
たくだいいちこう	拓大一高
たくそうてにもつ	託送手荷物
たきのうぶんれつ	多機能分裂
たきざわりんどう	滝沢林道
たかんきょうせい	多環境性
たからづかしょう	宝塚賞
たからづかきねん	宝塚記念
たからづかかげき	宝塚歌劇
たかやまほんせん	高山本線
たかやまほうめん	高山方面
たかむらこううん	高村光雲
たかはしみちつな	高橋三千綱
たかはしこれきよ	高橋是清
たかねきょうぞん	高値共存
たかつきていしゃ	高槻停車
たかつかこうこう	高塚高校
たかちほろんそう	高千穂論争
たかだのばばてん	高田馬場店
たかだのばばえき	高田馬場駅
たかすぎしんさく	高杉晋作
たかさきほうめん	高崎方面
たかさきはまがわ	高崎浜川
たかくらてんのう	高倉天皇
たかおそうぶせん	高尾総武線
たかおかしょてん	高岡書店
たいわんよしのや	台湾吉野家
たいりょくぶそく	体力不足
たいりょうゆそう	大量輸送
たいりょうしよう	大量使用
たいりょういんじ	大量印字
たいりつがいねん	対立概念
たいりつかんけい	対立関係
たいりついでんし	対立遺伝子
たいりくはっけん	大陸発見
たいりくしょぼう	大陸書房
たいりくおうだん	大陸横断
たいらのまさかど	平将門
たいらのきよもり	平清盛
たいらのかねもり	平兼盛
たいよこはません	対横浜戦
たいようゆうでん	太陽誘電
たいようはつでん	太陽発電
たいようねんすう	耐用年数
たいようすうはい	太陽崇拝
たいようしょぼう	大洋書房
たいようこくてん	太陽黒点
たいようこうせん	太陽光線
たいようけいない	太陽系内
たいようけいがい	太陽系外
たいようかつどう	太陽活動
たいめんのりかえ	対面乗換
たいめんてつどう	泰緬鐵道
たいめんつうこう	対面通行
たいほくおうふく	台北往復
たいほうやくひん	大鵬薬品
たいへんゆうめい	大変有名
たいへんめいわく	大変迷惑
たいへんまんぞく	大変満足
たいへんふゆかい	大変不愉快
たいへんしんせつ	大変親切
たいへんしつれい	大変失礼
たいへんざんねん	大変残念
たいへんこんなん	大変困難
たいへんけっこう	大変結構
たいへんかんしゃ	大変感謝
たいへいようせん	太平洋線
たいへいようがわ	太平洋側
たいひりょういき	退避領域
たいばつもんだい	体罰問題
たいばつきょうし	体罰教師
たいのうしょぶん	滞納処分
たいにちさんせん	対日参戦
たいないはいかん	胎内拝観
たいどひょうめい	態度表明
たいとうかんけい	対等関係
たいとういじょう	対等以上
たいちょういへん	体調異変
たいだんしょぶん	退団処分
たいだんけいしき	対談形式
たいぜんじじゃく	泰然自若
たいせんとちゅう	対戦途中
たいせんせいせき	対戦成績
たいせんしゃほう	対戦車砲
たいせんけいしき	対戦形式
たいせんかいすう	対戦回数
たいせいようせん	大西洋線
たいせいようじょ	対生葉序
たいせいようがん	大西洋岸
たいせいほうかん	大政奉還
たいせいこうこう	大成高校
たいせいけんせつ	大成建設
たいせいかんかく	体性感覚
たいせいいでんし	耐性遺伝子
たいすうかんすう	対数関数
たいじんかんけい	対人関係
たいじょうじゅん	退場順
たいじゅうりょう	耐重量
たいじゅういどう	体重移動
たいしんせっけい	耐震設計
たいしょほうほう	対処方法
たいしょこうしょ	大所高所
たいしょくりゆう	退職理由
たいしょくねがい	退職願
たいしょくじゆう	退職事由
たいしょくけいじ	退職刑事
たいしょうわしゃ	対象話者
たいしょうまっき	大正末期
たいしょうひょう	対照表
たいしょうねんど	対象年度
たいしょうちしき	対象知識
たいしょうちいき	対象地域
たいしょうせかい	対象世界
たいしょうじだい	大正時代
たいしょうしてい	対象指定
たいしょうしこう	対象指向
たいしょうざっし	対象雑誌
たいしょうげんご	対象言語
たいしょうくかん	対象区間
たいしょうきしゅ	対象機種
たいしょうきごう	対象記号
たいしょうきかん	対象期間
たいしゅうぶんか	大衆文化
たいしゅうすしや	大衆寿司屋
たいしゅうしんり	大衆心理
たいしゅうごらく	大衆娯楽
たいしゃくきょう	帝釈峡
たいしつかいぞう	体質改造
たいしつかいぜん	体質改善
たいざいにっすう	滞在日数
たいざいけいけん	滞在経験
たいさくほうほう	対策方法
たいさくなんかい	対策難解
たいこしょうせい	耐故障性
たいこうれっしゃ	対向列車
たいこうようけん	対抗要件
たいこうはんしゃ	対光反射
たいこうたいごう	太皇太后
たいこうしゅだん	対抗手段
たいこうしゃせん	対向車線
たいこうかくしゃ	対抗各社
たいぐうかいぜん	待遇改善
たいくうぼうぎょ	対空防御
たいくうほうだん	対空砲弾
たいくうしゃげき	対空射撃
たいくうけいかく	対空計画
たいぎゃくむどう	大逆無道
たいぎゃくじけん	大逆事件
たいきんてつせん	対近鉄戦
たいきょくちゅう	対局中
たいきょくけいか	対局経過
たいきゅうりょく	耐久力
たいきゅうしけん	耐久試験
たいきゃくちゅう	退却中
たいきでんりょく	待機電力
たいきじょうたい	待機状態
たいきげんしょう	大気現象
たいがしょうせつ	大河小説
たいがくしょぶん	退学処分
たいがくかんこく	退学勧告
たいがいせんでん	対外宣伝
たいがいじゅせい	体外受精
たいがいかつどう	対外活動
たいかんみんこく	大韓民国
たいかんこうげき	対艦攻撃
たいかくせいぶん	対角成分
たいかくしゃぞう	対角写像
たいかくぎょがん	対角魚眼
たいかいようこう	大会要項
たいかいやくいん	大会役員
たいかいぜんぱん	大会全般
たいかいぜんたい	大会全体
たいかいさんかひ	大会参加費
たいかいかいさい	大会開催
たいおんそくてい	体温測定
たいおうふかのう	対応不可能
たいおうばんぐみ	対応番組
たいおうどりょく	対応努力
たいおうしゅだん	対応手段
たいおうしゃしゅ	対応車種
たいおうかんけい	対応関係
たいえきぐんじん	退役軍人
たいいくきょうし	体育教師
たいいくかんない	体育館内
たいいくかいけい	体育会系
たいいきほうしき	大域方式
たいいきへんすう	大域変数
たいいきぶんせき	帯域分析
たいいきぶんかつ	帯域分割
たいいきとくせい	帯域特性
たいいきせいげん	帯域制限
たいいきざつおん	帯域雑音
たいいきこうぞう	大域構造
たいいきかんすう	大域関数
たいいきかくだい	帯域拡大
たいあんきちじつ	大安吉日
とろーるぎょぎょう	トロール漁業
とりひきざいりょう	取引材料
とりつびじゅつかん	都立美術館
とりしまりやくかい	取締役会
とりしまりじじょう	取締事情
とりけしでんぴょう	取消伝票
とよおかこうじょう	豊岡工場
とやまけんりつだい	富山県立大
とみおかぼうはてい	富岡防波堤
とびいしれんきゅう	飛石連休	飛び石連休
とばくうりあげきん	賭博売上金
とのさましょうばい	殿様商売
とどけでずみしょう	届出済証
とどうふけんざかい	都道府県境
とどうふけんぎかい	都道府県議会
とつじょしゅつげん	突如出現
とっぱつげんしょう	突発現象
とっけんかいきゅう	特権階級
とっきょせんりゃく	特許戦略
とっきょしゅつがん	特許出願
とっきゅうれっしゃ	特急列車
とっきゅうほうしき	特急方式
とっきゅうでんしゃ	特急電車
とちりようこうりつ	土地利用効率
とちりようけいかく	土地利用計画
とちゅうりようしゃ	途中利用者
とちゅうたいじょう	途中退場
とちゅうげしゃいん	途中下車印
とちゅうきゅうけい	途中休憩
とちゅうきゅうえん	途中休演
とちゅうえきそうご	途中駅相互
とちぶんじょうしき	土地分譲式
とちかいりょうほう	土地改良法
とそうかんりょうご	塗装完了後
としょしりょうしつ	図書資料室
としょかんしりょう	図書館資料
としけいかくどうろ	都市計画道路
とけいないぞうがた	時計内蔵型
とくべつりょうきん	特別料金
とくべつべんごにん	特別弁護人
とくべつへんしゅう	特別編集
とくべつちゅうもん	特別注文
とくべつじょうこく	特別上告
とくべつしようしゃ	特別仕様車
とくべつしゅつえん	特別出演
とくべつしゃりょう	特別車両
とくべつしていせき	特別指定席
とくべつけんきゅう	特別研究
とくべつきょうてい	特別協定
とくべつきょうそう	特別競争	特別競走
とくべつきょうしつ	特別教室
とくべつきゅうこう	特別急行
とくべつかいじょう	特別会場
とくべついいんかい	特別委員会
とくひょうじゅんい	得票順位
とくはいんほうこく	特派員報告
とくてんけんだりつ	得点圏打率
とくていとくしない	特定都区市内
とくていちいきがい	特定地域外
とくていしょうすう	特定少数
とくていしょうけい	特定承継
とくていしゃりょう	特定車両
とくていこじんよう	特定個人用
とくていげんごけん	特定言語圏
とくていけいしきき	特定形式機
とくていきゅうだん	特定球団
とくていきしゅべつ	特定機種別
とくちょうくうかん	特徴空間
とくちょうかんすう	特徴関数
とくちょういちらん	特徴一覧
とくせつかいじょう	特設会場
とくせいきょくせん	特性曲線
とくしゅよくじょう	特殊浴場
とくしゅむせんぎし	特殊無線技師
とくしゅのうりょく	特殊能力
とくしゅじゅうだん	特殊銃弾
とくしゅじどうしゃ	特種自動車
とくしゅしょうひん	特殊賞品
とくしゅしゃりょう	特殊車両
とくしゅけいじょう	特殊形状
とくしゅがっきゅう	特殊学級
とくしゅかいきゅう	特殊階級
とくしゅうばんぐみ	特集番組
とくしまけんきょう	徳島県境
ときわまつがくえん	トキワ松学園
とえいあさくさせん	都営浅草線
とうろくわしゃすう	登録話者数
とうろくようきゅう	登録要求
とうろくまっしょう	登録抹消
とうろくたんごすう	登録単語数
とうろくじょうほう	登録情報
とうろくじどうしゃ	登録自動車
とうろくじしょめい	登録辞書名
とうろくしょひよう	登録諸費用
とうろくしょうしょ	登録証書
とうろくきぼうしゃ	登録希望者
とうろくかんりょう	登録完了
とうらくせんじょう	当落線上
とうよこせんでぐち	東横線出口
とうよこせんしぶや	東横線渋谷
とうようだいひめじ	東洋大姫路
とうようじょうほう	東洋情報
とうようじょうぞう	東洋醸造
とうようさんぎょう	東洋産業
とうようこうぎょう	東洋工業
とうよういがくしゃ	東洋医学者
とうみんじょうたい	冬眠状態
とうほくやっかだい	東北薬科大
とうほくふくしだい	東北福祉大
とうほくとっきゅう	東北特急
とうほくでんりょく	東北電力
とうほくせんくかん	東北線区間
とうほくしぶちょう	東北支部長
とうほくかもつせん	東北貨物線
とうほうきょうかい	東方教会
とうぶはくぶつかん	東武博物館
とうぶにっこうせん	東武日光線
とうぶにっこうえき	東武日光駅
とうぶいせざきせん	東武伊勢崎線
とうふくじのりかえ	東福寺乗換
とうびょうせいかつ	闘病生活
とうひょうほうほう	投票方法
とうひょうほうしき	投票方式
とうひょうはんたい	投票反対
とうひょうにんずう	投票人数
とうひょうないよう	投票内容
とうひょうそうすう	投票総数
とうひょうぜんたい	投票全体
とうひょうぜんすう	投票全数
とうひょうせいりつ	投票成立
とうひょうじょない	投票所内
とうひょうじょうい	投票上位
とうひょうじゅんい	投票順位
とうひょうじゅうし	投票重視
とうひょうしょない	投票所内
とうひょうしゅほう	投票手法
とうひょうしゅだん	投票手段
とうひょうしゃめい	投票者名
とうひょうしゃすう	投票者数
とうひょうしゃかん	投票者間
とうひょうしゃあて	投票者宛
とうひょうさぎょう	投票作業
とうひょうこうどう	投票行動
とうひょうけんだい	投票券代
とうひょうけいしき	投票形式
とうひょうきんがく	投票金額
とうはてきにんげん	党派的人間
とうにゅうきんがく	投入金額
とうなんぼうしよう	盗難防止用
とうなんしょうめい	盗難証明
とうてつこうぎょう	東鉄工業
とうつうさんぎょう	東通産業
とうちょうないよう	盗聴内容
とうちゃくぶんまで	到着分迄
とうちゃくかんかく	到着間隔
とうちゃくかくりつ	到着確率
とうちせんかんかく	等値線間隔
とうだいりかにるい	東大理科二類
とうだいほうがくぶ	東大法学部
とうだいぶんがくぶ	東大文学部
とうだいびょういん	東大病院
とうだいのうがくぶ	東大農学部
とうだいすうがっか	東大数学科
とうだいじょうこう	東大情工
とうだいじしんけん	東大地震研
とうだいざいりょう	東大材料
とうだいこうがくぶ	東大工学部
とうだいきょうよう	東大教養
とうだいきょうじゅ	東大教授
とうだいきょういく	東大教育
とうたつもくひょう	到達目標
とうたつかのうせい	到達可能性
とうそくどうんどう	等速度運動
とうせきりょうほう	透析療法
とうせきどうにゅう	透析導入
とうじょうよていび	搭乗予定日
とうじょうばんぐみ	登場番組
とうじょうてつどう	東上鉄道
とうじょうせいけん	東条政権
とうじょうじんぶつ	登場人物
とうじょうじっせき	搭乗実績
とうじょうかいかん	東條會舘
とうじつりょうきん	当日料金
とうじつはっぴょう	当日発表
とうじつかいじょう	当日会場
とうじしゃてきかく	当事者適格
とうじこうこうせい	当時高校生
とうしゅきようほう	投手起用法
とうしばじょうほう	東芝情報
とうしばじゅんせい	東芝純正
とうしこもんぎょう	投資顧問業
とうざいごうりゅう	東西合流
とうごうきょういく	統合教育
とうごうかんきょう	統合環境
とうごうかのうせい	統合可能性
とうごうかしゅほう	統合化手法
とうこうちゅうどく	投稿中毒
とうこうだいぶつり	東工大物理
とうこうだいないぶ	東工大内部
とうこうだいすうり	東工大数理
とうこうしゃどうし	投稿者同士
とうこうしゃじしん	投稿者自身
とうこうきじちゅう	投稿記事中
とうこうかんきょう	投稿環境
とうけんきゅうしょ	当研究所
とうけんきゅうしつ	当研究室
とうけんきゅうかい	当研究会
とうけつぼうしよう	凍結防止用
とうけつぼうしざい	凍結防止剤
とうけいてきすうち	統計的数値
とうけいてきけっか	統計的結果
とうけいてきかいき	統計的回帰
とうけいじょうほう	統計情報
とうけいしょりよう	統計処理用
とうきょうわんない	東京湾内
とうきょうわんぐち	東京湾口
とうきょうわんがん	東京湾岸
とうきょうりかだい	東京理科大
とうきょうほんしゃ	東京本社
とうきょうほうめん	東京方面
とうきょうほうそう	東京放送
とうきょうほうしき	東京方式
とうきょうほうげん	東京方言
とうきょうのりいれ	東京乗入
とうきょうにっさん	東京日産
とうきょうとちょう	東京都庁
とうきょうとくない	東京都区内
とうきょうでんかん	東京電環
とうきょうてっこう	東京鐵鋼
とうきょうてあとる	東京テアトル
とうきょうちかえき	東京地下駅
とうきょうだいがく	東京大学
とうきょうたんけん	東京探検
とうきょうたいかい	東京大会
とうきょうぜんたい	東京全体
とうきょうぜいかん	東京税関
とうきょうせたがや	東京世田谷
とうきょうせいてつ	東京製鐵
とうきょうせいこう	東京製鋼
とうきょうせいかつ	東京生活
とうきょうすたいる	東京スタイル
とうきょうじむしょ	東京事務所
とうきょうしんぶん	東京新聞
とうきょうしょせき	東京書籍
とうきょうしたまち	東京下町
とうきょうしじょう	東京市場
とうきょうさいばん	東京裁判
とうきょうこくさい	東京国際
とうきょうこうだい	東京工大
とうきょうこうせん	東京高専
とうきょうこうこう	東京高校
とうきょうこうえん	東京公演
とうきょうけいれつ	東京系列
とうきょうぎんこう	東京銀行
とうきょうきんこう	東京近郊
とうきょうきそけん	東京基礎研
とうきょうきかんく	東京機関区
とうきょうかんない	東京管内
とうきょうかながわ	東京神奈川
とうきょうかいわい	東京界隈
とうきょうかいらく	東京快楽
とうきょうかいはつ	東京開発
とうきょうかいさい	東京開催
とうきょうかいかん	東京会舘
とうきょうおんだい	東京音大
とうきょうおおつか	東京大塚
とうきょうおうふく	東京往復
とうきょうえきちか	東京駅地下
とうきゅうほんてん	東急本店
とうきゅうほんかん	東急本館
とうきゅうないよう	投球内容
とうきゅうとうよこ	東急東横
とうきゅうでんてつ	東急電鉄
とうきゅうけんせつ	東急建設
とうきゅうかんこう	東急観光
とうきゅうかいすう	投球回数
とうきはくぶつかん	陶器博物館
とうきかいいんけん	冬季会員券
とうがいしょうひん	当該商品
とうがいこういしゃ	当該行為者
とうがいきゅうだん	当該球団
とうがいあいてかた	当該相手方
とうかつじぎょうぶ	統轄事業部	統括事業部
とうかせいはんてい	等価性判定
とうかがたでんけん	透過型電顕
とうかかいてんけい	等価回転系
とうかいどうくかん	東海道区間
とうかいだいぶつり	東海大物理
とうかいだいひょう	東海代表
とうかいだいさがみ	東海大相模
とうかいだいこうふ	東海大甲府
とうかいこうぎょう	東海鋼業	東海興業
とういつきょうかい	統一教会	統一協会
てんりゅうほうめん	天竜方面
てんらんかいじょう	展覧会場
てんもんせんもんし	天文専門誌
てんもんしょうねん	天文少年
てんもんげんしょう	天文現象
てんもんがっかいし	天文学会誌
てんめつじょうたい	点滅状態
てんばいかいもどし	転売買戻し
てんのうほうちゅう	天皇訪中
てんのうはいよせん	天皇杯予選
てんのうちょうかん	天王町間
てんのうせいひはん	天皇制批判
てんのうしょうはる	天皇賞春
てんのうしょうぐみ	天皇賞組
てんのうしょうあき	天皇賞秋
てんのうきかんせつ	天皇機関説
てんねんせんりょう	天然染料
てんねんきねんぶつ	天然記念物
てんちょうちきゅう	天長地久
てんたいぶつりてき	天体物理的
てんたいぶつりがく	天体物理学
てんたいしゃしんか	天体写真家
てんそうようりょう	転送容量
てんそうようきゅう	転送要求
てんそうのうりょく	転送能力
てんそうじょうげん	転送上限
てんそうしゅうよう	転送収容
てんすうちょうせい	点数調整
てんじょうむきゅう	天壤無窮	天壌無窮
てんじょういんよう	添乗員用
てんじたんとうしゃ	展示担当者
てんじそくばいかい	展示即売会
てんじせつめいかい	展示説明会
てんじえいわじてん	点字英和辞典
てんさいたいしょう	天才大賞
てんさいじょうけん	転載条件
てんさいしょうねん	天才少年
てんさいしょうじょ	天才少女
てんさいかがくしゃ	天才科学者
てんこうこくしょく	天香国色
てんきそうだんじょ	天気相談所
てんきそうだんしょ	天気相談所
てんかいじょうたい	展開状態
てんいんきょういく	店員教育
てんあんもんひろば	天安門広場
てんあんもんじけん	天安門事件
てらまちじいんぐん	寺町寺院群
てびきだいいっぱん	手引第一版
てつどうりょうきん	鉄道料金
てつどうもけいよう	鉄道模型用
てつどうせいびぜい	鉄道整備税
てつどうじょうほう	鉄道情報
てつどうしょくいん	鉄道職員
てつどうしゃりょう	鉄道車両
てつどうしがっかい	鉄道史学会
てつどうこくゆうか	鉄道国有化
てつどうこうそくか	鉄道高速化
てつどうきねんかん	鉄道記念館
てつどうえんちょう	鉄道延長
てつどうあいこうか	鉄道愛好家
てつづきがたげんご	手続型言語	手続き型言語
てつがくてきけんち	哲学的見地
てつがくしゅっぱん	哲学出版
てつがくきょうじゅ	哲学教授
てつがくきょういく	哲学教育
てっちゅうこうげき	鉄柱攻撃
てったいじょうけん	撤退条件
てっしんせきちょう	鉄心石腸
てっしゅうじゅんび	撤収準備
てっこついんりょう	鉄骨飲料
てっかいようきゅう	撤回要求
てすうりょうていど	手数料程度
てきようはんいがい	適用範囲外
てきようたいしょう	適用対象
てきようじょうけん	適用条件
てきようじゅんじょ	適用順序
てきせつふてきせつ	適切不適切
てきせいこうりょう	適正光量
てきおうりょうしか	適応量子化
てきおうせんりゃく	適応戦略
てきおうしょうがい	適応障害
てきおうきょうめい	適応共鳴
てきおうがくしゅう	適応学習
てがきもじにんしき	手書き文字認識
ていりゅうじょめい	停留所名
ていりゅうじょかん	停留所間
ていりしょうめいき	定理証明器	定理証明機
ていばんしょうひん	定番商品
ていねんたいしょく	定年退職	停年退職
ていとうしょうけん	抵当証券
ていでんりょくふか	定電力負荷
ていでんりゅうげん	定電流源
ていちゃくふりょう	定着不良
ていそんしつせんろ	低損失線路
ていそくつうしんじ	低速通信時
ていせいのうりょく	訂正能力
ていじょうぎょうむ	定常業務
ていじょうかくりつ	定常確率
ていじげんぶんかい	低次元分解
ていしんしゅうてき	低侵襲的
ていしゅつぶんしょ	提出文書
ていしゅつしょるい	提出書類
ていしゅつしめきり	提出締切
ていしゅうはぶぶん	低周波部分
ていしゅうはでんか	低周波電化
ていしゃちょくぜん	停車直前
ていしゃじょうたい	停車状態
ていしゃしゃりょう	停車車両
ていしゃえきぜんぶ	停車駅全部
ていしせいはんてい	停止性判定
ていしきかしゅほう	定式化手法
ていこくしゅぎしゃ	帝国主義者
ていこくさんぎょう	帝国産業
ていこくげきじょう	帝国劇場
ていこうせいりょく	抵抗勢力
ていけつあつしょう	低血圧症
ていけいかいしょう	提携解消
ていぎいきぜんたい	定義域全体
ていきょうほうほう	提供方法
ていきょうばんぐみ	提供番組
ていきょうだいがく	帝京大学
ていきょうしゃがわ	提供者側
ていきょうこうこう	帝京高校
ていきしょうきゅう	定期昇給
ていきしゃくちけん	定期借地権
ていききんさいけん	定期金債権
ていきかんこうぶつ	定期刊行物
ていきかいいんけん	定期会員券
ていきえんそうかい	定期演奏会
ていかくでんりゅう	定格電流
ていかかくせいひん	低価格製品
ていいんじょうしゃ	定員乗車
つぼうちしょうよう	坪内逍遥
つばきもとちえいん	椿本チエイン
つなみちゅういほう	津波注意報
つちみかどてんのう	土御門天皇
つだじゅくだいがく	津田塾大学
つけものしょくにん	漬物職人
つくばだいせいぶつ	筑波大生物
つくばだいしゃこう	筑波大社工
つくばだいこうがく	筑波大工学
つくばだいがくだい	筑波大学第
つくばだいがくいん	筑波大学院
つくばじっけんしつ	筑波実験室
つくだいびょういん	筑大病院
つきせかいりょこう	月世界旅行
つきすうかいくらい	月数回位
つうはんぎょうしゃ	通販業者
つうぞくてきりかい	通俗的理解
つうじょうほうしき	通常方式
つうじょうひょうじ	通常表示
つうじょうだんとう	通常弾頭
つうじょうそうこう	通常走行
つうじょうそうかい	通常総会
つうじょうさつえい	通常撮影
つうじょうさいせい	通常再生
つうじょうこっかい	通常国会
つうじょうこうげき	通常攻撃
つうじょうくうかん	通常空間
つうじょうぎょうむ	通常業務
つうじょうおんいき	通常音域
つうじょううんてん	通常運転
つうじょううんちん	通常運賃
つうしんりょうきん	通信料金
つうしんようりょう	通信容量
つうしんのうりょく	通信能力
つうしんたいしょう	通信対象
つうしんじょうほう	通信情報
つうしんじょうけん	通信条件
つうしんしょうがい	通信障害
つうしんこうがっか	通信工学科
つうしんぎじゅつぶ	通信技術部
つうしんきょういく	通信教育
つうしんかんきょう	通信環境
つうしんかいはつぶ	通信開発部
つうこうりょうきん	通行料金
つうきんりゅうどう	通勤流動
つうきんとっきゅう	通勤特急
つうきんていきだい	通勤定期代
つうきんじかんたい	通勤時間帯
つうきんしゃりょう	通勤車両
つうがくじかんたい	通学時間帯
つういんこうつうひ	通院交通費
ついにんとうひょう	追認投票
ついとうじょうえい	追悼上映
ついかぼしゅうぶん	追加募集分
ちんちゃくれいせい	沈着冷静
ちんたいじゅうたく	賃貸住宅
ちんすいしょくぶつ	沈水植物
ちんぎんどれいせい	賃金奴隷制
ちんぎんすいじゅん	賃金水準
ちりょうひかんけい	治療費関係
ちよだせんあかさか	千代田線赤坂
ちよだじょがくえん	千代田女学園
ちょっこうぶんかい	直交分解
ちょっこうちょっき	直行直帰
ちょっこうざひょう	直交座標
ちょっこうかんすう	直交関数
ちょっけいそんぞく	直系尊属
ちょっけいけつぞく	直系血族
ちょっけいいんぞく	直系姻族
ちょっかんないよう	直観内容
ちょっかくほうこう	直角方向
ちょっかくざひょう	直角座標
ちょっかがたじしん	直下型地震
ちょしゃりゃくれき	著者略歴
ちょしゃめいじゅん	著者名順
ちょしゃしょうかい	著者紹介
ちょさくけんりょう	著作権料
ちょさくけんほうき	著作権放棄
ちょさくけんせいど	著作権制度
ちょさくけんじょう	著作権上
ちょさくけんいはん	著作権違反
ちょくれつせつぞく	直列接続
ちょくりゅうでんか	直流電化
ちょくりゅうくかん	直流区間
ちょくりつさいぼう	直立細胞
ちょくゆにゅうばん	直輸入版
ちょくつうれっしゃ	直通列車
ちょくつうでんしゃ	直通電車
ちょくつうじゅよう	直通需要
ちょくつううんよう	直通運用
ちょくつううんてん	直通運転
ちょくせんへんこう	直線偏光
ちょくせんしょうぶ	直線勝負
ちょくせんかそくき	直線加速器
ちょくせんうんどう	直線運動
ちょくせつれんらく	直接連絡
ちょくせつゆにゅう	直接輸入
ちょくせつはんばい	直接販売
ちょくせつはんたい	直接反対
ちょくせつてんそう	直接転送
ちょくせつつうしん	直接通信
ちょくせつたいけつ	直接対決
ちょくせつたいおう	直接対応
ちょくせつそくてい	直接測定
ちょくせつせんとう	直接戦闘
ちょくせつせんきょ	直接選挙
ちょくせつせつぞく	直接接続
ちょくせつせっしゅ	直接摂取
ちょくせつせいぎょ	直接制御
ちょくせつしょうこ	直接証拠
ちょくせつさぎょう	直接作業
ちょくせつこうげき	直接攻撃
ちょくせつげんいん	直接原因
ちょくせつけいやく	直接契約
ちょくせつきんゆう	直接金融
ちょくせつきじゅつ	直接記述
ちょくせつかんせつ	直接間接
ちょくせつかくにん	直接確認
ちょくせつかいとう	直接回答
ちょくせつかいせん	直接回線
ちょくせいはいしゅ	直生胚珠
ちょくしんほうこう	直進方向
ちょくしんうんどう	直進運動
ちょくしゃにっこう	直射日光
ちょくおうまいしん	直往邁進
ちょうわしんどうし	調和振動子
ちょうりょくきのう	聴力機能
ちょうりょうばっこ	跳梁跋扈
ちょうゆうめいてん	超有名店
ちょうゆうめいじん	超有名人
ちょうみりょうなど	調味料等
ちょうみりょうだい	調味料代
ちょうぼうえんよう	超望遠用
ちょうほしゅしそう	超保守思想
ちょうほうかつどう	諜報活動
ちょうへいれつよう	超並列用
ちょうへいれつがた	超並列型
ちょうふにんきしゃ	超不人気車
ちょうひっさつわざ	超必殺技
ちょうないかくしょ	町内各所
ちょうでんどうたい	超伝導体
ちょうでんじこうか	超電磁効果
ちょうていぶんさん	超低分散
ちょうていきょくほ	長汀曲浦
ちょうちんあんこう	提灯鮟鱇
ちょうちょうはっし	丁々発止
ちょうちょうきょり	超長距離
ちょうだいへんせい	長大編成
ちょうたんはんてい	長短判定
ちょうたんさいぼう	頂端細胞
ちょうそんそうかい	町村総会
ちょうぜつりんじん	超絶倫人
ちょうせんへいごう	朝鮮併合
ちょうせんはんとう	朝鮮半島
ちょうせんにんじん	朝鮮人参
ちょうせんにっぽう	朝鮮日報
ちょうせんだいがく	朝鮮大学
ちょうせんせんそう	朝鮮戦争
ちょうせんしゃぐみ	挑戦者組
ちょうせつほうほう	調節方法
ちょうせついでんし	調節遺伝子
ちょうせきはつでん	潮汐発電
ちょうせいほうほう	調整方法
ちょうせいしゅだん	調整手段
ちょうせいかいせき	調性解析
ちょうせいおんがく	調性音楽
ちょうすうがくてき	超数学的
ちょうじょうふきん	頂上付近
ちょうじょうきゅう	超上級
ちょうじゅばんづけ	長寿番付
ちょうじゅばんぐみ	長寿番組
ちょうじゅしゃかい	長寿社会
ちょうじゃばんづけ	長者番付
ちょうじっすうろん	超実数論
ちょうじくほうこう	長軸方向
ちょうじくうせんき	超時空戦記
ちょうじかんろこう	長時間露光
ちょうじかんでんわ	長時間電話
ちょうじかんしよう	長時間使用
ちょうしょたんしょ	長所短所
ちょうしょしんしゃ	超初心者
ちょうしょくじかん	朝食時間
ちょうしょうすうは	超少数派
ちょうしゅじっけん	聴取実験
ちょうしゅくうかん	聴取空間
ちょうしゅうさんか	聴衆参加
ちょうさだんちょう	調査団長
ちょうさたいしょう	調査対象
ちょうさけんきゅう	調査研究
ちょうこっかしゅぎ	超国家主義
ちょうこうむりょう	聴講無料
ちょうこうぼうえき	朝貢貿易
ちょうこうひんしつ	超高品質
ちょうこうそうびる	超高層ビル
ちょうこうせいのう	超高性能
ちょうこうじゅんど	超高純度
ちょうこうしゅうは	超高周波
ちょうこうかいてん	超高回転
ちょうげんじつてき	超現実的
ちょうけいりょうか	超軽量化
ちょうけいてんのう	長慶天皇
ちょうきれんきゅう	長期連休
ちょうきょりろせん	長距離路線
ちょうきょりゆそう	長距離輸送
ちょうきょりふつう	長距離普通
ちょうきょりひこう	長距離飛行
ちょうきょりでんわ	長距離電話
ちょうきょりだしゃ	長距離打者
ちょうきょりきろく	長距離記録
ちょうきょりきゃく	長距離客
ちょうきょりきっぷ	長距離切符
ちょうきょうりょく	超強力
ちょうきょうぶそく	調教不足
ちょうきょうちゅう	調教中
ちょうきもくひょう	長期目標
ちょうきふきょうか	長期不況下
ちょうきびょうけつ	長期病欠
ちょうきにゅういん	長期入院
ちょうきこうはんい	長期広範囲
ちょうきけつじょう	長期欠場
ちょうききゅうよう	長期休養
ちょうきかんほぞん	長期間保存
ちょうきかんほうち	長期間放置
ちょうきかんしよう	長期間使用
ちょうかんすうろん	超関数論
ちょうかんじゅんい	聴感順位
ちょうかりょうきん	超過料金
ちょうかくとくせい	聴覚特性
ちょうかくしんけい	聴覚神経
ちょうかいしょぶん	懲戒処分
ちょうかいけんしゃ	懲戒権者
ちょうおんようしき	調音様式
ちょうおんけつごう	調音結合
ちょうおんかぶぶん	長音化部分
ちょうえつろんてき	超越論的
ちょうえつそんざい	超越存在
ちょういちりゅうば	超一流馬
ちゅうりつせんげん	中立宣言
ちゅうやぎゃくてん	昼夜逆転
ちゅうもんほうほう	注文方法
ちゅうもんばんごう	注文番号
ちゅうもんないよう	注文内容
ちゅうもんせんよう	注文専用
ちゅうもんせいさん	注文生産
ちゅうもくせんしゅ	注目選手
ちゅうもくさくひん	注目作品
ちゅうべいほうめん	中米方面
ちゅうぶでんりょく	中部電力
ちゅうぶてんりゅう	中部天竜
ちゅうばんいじょう	中判以上
ちゅうねんだんせい	中年男性
ちゅうねんしょうど	中燃焼度
ちゅうにちしんぶん	中日新聞
ちゅうどくかんじゃ	中毒患者
ちゅうとうもんだい	中東問題
ちゅうとうせんそう	中東戦争
ちゅうとうせいさく	中東政策
ちゅうちょうきょり	中長距離
ちゅうちょうきてき	中長期的
ちゅうちゅうたいし	駐中大使
ちゅうだいすぎなみ	中大杉並
ちゅうせんほうほう	抽選方法
ちゅうせいふりょく	中性浮力
ちゅうせいどうぶつ	中生動物
ちゅうせいせんざい	中性洗剤
ちゅうせいじょじし	中世叙事詩
ちゅうせいおんがく	中世音楽
ちゅうすうしんけい	中枢神経
ちゅうじゅんいこう	中旬以降
ちゅうしんほうこう	中心方向
ちゅうしんぶいこう	中心部以降
ちゅうしんぶいがい	中心部以外
ちゅうしんせんしゅ	中心選手
ちゅうしんじんぶつ	中心人物
ちゅうしんしゅだい	中心主題
ちゅうしんしがいち	中心市街地
ちゅうしようきゅう	中止要求
ちゅうしょうめいし	抽象名詞
ちゅうしょうせかい	抽象世界
ちゅうしょうしょり	抽象処理
ちゅうしょうしてつ	中小私鉄
ちゅうしょうごめん	中傷御免
ちゅうしょうきかい	抽象機械
ちゅうしゃもんだい	駐車問題
ちゅうしゃだいすう	駐車台数
ちゅうしゃくじこう	注釈事項
ちゅうしゃくぎょう	註釈行
ちゅうしこくちほう	中四国地方
ちゅうさいはんだん	仲裁判断
ちゅうさいけいやく	仲裁契約
ちゅうごしっくたい	中ゴシック体
ちゅうごくりょうり	中国料理
ちゅうごくみんこう	中国民航
ちゅうごくほうそう	中国放送
ちゅうごくぶんめい	中国文明
ちゅうごくぶんがく	中国文学
ちゅうごくはっこう	中国発行
ちゅうごくのうみん	中国農民
ちゅうごくどくりつ	中国独立
ちゅうごくたいりく	中国大陸
ちゅうごくせいほう	中国西方
ちゅうごくせいねん	中国青年
ちゅうごくせいいき	中国西域
ちゅうごくじんみん	中国人民
ちゅうごくじんがわ	中国人側
ちゅうごくしんぶん	中国新聞
ちゅうごくごぶぶん	中国語部分
ちゅうごくこくみん	中国国民
ちゅうごくこくない	中国国内
ちゅうごくぐんみん	中国軍民
ちゅうごくぐんえい	中国軍営
ちゅうごくぎんこう	中国銀行
ちゅうごくえんせい	中国遠征
ちゅうこしゃりょう	中古車両
ちゅうこしゃざっし	中古車雑誌
ちゅうここうにゅう	中古購入
ちゅうこくふぁんど	中国ファンド
ちゅうこぎょうしゃ	中古業者
ちゅうこうれっしゃ	昼行列車
ちゅうこうもくめい	中項目名
ちゅうこうねんそう	中高年層
ちゅうこうだいいん	中高大院
ちゅうこうしんしょ	中公新書
ちゅうこうおんいき	中高音域
ちゅうけんしゃいん	中堅社員
ちゅうくうこうぞう	中空構造
ちゅうきょりだしゃ	中距離打者
ちゅうきょりいどう	中距離移動
ちゅうきゅうていど	中級程度
ちゅうがっこうまで	中学校迄
ちゅうがためんきょ	中型免許
ちゅうがたげんてい	中型限定
ちゅうがたいじょう	中型以上
ちゅうがくにゅうし	中学入試
ちゅうがくせいばん	中学生版
ちゅうがくじゅけん	中学受験
ちゅうがくこうこう	中学高校
ちゅうがくきょうし	中学教師
ちゅうがいせいやく	中外製薬
ちゅうかんほうじん	中間法人
ちゅうかんほうこく	中間報告
ちゅうかんへんすう	中間変数
ちゅうかんはんけつ	中間判決
ちゅうかんはいとう	中間配当
ちゅうかんはいせん	中間配線
ちゅうかんとうしん	中間答申
ちゅうかんだんかい	中間段階
ちゅうかんだいしゃ	中間台車
ちゅうかんそうすう	中間層数
ちゅうかんじんこう	昼間人口
ちゅうかんしんこく	中間申告
ちゅうかんさくしゅ	中間搾取
ちゅうかんけっさん	中間決算
ちゅうかんがいねん	中間概念
ちゅうかんかいそく	昼間快速
ちゅうかんかいそう	中間階層
ちゅうかんかいさつ	中間改札
ちゅうかりょうりや	中華料理屋
ちゅうかまんじゅう	中華饅頭
ちゅうかざいりょう	中華材料
ちゅうかくじぎょう	中核事業
ちゅうかいてんいき	中回転域
ちゅうおうりんかん	中央林間
ちゅうおうほんせん	中央本線
ちゅうおうはつでん	中央発電
ちゅうおうにっぽう	中央日報
ちゅうおうとっかい	中央特快
ちゅうおうだいがく	中央大学
ちゅうおうせんよう	中央線用
ちゅうおうせんない	中央線内
ちゅうおうしょいん	中央書院
ちゅうおうしゃせん	中央車線
ちゅうおうさいせん	中央西線
ちゅうおうこうろん	中央公論
ちゅうおうこうそく	中央高速
ちゅうおうこうえん	中央公園
ちゅうおうぐちてん	中央口店
ちゅうおうぎんこう	中央銀行
ちゅうおうがくいん	中央学院
ちゅうえつせんそう	中越戦争
ちゅうあいてんのう	仲哀天皇
ちゅーれんぱおとう	九連宝灯
ちゃっこうだんかい	着工段階
ちゃくりくてじゅん	着陸手順
ちゃくしんせってい	着信設定
ちゃくしんかいせん	着信回線
ちゃくしょくりょう	着色料
ちゃくしょくずめん	着色図面
ちめいてきけってん	致命的欠点
ちめいてきけっかん	致命的欠陥
ちほうとくさんひん	地方特産品
ちほうてつどうほう	地方鉄道法
ちほうじゅんぎょう	地方巡業
ちほうしょうたいば	地方招待馬
ちほうさいばんしょ	地方裁判所
ちほうこうつうせん	地方交通線
ちほうきゅうじょう	地方球場
ちばひがしこうこう	千葉東高校
ちばきゅうこうせん	千葉急行線
ちてきせいめいたい	知的生命体
ちてきしょゆうけん	知的所有権
ちてきざいさんけん	知的財産権
ちじょうはほうそう	地上波放送
ちじょうさいきょう	地上最強
ちじきかんそくしょ	地磁気観測所
ちしつちょうさしょ	地質調査所
ちしつずさくいんず	地質図索引図
ちしきしゅどうがた	知識主導型
ちしきこうがくてき	知識工学的
ちしきこうがくしゃ	知識工学者
ちしきぎじゅつしゃ	知識技術者
ちこつけつごうえん	恥骨結合炎
ちこくしゃたいさく	遅刻者対策
ちくりんしょうじゃ	竹林精舎
ちくじにゅうりょく	逐次入力
ちくじがたすいろん	逐次型推論
ちくじかんこうぶつ	逐次刊行物
ちくごふくしまえき	筑後福島駅
ちきゅうりゅうたい	地球流体
ちきゅうぶつりよう	地球物理用
ちきゅうぶつりがく	地球物理学
ちきゅうてきけんち	地球的見地
ちきゅうじんどうし	地球人同士
ちきゅうしんりゃく	地球侵略
ちきゅうしんにゅう	地球侵入
ちきゅうしつりょう	地球質量
ちきゅうけんきゅう	地球研究
ちきゅうかんきょう	地球環境
ちきゅうおんだんか	地球温暖化
ちかれんらくつうろ	地下連絡通路
ちかてつぜんくかん	地下鉄全区間
ちかてつぎんざせん	地下鉄銀座線
ちかてつきょうつう	地下鉄共通
ちかきゅうこうせん	地下急行線
ちえんじょうきょう	遅延状況
ちいきぶんかつがた	地域分割型
ちあんじょうきょう	治安状況
たんぽつきしゃさい	担保付社債
たんぺんしょうせつ	短編小説	短篇小説
たんどくそんしょう	単独損傷
たんとうへんしゅう	担当編集
たんとうのうりょく	担当能力
たんとうしゃしめい	担当者氏名
たんとうしゃこじん	担当者個人
たんとうがかりめい	担当係名
たんとうかんりにん	担当管理人
たんとうかかりかん	担当係官
たんていしょうせつ	探偵小説
たんそうこうりゅう	単相交流
たんせいせいしょく	単性生殖
たんじょうびきねん	誕生日記念
たんじょうちょくご	誕生直後
たんじゅんろうどう	単純労働
たんじゅんめいかい	単純明解	単純明快
たんじゅんへいきん	単純平均
たんじゅんさぎょう	単純作業
たんじゅんけいさん	単純計算
たんじゅんおうふく	単純往復
たんしんふにんぞく	単身赴任族
たんしんふにんしゃ	単身赴任者
たんしょうはんだん	単称判断
たんしょうはいとう	単勝配当
たんしょうてんがわ	短焦点側
たんしょうしじりつ	単勝支持率
たんししゅつりょく	端子出力
たんしかんでんあつ	端子間電圧
たんざわこほうめん	丹沢湖方面
たんさんどおんてい	短三度音程
たんさんかんでんち	単三乾電池
たんさんいんりょう	炭酸飲料
たんさくせんりゃく	探索戦略
たんさいぼうこうぼ	単細胞酵母
たんごにんしきりつ	単語認識率
たんごかんくうはく	単語間空白
たんこうのうりょく	堪航能力
たんこうえんざんし	単項演算子
たんくかんしんぷく	短区間振幅
たんきょりらんなー	短距離ランナー
たんきょりそうしゃ	短距離走者
たんきょりせんもん	短距離専門
たんきょりけっとう	短距離血統
たんきひこうちゅう	単機飛行中
たんきだいがくせい	短期大学生
たんきしゅうちゅう	短期集中
たんきかりいれきん	短期借入金
たんかんじょうえい	単館上映
たんかんじへんかん	単漢字変換
たんいりったいかく	単位立体角
たんいつだいにゅう	単一代入
たんいつけいちょう	単一茎頂
たんいつけいしょう	単一継承
たんいちかんでんち	単一乾電池
たんいせいこうこう	単位制高校
たわらまちおおくさ	田原町大草
たりきほんがんてき	他力本願的
ためいけこうさてん	溜池交差点
たまがわてっきょう	多摩川鉄橋
たまがわじょうすい	玉川上水
たへんすうかんすう	多変数関数
たへんすうかいせき	多変数解析
たぶんだいじょうぶ	多分大丈夫
たねんせいそうほん	多年性草本
たどうしもくてきご	他動詞目的語
たてわりぎょうせい	縦割行政
たてがたせいまいき	縦型精米機
たっぴかいていえき	竜飛海底駅
たちばじょうゆうり	立場上有利
たちせきじょうしゃ	立席乗車
ただいまさんじょう	只今参上
たそうこうぞうなべ	多層構造鍋
たせかいかいしゃく	多世界解釈
たじゅうさいむしゃ	多重債務者
たじゅうけいしょう	多重継承
たしょうちんせいか	多少鎮静化
たしょうえいきょう	多少影響
たしゃせんれんらく	他社線連絡
たさいぼうせいぶつ	多細胞生物
たこくせきぐんがわ	多国籍軍側
たこくせききぎょう	多国籍企業
たこくかんきょうぎ	多国間協議
たこうしきかんすう	多項式関数
たけなかこうむてん	竹中工務店
たけとりものがたり	竹取物語
たくしょくだいがく	拓殖大学
たかんかくゆうごう	多感覚融合
たからづかほうめん	宝塚方面
たからづかきねんば	宝塚記念馬
たからづかおんせん	宝塚温泉
たからずかきねんば	宝塚記念馬
たかむらこうたろう	高村光太郎
たかむこのくろまろ	高向玄理
たかみねじょうきち	高峰譲吉
たかまつのみやはい	高松宮杯	高松宮盃
たかとりこうじょう	鷹取工場
たかだのばばしてん	高田馬場支店
たかしまだいらがわ	高島平側
たかくしょうじょう	他覚症状
たいわんかいきょう	台湾海峡
たいりょくようせい	体力養成
たいりょくぞうしん	体力増進
たいりょくそくてい	体力測定
たいりょくしょうぶ	体力勝負
たいりょくかいふく	体力回復
たいりょうはんばい	大量販売
たいりょうはっそう	大量発送
たいりょうはっせい	大量発生
たいりょうとくてん	大量得点
たいりょうとうこう	大量投稿
たいりょうぜつめつ	大量絶滅
たいりょうせいさん	大量生産
たいりょうしょうひ	大量消費
たいりょうしってん	大量失点
たいりょうさつじん	大量殺人
たいりょうさいよう	大量採用
たいりょういんさつ	大量印刷
たいりゅうけいたい	対流形態
たいりくしんしゅつ	大陸進出
たいようねつりよう	太陽熱利用
たいようでんちしき	太陽電池式
たいようぎょぎょう	大洋漁業
たいようきゅうだん	大洋球団
たいほかんきんざい	逮捕監禁罪
たいほうりつりょう	大宝律令
たいへんじゅうよう	大変重要
たいへんごめいわく	大変御迷惑
たいへいようちいき	太平洋地域
たいへいこうぎょう	太平工業
たいふうじょうりく	台風上陸
たいひょうめんせき	体表面積
たいばつぜんひてい	体罰全否定
たいちょうふりょう	体調不良
たいちょうふちょう	体調不調
たいちょうばんぜん	体調万全
たいちゅうにちせん	対中日戦
たいせんちゅうるい	苔蘚虫類
たいせんすうひょう	対戦数表
たいじょうほうしん	帯状疱疹
たいじょうしょぶん	退場処分
たいじゅうそくてい	体重測定
たいしょりょうほう	対処療法
たいしょくねんきん	退職年金
たいしょうへんすう	対象変数
たいしょうねんれい	対象年齢
たいしょうにんしき	対象認識
たいしょうてんのう	大正天皇
たいしょうたいかい	対象大会
たいしょうせんしゅ	対象選手
たいしょうせいやく	大正製薬
たいしょうじんいん	対象人員
たいしょうじっけん	対照実験
たいしょうしんじん	大賞新人
たいしょうがんねん	大正元年
たいしょうがいせい	耐障害性
たいしゅうぶんがく	大衆文学
たいしゅうおんがく	大衆音楽
たいしゃくとりひき	貸借取引
たいさくいいんかい	対策委員会
たいこうにりんしゃ	対向二輪車
たいこうしょうひん	対抗商品
たいこううせつしゃ	対向右折車
たいけんがくしゅう	体験学習
たいきょくへんすう	大局変数
たいきょくばんごう	対局番号
たいきょくしゃめい	対局者名
たいきゅうせいのう	耐久性能
たいきばんせいがた	大器晩成型
たいがいせっしょう	対外折衝
たいかくせんじょう	対角線上
たいかくぎょうれつ	対角行列
たいかいじむきょく	大会事務局
たいかいしんきろく	大会新記録
たいかいさんかしゃ	大会参加者
たいかいけっしょう	大会決勝
たいかいかいじょう	大会会場
たいおんちょうせつ	体温調節
たいおんちょうせい	体温調整
たいおうしゃりょう	対応車両
たいおうけんばいき	対応券売機
たいいくかがくけい	体育科学系
たいいきだっしゅつ	大域脱出
たいいきしょうめい	大域照明
とりつけせつめいしょ	取付説明書
とりあつかいちゅうい	取扱注意
とやまちほうてつどう	富山地方鉄道
ともながしんいちろう	朝永振一郎
ともえがわせいししょ	巴川製紙所
とみおかはちまんぐう	富岡八幡宮
とないかんじょうせん	都内環状線
とどうふけんじちたい	都道府県自治体
とつかえきりようしゃ	戸塚駅利用者
とっぱつせいはっしん	突発性発疹
とっこうだいさくせん	特攻大作戦
とっきゅうりょうきん	特急料金
とっきゅうはくちょう	特急白鳥
とっきゅうでんしゃか	特急電車化
とっきゅうつうかまち	特急通過待ち
とっきゅうしゃりょう	特急車両
とちゅうしょうりゃく	途中省略
とちゅうしゅつじょう	途中出場
とちかおくちょうさし	土地家屋調査士
とそうへんこうちゅう	塗装変更中
としんじゅんかんせん	都心循環線
としゅつりょうぶそく	吐出量不足
としたいこうやきゅう	都市対抗野球
としこうつうねんぽう	都市交通年報
とけいじぎょうほんぶ	時計事業本部
とくべつほじゅうけん	特別補充券
とくべつはいにんざい	特別背任罪
とくべつさいばんしょ	特別裁判所
とくべつこうえんかい	特別講演会
とくべつかんらんせき	特別観覧席
とくべつかいはつしつ	特別開発室
とくべつえんそうかい	特別演奏会
とくてんこうくうけん	特典航空券
とくてんけいさんしき	得点計算式
とくていとうこうしゃ	特定投稿者
とくていちいきいがい	特定地域以外
とくていきしゅじょう	特定機種上
とくちょうてききのう	特徴的機能
とくちょうがくしゅう	特徴学習
とくせんたいたいいん	特戦隊隊員
とくしゅそうたいろん	特殊相対論
とくがわぶげいちょう	徳川武芸帳
とくがわしょうぐんけ	徳川将軍家
とえいしんじゅくせん	都営新宿線
とうろくしょうひょう	登録商標
とうろくかんりょうば	登録完了馬
とうよこせんれんらく	東横線連絡
とうよこせんぜんせん	東横線全線
とうよこせんかいさつ	東横線改札
とうようかんじひょう	当用漢字表
とうめいはままつにし	東名浜松西
とうめいこうそくせん	東名高速線
とうほくだいせいみつ	東北大精密
とうほくだいすうがく	東北大数学
とうほくしんかんせん	東北新幹線
とうほくがくいんだい	東北学院大
とうほうだいがくいん	東邦大学院
とうほうけんぶんろく	東方見聞録
とうぶんへいきんりつ	等分平均率
とうぶとうじょうせん	東武東上線
とうひょうびとうじつ	投票日当日
とうひょうはんたいは	投票反対派
とうひょうはっぴょう	投票発表
とうひょうたいしょう	投票対象
とうひょうせんしゅつ	投票選出
とうひょうじょうけん	投票条件
とうひょうじょういば	投票上位馬
とうひょうじっしまえ	投票実施前
とうひょうしゅうけい	投票集計
とうひょうさんせいは	投票賛成派
とうひょうさんかしゃ	投票参加者
とうひょうかんりしゃ	投票管理者
とうばいとうりつぞう	当倍倒立像
とうちゃくじゅんじょ	到着順序
とうちゃくごすうにち	到着後数日
とうだいりじょうほう	東大理情報
とうだいぶっせいけん	東大物性研
とうだいせんたんけん	東大先端研
とうだいせいさんけん	東大生産研
とうだいすうりかがく	東大数理科学
とうだいごうかくしゃ	東大合格者
とうだいこうきんぞく	東大工金属
とうだいげんしりょく	東大原子力
とうだいぐさもくぐん	トウダイグサ目群
とうだいかいようけん	東大海洋研
とうそくえんうんどう	等速円運動
とうじょうちょくぜん	搭乗直前
とうじょうしゃほけん	搭乗者保険
とうじつけんまどぐち	当日券窓口
とうじちゅうがくせい	当時中学生
とうじしょうがくせい	当時小学生
とうじしゃのうりょく	当事者能力
とうしばかんさいけん	東芝関西研
とうしばえいぞうけん	東芝映像研
とうしきかくていせつ	等式確定節
とうざいべつけいとう	東西別系統
とうざいせんかいそく	東西線快速
とうざいじゆうつうろ	東西自由通路
とうごうへいはちろう	東郷平八郎
とうごうかじょうほう	統合化情報
とうごういちがたしき	統合一型式
とうこんさんじゅうし	闘魂三銃士
とうこうろんぶんよう	投稿論文用
とうこうだいながつだ	東工大長津田
とうこうだいしゅうし	東工大修士
とうこうせんさくせい	等高線作成
とうこうせいげんとう	投稿制限等
とうこうしゃほんにん	投稿者本人
とうこうしゃそうすう	投稿者総数
とうこうしゃぜんいん	投稿者全員
とうけつじょうきょう	凍結状況
とうけつじゅせいらん	凍結受精卵
とうけいりきがくけい	統計力学系
とうけいねつりきがく	統計熱力学
とうけいてきほうそく	統計的法則
とうけいてきせいしつ	統計的性質
とうけいてきしりょう	統計的資料
とうけいてきしゅほう	統計的手法
とうけいてきかんかく	統計的感覚
とうけいかいせきよう	統計解析用
とうきょうりゅうつう	東京流通
とうきょうりっしょう	東京立正
とうきょうゆうしゅん	東京優駿
とうきょうぶんかけん	東京文化圏
とうきょうはちおうじ	東京八王子
とうきょうなんせいぶ	東京南西部
とうきょうとりつだい	東京都立大
とうきょうでんりょく	東京電力
とうきょうでんきだい	東京電機大
とうきょうちゅうにち	東京中日
とうきょうちゅうしん	東京中心
とうきょうちほうじん	東京地方人
とうきょうじょうほう	東京情報
とうきょうしんじゅく	東京新宿
とうきょうこうじょう	東京工場
とうきょうこうかだい	東京工科大
とうきょうきゅうこう	東京急行
とうきょうかせいだい	東京家政大
とうきょうかいじょう	東京会場	東京海上
とうきょうえきちゃく	東京駅着
とうきょういけぶくろ	東京池袋
とうきょうあきはばら	東京秋葉原
とうきゅうめかません	東急目蒲線
とうきゅうぶんかむら	東急文化村
とうきゅうふどうさん	東急不動産
とうきゅうたたません	東急田玉線
とうきゅうしゃりょう	東急車両
とうがいふくせいぶつ	当該複製物
とうがいちょさくぶつ	当該著作物
とうがいちょさくけん	当該著作権
とうがいしちょうそん	当該市町村
とうかそくどうんどう	等加速度運動
とうかそうおんれべる	等価騒音レベル
とうかいどうほんせん	東海道本線
とうかいだいがくまえ	東海大学前
とうかいしぜんほどう	東海自然歩道
とうえいりったいかく	投影立体角
とういつてききじゅつ	統一的記述
てんりゅうがわかこう	天竜川河口
てんもんどうこうかい	天文同好会
てんぷちずさんしょう	添付地図参照
てんのうゆうざいろん	天皇有罪論
てんのうたんじょうび	天皇誕生日
てんのうしんぽうしゃ	天皇信奉者
てんのうしょうかんじ	天皇賞幹事
てんねんほうしゃせん	天然放射線
てんにゅうてんしゅつ	転入転出
てんとうしょぶんひん	店頭処分品
てんそうしゅうりょう	転送終了
てんじょうせっちがた	天井設置型
てんじゅこくまんだら	天寿国曼荼羅
てんしゅつしょうめい	転出証明
てんさいせきにんしゃ	転載責任者
てんかいちぶどうかい	天下一武道会
てもとりゅうどうせい	手元流動性
てにもつけんさじょう	手荷物検査場
てつどうもけいしゅみ	鉄道模型趣味
てつどうはくぶつかん	鉄道博物館
てつどうたんていだん	鉄道探偵団
てつどうせいびききん	鉄道整備基金
てつどうじこくひょう	鉄道時刻表
てつどうじぎょうしゃ	鉄道事業者
てつどうこうあんかん	鉄道公安官
てつどうけんちくぶつ	鉄道建築物
てつどうけいさつたい	鉄道警察隊
てつどうかんけいしゃ	鉄道関係者
てつがくてきがいねん	哲学的概念
てっきんこんくりーと	鉄筋コンクリート
てすうりょうむりょう	手数料無料
てきせいしようりょう	適正使用量
てきしゅつしゅじゅつ	摘出手術
てきごうほあんぶひん	適合保安部品
てきおうふくぶんかつ	適応副分割
てがきすうじにんしき	手書き数字認識
ていりゅうじょいがい	停留所以外
ていりしょうめいけい	定理証明系
ていでんあつてんとう	低電圧点灯
ていちそうこうねんぴ	定地走行燃費
ていすうかくさぜせい	定数格差是正
ていすうかいせいあん	定数改正案
ていじょうじょうたい	定常状態
ていじょうじけいれつ	定常時系列
ていじにゅうこうしゃ	定時入校者
ていしゅうはすういき	低周波数域
ていしゅうはしんどう	低周波振動
ていしゃえきひょうじ	停車駅表示
ていしゃえきさくげん	停車駅削減
ていしゃえきあんない	停車駅案内
ていしつごしょうてん	帝室御賞典
ていこうせいぎょしゃ	抵抗制御車
ていきょうはちおうじ	帝京八王子
ていきちんたいしゃく	定期賃貸借
ていきじょうしゃけん	定期乗車券
ていかそくしゃりょう	低加速車両
ていかくしゅつりょく	定格出力
ていかくかいてんすう	定格回転数
ていかかくきょうそう	低価格競争
ていおんこうがくかい	低温工学会
ていえんびじゅつかん	庭園美術館
ていうんてんだいしゃ	低運転台車
ていいんせいかいそく	定員制快速
ていあつちょくりゅう	低圧直流
つばきさんじゅうろう	椿三十郎
つづりかたきょうしつ	綴方教室
つだぬまえきちょっか	津田沼駅直下
つくばだいびょういん	筑波大病院
つくばだいちゅうおう	筑波大中央
つくばだいすうちけん	筑波大数値研
つくばだいがくでんし	筑波大学電子
つくばだいかがくけい	筑波大化学系
つくばけんきゅうしょ	筑波研究所
つがるかいきょうせん	津軽海峡線
つうぞくかいせつしょ	通俗解説書
つうじょうえいぎょう	通常営業
つうしんはんばいてん	通信販売店
つうしんそうごうけん	通信総合研
つうしんせいぎょけん	通信制御研
つうしんじぎょうしゃ	通信事業者
つうしんけんきゅうぶ	通信研究部
つうしんけいいっぱん	通信系一般
つうしんかいはつしつ	通信開発室
つうしょうじょうやく	通商条約
つうこうきんしいはん	通行禁止違反
つうきんしんかいそく	通勤新快速
つうきんけいろじょう	通勤経路上
つうかれっしゃどうし	通過列車同士
つうかりょきゃくすう	通過旅客数
つうかせいげんひょう	通過制限表
つうかえきそうごかん	通過駅相互間
ついかんばんへるにあ	椎間板ヘルニア
ついかとうろくりょう	追加登録料
ちんばめんたいしょう	珍場面大賞
ちんたいけいやくしゃ	賃貸契約者
ちんぎんじょうしょう	賃金上昇
ちよだかこうけんせつ	千代田化工建設
ちょっこうぎょうれつ	直交行列
ちょっこうがたきこう	直交型気孔
ちょっかんしゅぎてき	直観主義的
ちょっかんしゅぎしゃ	直観主義者
ちょぞうじゅうそしき	貯蔵柔組織
ちょさくりんせつけん	著作隣接権
ちょさくけんもんだい	著作権問題
ちょさくけんひょうじ	著作権表示
ちょさくけんだんたい	著作権団体
ちょさくけんしんがい	著作権侵害
ちょさくけんかんけい	著作権関係
ちょくりゅうほうしき	直流方式
ちょくりゅうでんしゃ	直流電車
ちょくりゅうていこう	直流抵抗
ちょくりゅうたいおう	直流対応
ちょくりゅうそうでん	直流送電
ちょくりゅうせいぶん	直流成分
ちょくりゅうしんごう	直流信号
ちょくりつじょうたい	直立状態
ちょくつうとっきゅう	直通特急
ちょくつうきゅうこう	直通急行
ちょくせんわかしゅう	勅撰和歌集
ちょくせんりょうしか	直線量子化
ちょくせんせんようき	直線専用機
ちょくせつはっちゅう	直接発注
ちょくせつにゅうしゅ	直接入手
ちょくせつにゅうしゃ	直接入射
ちょくせつていしゅつ	直接提出
ちょくせつちゅうもん	直接注文
ちょくせつぜいふたん	直接税負担
ちょくせつせいきゅう	直接請求
ちょくせつしょうめい	直接照明
ちょくせつごうぎせい	直接合議制
ちょくせつこうにゅう	直接購入
ちょくせつこうしょう	直接交渉
ちょくせつきょうせい	直接強制
ちょくせつかいにゅう	直接介入
ちょくせつかいじょう	直接会場
ちょくせつえいきょう	直接影響
ちょくじょうけいこう	直情径行
ちょうりょくはつでん	潮力発電
ちょうりつようちえん	町立幼稚園
ちょうりつきょくせん	調律曲線
ちょうやくじょうこく	跳躍上告
ちょうぼえつらんけん	帳簿閲覧権
ちょうへんしょうせつ	長編小説
ちょうへいれつしょり	超並列処理
ちょうのうりょくしゃ	超脳力者	超能力者
ちょうないかんきょう	腸内環境
ちょうていくうひこう	超低空飛行
ちょうちんぎょうれつ	提灯行列
ちょうちょうなんなん	喋喋喃喃	喋々喃々
ちょうたんせいちょう	頂端生長
ちょうたいしょうせい	超対称性
ちょうぞうかんしょり	超増感処理
ちょうせんそうとくふ	朝鮮総督府
ちょうせんじんさべつ	朝鮮人差別
ちょうせんしんりゃく	朝鮮侵略
ちょうせんしゅっぺい	朝鮮出兵
ちょうせんけいいみん	朝鮮系移民
ちょうせんかんこくご	朝鮮韓国語
ちょうせいのうりょく	調整能力
ちょうじゅんかいせき	超準解析
ちょうじゅせかいいち	長寿世界一
ちょうじゅうせんしゃ	超重戦車
ちょうじくうようさい	超時空要塞
ちょうじかんていしゃ	長時間停車
ちょうじかんさつえい	長時間撮影
ちょうじかんさぎょう	長時間作業
ちょうじかんうんてん	長時間運転
ちょうしんりがっかい	超心理学会
ちょうしんりがくしゃ	超心理学者
ちょうしんくうでんし	超真空電子
ちょうしょくとりょう	調色塗料
ちょうしょくじゅんび	朝食準備
ちょうしゅうぜんいん	聴衆全員
ちょうししょうぎょう	銚子商業
ちょうさほうこくしょ	調査報告書
ちょうこだいにほんご	超古代日本語
ちょうこうそくくどう	超光速駆動
ちょうこうこうきゅう	超高校級
ちょうげんじつしゅぎ	超現実主義
ちょうげんきのうほう	超限帰納法
ちょうくうかんくどう	超空間駆動
ちょうきょりわりびき	長距離割引
ちょうきょりれっしゃ	長距離列車
ちょうきょりりょこう	長距離旅行
ちょうきょりらんなー	長距離ランナー
ちょうきょりつうきん	長距離通勤
ちょうきょりそうしゃ	長距離走者
ちょうきょりそうこう	長距離走行
ちょうきょりせんもん	長距離専門
ちょうきょりしじょう	長距離試乗
ちょうきょりけっとう	長距離血統
ちょうきょりうんてん	長距離運転
ちょうきゅうけいさつ	超級警察
ちょうきゅういんてき	超吸引的
ちょうきてきみとおし	長期的見通し
ちょうきたいざいしゃ	長期滞在者
ちょうきしゅっちょう	長期出張
ちょうきかんこうそく	長期間拘束
ちょうきかりいれきん	長期借入金
ちょうきいどうちゅう	長期移動中
ちょうがいさんかしゃ	町外参加者
ちょうかくてきしげき	聴覚的刺激
ちょうかくじゅんのう	聴覚順応
ちょうかくしんりがく	聴覚心理学
ちょうかくしょうがい	聴覚障害
ちょうかくげんしょう	聴覚現象
ちょうかきんむてあて	超過勤務手当
ちょうかいめんしょく	懲戒免職
ちょうかいたいしょう	懲戒対象
ちょうおんぱつうしん	超音波通信
ちょうおんてんへんか	調音点変化
ちょういちりゅうひん	超一流品
ちゅうにちりょうこく	中日両国
ちゅうにくちゅうぜい	中肉中背
ちゅうなんべいろせん	中南米路線
ちゅうとしつめいしゃ	中途失明者
ちゅうとうじょうせい	中東情勢
ちゅうとうきょういく	中等教育
ちゅうでんかいちいき	中電界地域
ちゅうていしゃちゅう	駐停車中
ちゅうていしゃきんし	駐停車禁止
ちゅうせんたいしょう	抽選対象
ちゅうせんきょくせい	中選挙区制
ちゅうせいしほうだん	中性子砲弾
ちゅうしんでんきょく	中心電極
ちゅうしんてききのう	中心的機能
ちゅうしんせんじょう	中心線上
ちゅうしょうすうがく	抽象数学
ちゅうしょうこうぶん	抽象構文
ちゅうしょうきぎょう	中小企業
ちゅうしょうがいねん	抽象概念
ちゅうしょうかんやく	抽象簡約
ちゅうしゃりょうきん	駐車料金
ちゅうしゃじょうなど	駐車場等
ちゅうしゃじょうない	駐車場内
ちゅうしゃじょうだい	駐車場代
ちゅうしゃじょうした	駐車場下
ちゅうしゃしゃりょう	駐車車両
ちゅうさんかいきゅう	中産階級
ちゅうごくぶんめいし	中国文明史
ちゅうごくはけんぐん	中国派遣軍
ちゅうごくでんりょく	中国電力
ちゅうごくしんりゃく	中国侵略
ちゅうごくごがいろん	中国語概論
ちゅうごくこっきょう	中国国境
ちゅうごくぐんじんち	中国軍陣地
ちゅうごくかんたいじ	中国簡体字
ちゅうごくかがくいん	中国科学院
ちゅうこせんもんてん	中古専門店
ちゅうけいしんごうき	中継信号機
ちゅうけいきょくかん	中継局間
ちゅうきょりでんしゃ	中距離電車
ちゅうきょりしゅもく	中距離種目
ちゅうきょうてんのう	仲恭天皇
ちゅうきょうだいがく	中京大学
ちゅうきょうかいさい	中京開催
ちゅうきゅうしゃよう	中級者用
ちゅうきゅうしゃむけ	中級者向
ちゅうきゅうきていど	中級機程度
ちゅうがっこうじだい	中学校時代
ちゅうがっこういらい	中学校以来
ちゅうがくそつぎょう	中学卒業
ちゅうがくせいとかい	中学生徒会
ちゅうがくせいざっし	中学生雑誌
ちゅうがくせいいぜん	中学生以前
ちゅうがくせいあいて	中学生相手
ちゅうがくこうちょう	中学校長
ちゅうがいいがくしゃ	中外医学社
ちゅうかんひょうげん	中間表現
ちゅうかんはっぴょう	中間発表
ちゅうかんしゅうけい	中間集計
ちゅうかんがくしょう	中間楽章
ちゅうかんかいきゅう	中間階級
ちゅうかんえきしはつ	中間駅始発
ちゅうかりょうりてん	中華料理店
ちゅうかいひょうげん	仲介表現
ちゅうおうぶんりたい	中央分離帯
ちゅうおうひがしせん	中央東線
ちゅうおうとしょかん	中央図書館
ちゅうおうしょくどう	中央食堂
ちゅうおうしょうめん	中央正面
ちゅうおうしょうたい	中央招待
ちゅうおうしゅっぱん	中央出版
ちゅうおうしゅうけん	中央集権
ちゅうおうけいばかい	中央競馬会
ちゅうおうきげんてき	中央起源的
ちゅうおういいんかい	中央委員会
ちゅういりょくぶそく	注意力不足
ちゅういほうかいじょ	注意報解除
ちゃくりくちょくぜん	着陸直前
ちゃくりくしんにゅう	着陸進入
ちゃくだつじゅうたい	着脱渋滞
ちゃくしんにんばらい	着信人払い
ちゃくさいこうぞうが	着彩構造画
ちめいてきじゃくてん	致命的弱点
ちほうこうむいんほう	地方公務員法
ちほうけんさつちょう	地方検察庁
ちばけんえいてつどう	千葉県営鉄道
ちばいちりつこうこう	千葉市立高校
ちのうしょうがいしゃ	知能障害者
ちのうこうがくこうざ	知能工学講座
ちてきしょりしすてむ	知的処理システム
ちてきしょうがいしゃ	知的障害者
ちてきけいさんきしつ	知的計算機室
ちてきかつどうしえん	知的活動支援
ちじょうそうこうしゃ	地上走行車
ちじょうさくてきのう	地上索敵能
ちじょうこうげきよう	地上攻撃用
ちしきしょりこうがく	知識処理工学
ちしきしゅうやくてき	知識集約的
ちくじじどうへんかん	逐次自動変換
ちくさんしけんじょう	畜産試験場
ちきゅうれんぽうぐん	地球連邦軍
ちきゅうぼうえいぐん	地球防衛軍
ちきゅうぶつりがっか	地球物理学科
ちきゅうきょうつうご	地球共通語
ちきゅうきどうじょう	地球軌道上
ちきゅうがいせいめい	地球外生命
ちきゅうがいせいぶつ	地球外生物
ちかまつもんざえもん	近松門左衛門
ちかてつはくぶつかん	地下鉄博物館
ちかてつとうざいせん	地下鉄東西線
ちかてつつるまいせん	地下鉄鶴舞線
ちかてつたにまちせん	地下鉄谷町線
ちかてつあさしおばし	地下鉄朝潮橋
ちかちゅうしゃじょう	地下駐車場
たんぽせいきゅうけん	担保請求権
たんぶんせつへんかん	単文節変換
たんとうちょくにゅう	単刀直入
たんとうけんさつかん	担当検察官
たんちょうげんしょう	単調減少
たんたいろしゅつけい	単体露出計
たんそうさんせんしき	単相三線式
たんせんりつおんがく	単旋律音楽
たんじゅんしょうにん	単純承認
たんじゅんけいちょう	単純茎頂
たんじかんけっちゃく	短時間決着
たんしんふにんちゅう	単身赴任中
たんしようしょくぶつ	単子葉植物
たんしょうまんばけん	単勝万馬券
たんしょうひょうすう	単勝票数
たんさいぼうせいぶつ	単細胞生物
たんごとうろくきどう	単語登録起動
たんこうろうどうしゃ	炭鉱労働者
たんこうぼんけいしき	単行本形式
たんきょりじょうしゃ	短距離乗車
たんきじょうたつほう	短期上達法
たれつほうしゃそしき	多列放射組織
たまちえきひがしぐち	田町駅東口
たまがわせいがくいん	玉川聖学院
たまがわきょうりょう	多摩川橋梁
たへんりょうかいせき	多変量解析
たばこしょうひりょう	煙草消費量
たばいちょうえんざん	多倍長演算
たにくふじつかちょう	谷区藤塚町
たにかわしゅんたろう	谷川俊太郎
たてやまでらおんせん	舘山寺温泉
たてながへんけいばん	縦長変形版
たちいりきんしばしょ	立入禁止場所
たじゅうじんかくしゃ	多重人格者
たじゅうがぞうしょり	多重画像処理
たじゅういみこうぞう	多重意味構造
たしょうろうきゅうか	多少老朽化
たしゃせんはっちゃく	他社線発着
たこうしきぶんるいき	多項式分類器
たくまでんぱこうせん	詫間電波高専
たからづかみなみぐち	宝塚南口
たかゆかしきえきしゃ	高床式駅舎
たかはしせいさくしょ	高橋製作所
たかさきせんみやはら	高崎線宮原
たかさきせんほうめん	高崎線方面
たかおかせいさくしょ	高岳製作所
たいわけんきゅうかい	対話研究会
たいれんぽうこうさく	対連邦工作
たいりょくしょうもう	体力消耗
たいりょくこうじょう	体力向上
たいりょうはっちゅう	大量発注
たいりょうにゅうがく	大量入学
たいりょうとうにゅう	大量投入
たいりょうせいさんち	大量生産地
たいりょうこうにゅう	大量購入
たいりゅうちょうせつ	対流調節
たいらけいりんじょう	平競輪場
たいようしんけいそう	太陽神経叢
たいようこうはつでん	太陽光発電
たいようけいていこく	太陽系帝国
たいようけいぜんたい	太陽系全体
たいまとりしまりほう	大麻取締法
たいまけんきゅうしゃ	大麻研究者
たいべいゆしゅつよう	対米輸出用
たいへんきょうしゅく	大変恐縮
たいへいようでんてつ	太平洋電鉄
たいへいようせんそう	太平洋戦争
たいへいようおうふく	太平洋往復
たいへいようおうだん	太平洋横断
たいばつひつようろん	体罰必要論
たいちこうげきりょく	対地攻撃力
たいせんがたきょうぎ	対戦型競技
たいせんがたかくとう	対戦型格闘
たいせいようかんたい	大西洋艦隊
たいせいしんこうげき	対精神攻撃
たいじゅうしんちょう	体重身長
たいしょくぼうしざい	褪色防止剤
たいしょくきんきてい	退職金規定
たいしょうりょうほう	対象療法	対症療法
たいしょうりょういき	対象領域
たいしょうちいきない	対象地域内
たいしょうすうりょう	対象数量
たいしょうじどうしゃ	対象自動車
たいしょうしゅうだん	対象集団
たいしょうしゃりょう	対象車両
たいしょうぎょうれつ	対称行列
たいしゅうてきにんき	大衆的人気
たいしゅうだいひょう	大衆代表
たいしゅうしょくどう	大衆食堂
たいしゃせいさんぶつ	代謝生産物
たいしでんきてつどう	大師電気鉄道
たいしかんりょうじぶ	大使館領事部
たいざいきかんちゅう	滞在期間中
たいざいがたりょこう	滞在型旅行
たいさくきょうぎかい	対策協議会
たいこうしゃせんがわ	対向車線側
たいけいてきちくせき	体系的蓄積
たいきぶんれつそしき	待機分裂組織
たいきだいじゅんかん	大気大循環
たいきおせんたいさく	大気汚染対策
たいかくせんろんぽう	対角線論法
たいかいしゅつじょう	大会出場
たいかいきかんちゅう	大会期間中
たいかいいいんちょう	大会委員長
たいおんじょうしょう	体温上昇
たいおうじょうきょう	対応状況
たいおうかじゅういき	対応荷重域
たいいんたいようれき	太陰太陽暦
たいいくかいがくせい	体育会学生
とりたていにんうらがき	取立委任裏書
とりあつかいしょうひん	取扱商品
とりあつかいかくちょう	取扱拡張
とやまけんりつだいがく	富山県立大学
とどうふけんじょうれい	都道府県条例
とっきゅうがたでんしゃ	特急型電車
とちゅうえきそうごかん	途中駅相互間
とちゅうえきじょうこう	途中駅乗降
としまおかじょがくえん	豊島岡女学園
とくべつようしえんぐみ	特別養子縁組
とくべつこうろうしょう	特別功労賞
とくべつこうてきかんり	特別公的管理
とくべつけんきゅうしつ	特別研究室
とくべつけんきゅういん	特別研究員
とくべつかさんうんちん	特別加算運賃
とくていしょこくいがい	特定諸国以外
とくていうんちんくかん	特定運賃区間
とくちょうちゅうしゅつ	特徴抽出
とくちょうしゅうはすう	特徴周波数
とくせいきょくせんぐん	特性曲線群
とくしゅきんいつくかん	特殊均一区間
とうよこせんしぶやえき	東横線渋谷駅
とうよこせんきくなえき	東横線菊名駅
とうようでんきせいぞう	東洋電機製造
とうようしそういっぱん	東洋思想一般
とうめいじどうしゃどう	東名自動車道
とうめいこうそくどうろ	東名高速道路
とうほくだいがくしんさ	東北大学審査
とうほくせんうえのぐち	東北線上野口
とうほくじどうしゃどう	東北自動車道
とうほくこうぎょうだい	東北工業大
とうほうとくさつえいが	東宝特撮映画
とうほうせいきょうかい	東方正教会
とうほうじょしこうこう	桐朋女子高校
とうほうけいげきじょう	東宝系劇場
とうぶどうぶつこうえん	東武動物公園
とうぶでんたつかんすう	頭部伝達関数
とうひょうはんたいしゃ	投票反対者
とうひょうたちあいにん	投票立会人
とうひょうしゅうりょう	投票終了
とうひょうしゃぜんいん	投票者全員
とうひょうしゃいちらん	投票者一覧
とうひょうけっかどおり	投票結果通り
とうひょうきかんちゅう	投票期間中
とうひょうかんりきかん	投票管理機関
とうちょうぼうしきのう	盗聴防止機能
とうちゃくじこくじゅん	到着時刻順
とうだいでんしこうがく	東大電子工学
とうだいじょうほうこう	東大情報工
とうだいしゅっぱんかい	東大出版会
とうだいしゅっしんしゃ	東大出身者
とうだいけいざいがくぶ	東大経済学部
とうじょうせんけいとう	東上線系統
とうじょうじんぶつめい	登場人物名
とうじょうじんぶつたち	登場人物達
とうじつとうちゃくぶん	当日到着分
とうじつかいじょうまえ	当日会場前
とうしょうかぶかしすう	東証株価指数
とうしゅうさいしゃらく	東洲斎写楽
とうしじぎょうくみあい	投資事業組合
とうししんたくがいしゃ	投資信託会社
とうざいりょうよこづな	東西両横綱
とうざいせんりようしゃ	東西線利用者
とうざいせんちょくつう	東西線直通
とうざいじょうもんじん	東西縄文人
とうさんほうしゅつひん	倒産放出品
とうごうてきけんきゅう	統合的研究
とうこうろんぶんいがい	投稿論文以外
とうこうりょうちょうさ	投稿量調査
とうこうだいすうがっか	東工大数学科
とうこうだいじょうこう	東工大情工
とうけいてきゆういせい	統計的有意性
とうけいてきていじょう	統計的定常
とうけいがくてきもでる	統計学的モデル
とうきょうりかだいがく	東京理科大学
とうきょうはつそくたつ	東京発速達
とうきょうのうこうだい	東京農工大
とうきょうとしょくいん	東京都職員
とうきょうとうぼうしゃ	東京逃亡者
とうきょうてんもんだい	東京天文台
とうきょうちゅうしんぶ	東京中心部
とうきょうちゅうおうぶ	東京中央部
とうきょうだいがくりか	東京大学理科
とうきょうだいがくせい	東京大学生
とうきょうたんていだん	東京探偵団
とうきょうたいいくかん	東京体育館
とうきょうそうげんしゃ	東京創元社
とうきょうすいさんだい	東京水産大
とうきょうじょがっかん	東京女学館
とうきょうじぎょうしょ	東京事業所
とうきょうしんぶんはい	東京新聞杯
とうきょうしゅっちょう	東京出張
とうきょうけいばじょう	東京競馬場
とうきょうきゅうじょう	東京球場
とうきょうがくげいだい	東京学芸大
とうきょうおおさかかん	東京大阪間
とうきょうえきだいまる	東京駅大丸
とうきゅうひゃっかてん	東急百貨店
とうきゅうとうよこてん	東急東横店
とうきゅうとうよこせん	東急東横線
とうきゅうせんえんせん	東急線沿線
とうきゅういけがみせん	東急池上線
とうがいしゅっぱんけん	当該出版権
とうがいけんきゅうかい	当該研究会
とうかしほんかいしゅう	投下資本回収
とうかいどうせんふつう	東海道線不通
とうかいどうせんのぼり	東海道線上り
とうかいどうせんとつか	東海道線戸塚
とうかいどうかもつせん	東海道貨物線
とうかいじょしだいがく	東海女子大学
とうかいじどうしゃどう	東海自動車道
てんりゅうはちぶしゅう	天竜八部衆
てんようたいしゅうやく	転用大衆薬
てんもんがくじょうほう	天文学情報
てんのうようごはつげん	天皇擁護発言
てんのうはいけっしょう	天皇杯決勝
てんのうじどうぶつえん	天王寺動物園
てんのうじすいぞっかん	天王寺水族館
てんたいぼうえんきょう	天体望遠鏡
てんたいうちゅうぶつり	天体宇宙物理
てんじかいしゅさいしゃ	展示会主催者
てんしんしはんだいがく	天津師範大学
てんあんもんひろばまえ	天安門広場前
てつどうりょこうじゅつ	鉄道旅行術
てつどうじぎょうようち	鉄道事業用地
てつどうけんきゅうかい	鉄道研究会
てつどうえいぎょうほう	鉄道営業法
てきようたいしょうがい	適用対象外
てきようきせいないよう	適用規制内容
てきたいてきばいしゅう	敵対的買収
てきおうしんごうしょり	適応信号処理
ていれいきょうじゅかい	定例教授会
ていりょうてきしひょう	定量的指標
ていりょうてきけいさん	定量的計算
ていちゃくしょりじかん	定着処理時間
ていそくかいせんじょう	低速回線上
ていじょうかんきょうか	定常環境下
ていじょううちゅうろん	定常宇宙論
ていしょうひでんりょく	低消費電力
ていこくしゅぎだんかい	帝国主義段階
ていいんさんしゅつほう	定員算出法
ていあんりゆうせつめい	提案理由説明
つるがおかはちまんぐう	鶴岡八幡宮
つくばだいがくせいぶつ	筑波大学生物
つくばぎじゅつたんだい	筑波技術短大
つうじょうりゅうにゅう	通常流入
つうしんはんばいいがい	通信販売以外
つうしんこうがくこうざ	通信工学講座
つうしんけんきゅうしょ	通信研究所
つうしんがたじゅしんき	通信型受信機
つうしんかいせんりろん	通信回線理論
つうがくしょうめいしょ	通学証明書
つうかれっしゃせってい	通過列車設定
つうかれっしゃうんてん	通過列車運転
ついせきちょうさかのう	追跡調査可能
ちょっこうざひょうけい	直交座標系
ちょっこうかんすうけい	直交関数系
ちょっかんてきほうほう	直観的方法	直感的方法
ちょっかんしゅぎろんり	直観主義論理
ちょっかんしゅぎじょう	直観主義上
ちょっかくさんかっけい	直角三角形
ちょさくぶつりゅうつう	著作物流通
ちょさくけんぽうじょう	著作権法上
ちょさくけんほうきせい	著作権法規制
ちょさくけんたいしょう	著作権対象
ちょさくけんきょうかい	著作権協会
ちょくりゅうはつでんき	直流発電機
ちょくりゅうでんりゅう	直流電流
ちょくりゅうきかんしゃ	直流機関車
ちょくつうじゅんきゅう	直通準急
ちょくせつみんしゅせい	直接民主制
ちょくせつにゅうりょく	直接入力
ちょくせつせんきょせい	直接選挙制
ちょくしんじどうにりん	直進自動二輪
ちょくしんあんていせい	直進安定性
ちょうりつしきょうかい	調律師協会
ちょうゆうめいばんぐみ	超有名番組
ちょうへいれつけいさん	超並列計算
ちょうでんどうじしゃく	超電導磁石
ちょうせんだいがっこう	朝鮮大学校
ちょうせんじんがっこう	朝鮮人学校
ちょうせんしゃけってい	挑戦者決定
ちょうせいじょうきょう	調整状況
ちょうじょうのうりょく	超常能力
ちょうじょうげんしょう	超常現象
ちょうじょうきゅうしゃ	超上級者
ちょうしゅりつちょうさ	聴取率調査
ちょうこうそくのうこう	超高速濃厚
ちょうこうそくこうほう	超光速航法
ちょうこうそくこうこう	超光速航行
ちょうこうそくかいてん	超高速回転
ちょうこうそくおおがた	超高速大型
ちょうこうきゅうきしゅ	超高級機種
ちょうこうかいてんがた	超高回転型
ちょうきょりりょうきん	長距離料金
ちょうきょりせんとうき	長距離戦闘機
ちょうきょりじゅんこう	長距離巡行
ちょうきょだいせんしゃ	超巨大戦車
ちょうきょだいうちゅう	超巨大宇宙
ちょうききゅうようあけ	長期休養明
ちょうかくしょりきこう	聴覚処理機構
ちょうおんぱはっせいき	超音波発生機
ちょうおんぱせんじょう	超音波洗浄
ちょうおんそくせいのう	超音速性能
ちょうおおがたけいさん	超大型計算
ちょういちりゅうほてる	超一流ホテル
ちゅうりゅうかいきゅう	中流階級
ちゅうぶにほんほうそう	中部日本放送
ちゅうなんべいしょこく	中南米諸国
ちゅうどくしょうじょう	中毒症状
ちゅうとうわへいかいぎ	中東和平会議
ちゅうちゅうごくたいし	駐中国大使
ちゅうせんきょくせいど	中選挙区制度
ちゅうせいしせいじょう	中性子星上
ちゅうすうしんけいけい	中枢神経系
ちゅうじょうきゅうしゃ	中上級者
ちゅうしんてきそんざい	中心的存在
ちゅうしんてきかつどう	中心的活動
ちゅうしんせんほうこう	中心線方向
ちゅうしんしゅうはすう	中心周波数
ちゅうしょくきゅうけい	昼食休憩
ちゅうしょうとしょかん	中小図書館
ちゅうしょうでーたがた	抽象データ型
ちゅうしょうてきしこう	抽象的思考
ちゅうしょうこうぶんぎ	抽象構文木
ちゅうしょうげいじゅつ	抽象芸術
ちゅうしょうかいしゃく	抽象解釈
ちゅうしゃじょうきょう	駐車状況
ちゅうしゃじょうかくほ	駐車場確保
ちゅうしゃきょかしょう	駐車許可証
ちゅうごくりょこうしゃ	中国旅行社
ちゅうごくみんかんじん	中国民間人
ちゅうごくじんがくせい	中国人学生
ちゅうごくこくみんとう	中国国民党
ちゅうこしじょうかかく	中古市場価格
ちゅうこうあいぞうばん	中公愛蔵版
ちゅうけいしゅうりょう	中継終了
ちゅうきんとうしょこく	中近東諸国
ちゅうきょうだいとよた	中京大豊田
ちゅうがくせいいじょう	中学生以上
ちゅうかんほうこくてき	中間報告的
ちゅうかんほうこくしょ	中間報告書
ちゅうかんしゅうはすう	中間周波数
ちゅうかんかんりしょく	中間管理職
ちゅうかこくみんせいふ	中華国民政府
ちゅうかいてすうりょう	仲介手数料
ちゅうおうりんかんえき	中央林間駅
ちゅうおうせんかいそく	中央線快速
ちゅうおうせんえんせん	中央線沿線
ちゅうおうせいぎょがた	中央制御型
ちゅうおうしんかんせん	中央新幹線
ちゅうおうしょりそうち	中央処理装置
ちゅうおうしょうちょう	中央省庁
ちゅうおうしょうぎょう	中央商業
ちゅうおうこうろんしゃ	中央公論社
ちゅうおうこうぞうせん	中央構造線
ちゅうおうけいばじょう	中央競馬場
ちゅうおうけいばいがい	中央競馬以外
ちゅうおうかんこうせん	中央緩行線
ちゅうおうかいそくせん	中央快速線
ちゃくじゅんはっぴょう	着順発表
ちゃくじゅんけいじばん	着順掲示板
ちほうこくりつだいがく	地方国立大学
ちほうこうえいきぎょう	地方公営企業
ちほうぎょうせいきかん	地方行政機関
ちばこうぎょうだいがく	千葉工業大学
ちのうじょうほうしょり	知能情報処理
ちてきふごうかつうしん	知的符号化通信
ちてきじょうほうしょり	知的情報処理
ちてきしょりけいさんき	知的処理計算機
ちてきさぎょうのうりつ	知的作業能率
ちじょうぼうえんきょう	地上望遠鏡
ちじょうせんとつにゅう	地上戦突入
ちしきひょうげんじょう	知識表現上
ちしきとうかつやくいん	知識統括役員
ちしきたんとうやくいん	知識担当役員
ちしきじょうほうしょり	知識情報処理
ちしきしっこうやくいん	知識執行役員
ちくじてきおうせいぎょ	逐次適応制御
ちきゅうわくせいぶつり	地球惑星物理
ちきゅうちゅうしんかく	地球中心核
ちきゅうじゆうしんどう	地球自由振動
ちきゅうかんきょうてき	地球環境的
ちかてつれんらくつうろ	地下鉄連絡通路
ちかてつめいじょうせん	地下鉄名城線
ちかてつひがしやません	地下鉄東山線
ちかてついけぶくろえき	地下鉄池袋駅
ちおりゅうさんしおるい	チオ硫酸塩類
ちいきげんていはつばい	地域限定発売
ちいきかいはつたんとう	地域開発担当
たんれつほうしゃそしき	単列放射組織
たんまつにゅうりょくじ	端末入力時
たんぺんけっさくしゅう	短編傑作集
たんとうへんしゅうしゃ	担当編集者
たんじゅんちょうぼいん	単純長母音
たんごおんせいにんしき	単語音声認識
たんきしゅうちゅうがた	短期集中型
たんいつだいにゅうそく	単一代入則
たにまちきゅうちょうめ	谷町九丁目
たにざきじゅんいちろう	谷崎潤一郎
たてやまさぼうてつどう	立山砂防鉄道
たちせきとっきゅうけん	立席特急券
たせんりゃくがくしゅう	多戦略学習
たじゅうろしゅつきこう	多重露出機構
たしゅたようたいりょう	多種多様大量
たくはいびんりょうきん	宅配便料金
たくはいびんぎょうしゃ	宅配便業者
たくはいそうりょうこみ	宅配送料込
たきのがわじょがくえん	瀧野川女学園
たきかんけんきゅうしゃ	他機関研究者
たかんちゅうしんちゅう	多環中心柱
たかさごえきりようしゃ	高砂駅利用者
たいりょうゆそうきかん	大量輸送機関
たいりょうはかいへいき	大量破壊兵器
たいりょうにゅうりょく	大量入力
たいりょうせいさんひん	大量生産品
たいりょうしぼうじけん	大量死亡事件
たいようねつおんすいき	太陽熱温水器
たいようでんちはつでん	太陽電池発電
たいようけいいっしゅう	太陽系一周
たいふうせっきんちゅう	台風接近中
たいちょうふじゅうぶん	体調不十分
たいすうじくひょうげん	対数軸表現
たいじんきょうふしょう	対人恐怖症
たいしょくきんかんけい	退職金関係
たいしゅうかんしょてん	大修館書店
たいしゅうえんげきふう	大衆演劇風
たいこうちょくしんしゃ	対向直進車
たいけいてきじょうほう	体系的情報
たいきゅうせんしゅけん	耐久選手権
たいきゅうしょうひざい	耐久消費財
たいきおせんぼうしほう	大気汚染防止法
たいかいしゅうりょうご	大会終了後
たいいくがくけんきゅう	体育学研究
たいいききょくしょうち	大域極小値
とりしまりやくしゃちょう	取締役社長
とりあつかいせつめいしょ	取扱説明書
とよだこうぎょうだいがく	豊田工業大学
とっぱつてきじょうしょう	突発的上昇
とっとりぎじゅつかいはつ	鳥取技術開発
とっきょしゅつがんちゅう	特許出願中
とっきゅうようしゃりょう	特急用車両
とっきゅうがたしゃりょう	特急型車両
としょかんれんじょうほう	図書関連情報
としょかんじょうほうだい	図書館情報大
としょかんじょうほうがく	図書館情報学
としまおかじょしがくえん	豊島岡女子学園
とくりつちゅうおうたいざ	特立中央胎座
とくべつりょうきんふよう	特別料金不要
とくべつこうとうけいさつ	特別高等警察
とくていしょうでんりょく	特定小電力
とくていきんせんしんたく	特定金銭信託
とくせんひょうじゅんまい	特選標準米
とくしゅそうたいろんてき	特殊相対論的
とくいてきていこうりょく	特異的抵抗力
とえいちょくつうれっしゃ	都営直通列車
とうろくもうしこみようし	登録申込用紙
とうろくうけつけぎょうむ	登録受付業務
とうようこうそくてつどう	東葉高速鉄道
とうめいよこはまほうめん	東名横浜方面
とうほくだいがくつうけん	東北大学通研
とうほくがくいんだいがく	東北学院大学
とうほうがくえんだいがく	桐朋学園大学
とうほうがくえんたんだい	東邦学園短大
とうびょうせいかつちゅう	闘病生活中
とうひょうはんたいひょう	投票反対票
とうひょうしゅうりょうご	投票終了後
とうひょうしゃかくこじん	投票者各個人
とうひょうきょひうんどう	投票拒否運動
とうちょうぼうしたいさく	盗聴防止対策
とうだいめいよきょうじゅ	東大名誉教授
とうだいせんぱくかいよう	東大船舶海洋
とうだいじょうほうかがく	東大情報科学
とうだいごうかくしゃすう	東大合格者数
とうだいきょうようぶつり	東大教養物理
とうだいきょういくしんり	東大教育心理
とうじつけしいんゆうこう	当日消印有効
とうごうばくりょうかいぎ	統合幕僚会議
とうごうしっちょうしょう	統合失調症
とうけいぶんぷてきかてい	統計分布的仮定
とうきょうわんいっしゅう	東京湾一周
とうきょうぶんかこうこう	東京文化高校
とうきょうぶんかかいかん	東京文化会舘	東京文化会館
とうきょうどうしゅっぱん	東京堂出版
とうきょうとりつだいがく	東京都立大学
とうきょうでんしせっけい	東京電子設計
とうきょうでんきだいがく	東京電機大学
とうきょうちょっこうびん	東京直行便
とうきょうだいくうしゅう	東京大空襲
とうきょうたいざいじかん	東京滞在時間
とうきょうじょしだいがく	東京女子大学
とうきょうじょしがくいん	東京女子学院
とうきょうこうぎょうだい	東京工業大
とうきょうこうかだいがく	東京工科大学
とうきょうかせいだいがく	東京家政大学
とうきょうかがくどうじん	東京化学同人
とうきょうえきみなみぐち	東京駅南口
とうきゅうさんげんじゃや	東急三軒茶屋
とうきゅうおおいまちせん	東急大井町線
とうきゅうおおいまちえき	東急大井町駅
とうがいしょうぎょうよう	当該商業用
とうかいどうせんえんせん	東海道線沿線
とうかいどうしんかんせん	東海道新幹線
とうかいだいかいはつこう	東海大開発工
とうおうしゃかいたいせい	東欧社会体制
てんのうしょうきょうそう	天皇賞競走
てつどうじぎょうめんきょ	鉄道事業免許
てつどうしゃりょうもけい	鉄道車両模型
てつどうけんせつこうだん	鉄道建設公団
てきおうきょうめいりろん	適応共鳴理論
ていりょうてきひょうかち	定量的評価値
ていとうけんせっていしゃ	抵当権設定者
ていでんりゅうじゅうでん	定電流充電
ていせんきょうていいはん	停戦協定違反
ていじょうさいさうんどう	定常才差運動
ていしゅうはしゅつりょく	低周波出力
つくばだいがくちゅうおう	筑波大学中央
つうしんようでんしぶつり	通信用電子物理
つうしんはんばいがいしゃ	通信販売会社
つうしんそうちけんきゅう	通信装置研究
つうしんかぶしきがいしゃ	通信株式会社
つうさんしょうこうぎいん	通産省工技院
つうきんとくべつかいそく	通勤特別快速
ちょっかんしゅぎすうがく	直観主義数学
ちょさくりんせつけんしゃ	著作隣接権者
ちょさくしゃじんかくけん	著作者人格権
ちょさくしゃざいさんけん	著作者財産権
ちょさくけんほうぜんぶん	著作権法全文
ちょさくけんしようりょう	著作権使用料
ちょさくけんしょゆうしゃ	著作権所有者
ちょくりゅうでんかくかん	直流電化区間
ちょくりゅうがわでんあつ	直流側電圧
ちょくつうかもつうんてん	直通貨物運転
ちょくせつみんしゅしゅぎ	直接民主主義
ちょくせつふつうせんきょ	直接普通選挙
ちょくせつひかくけんとう	直接比較検討
ちょくせつてきえいきょう	直接的影響
ちょくせつせいきゅうけん	直接請求権
ちょくせつがぞうしんごう	直接画像信号
ちょきんしゃっきんひょう	貯金借金表
ちょうりんかいりゅうたい	超臨界流体
ちょうへいれつけいさんき	超並列計算機
ちょうのうりょくばんぐみ	超能力番組
ちょうのうりょくかいめい	超能力解明
ちょうのうりょくかいはつ	超能力開発
ちょうたんぶんれつそしき	頂端分裂組織
ちょうせんはんとうなんぶ	朝鮮半島南部
ちょうせんしゅっしんしゃ	朝鮮出身者
ちょうじゅしょうこうぐん	長寿症候群
ちょうじゅうりょくりろん	超重力理論
ちょうさとうけいしりょう	調査統計資料
ちょうこうれいかしゃかい	超高齢化社会
ちょうきれんさいさくひん	長期連載作品
ちょうきょりつうかきゃく	長距離通過客
ちょうきょりこくさいせん	長距離国際線
ちょうきょりこうそくどう	長距離高速道
ちょうかくまっしょうけい	聴覚末梢系
ちょうかくてきいんしょう	聴覚的印象
ちょうかくしょうがいしゃ	聴覚障害者	聴覚障碍者
ちょうかくけんきゅうしゃ	聴覚研究者
ちょうかくけんきゅうしつ	聴覚研究室
ちょうえつろんてきろんり	超越論的論理
ちょういちりゅうりょかん	超一流旅館
ちゅうりょうゆそうきかん	中量輸送機関
ちゅうぶにっぽんほうそう	中部日本放送
ちゅうどくしゃぞくしゅつ	中毒者続出
ちゅうてんれんけつていり	中点連結定理
ちゅうちょうきょりろせん	中長距離路線
ちゅうせいしかじょうかく	中性子過剰核
ちゅうしょうてきはんだん	抽象的判断
ちゅうしょうてきがいねん	抽象的概念
ちゅうしゃじょうあんない	駐車場案内
ちゅうごくりゅうがくせい	中国留学生
ちゅうごくせんせいじゅつ	中国占星術
ちゅうごくせいふにんてい	中国政府認定
ちゅうごくじゅうかんどう	中国縦貫道
ちゅうごくじどうしゃどう	中国自動車道
ちゅうごくざんりゅうこじ	中国残留孤児
ちゅうごくごにゅうりょく	中国語入力
ちゅうごくごしょしんしゃ	中国語初心者
ちゅうごくきょうさんとう	中国共産党
ちゅうごくうんなんしょう	中国雲南省
ちゅうこしゃはんばいてん	中古車販売店
ちゅうこうとっきゅうしゃ	昼行特急車
ちゅうきょうけいばじょう	中京競馬場
ちゅうがたにりんめんきょ	中型二輪免許
ちゅうがくこうこうじだい	中学高校時代
ちゅうかんめいだいろんり	中間命題論理
ちゅうかんはっぴょうかい	中間発表会
ちゅうかんじゅつごろんり	中間述語論理
ちゅうかんしゅうはすうぶ	中間周波数部
ちゅうおうゆうびんきょく	中央郵便局
ちゅうおうひょうじゅんじ	中央標準時
ちゅうおうどうはちおうじ	中央道八王子
ちゅうおうじどうしゃどう	中央自動車道
ちゅうおうしゅうけんてき	中央集権的
ちゅうおうけんきゅうじょ	中央研究所
ちゅうおうけんきゅうしょ	中央研究所
ちゅうおうかんじょうせん	中央環状線
ちゃくばらいたくはいびん	着払宅配便
ちほうろうどういいんかい	地方労働委員会
ちほうこうきょうだんたい	地方公共団体
ちのうこうがくけんきゅう	知能工学研究
ちてきかんきょうこうちく	知的環境構築
ちしきひょうげんけいしき	知識表現形式
ちしきじょうほうこうがく	知識情報工学
たんとうへんしゅういいん	担当編集委員
たんしようしょくぶつこう	単子葉植物綱	Monocotyledoneae
たんしょうとうひょうすう	単勝投票数
たんしょうそうひょうすう	単勝総票数
たんこうぼんみしゅうろく	単行本未収録
たんこうぼんしゅうにゅう	単行本収入
たんこうほんみしゅうろく	単行本未収録
たんきしゅうちゅうこうざ	短期集中講座
たんおんせつめいりょうど	単音節明瞭度
たもくてきこうしゅうしつ	多目的講習室
たきのがわじょしがくえん	瀧野川女子学園
たからづかだいげきじょう	宝塚大劇場
たからずかだいげきじょう	宝塚大劇場
たかまつことひらてつどう	高松琴平鉄道
たいりょうはいきしゃかい	大量廃棄社会
たいようせいもうまくえん	太陽性網膜炎
たいようしんこうみんぞく	太陽信仰民族
たいようかつどうしゅうき	太陽活動周期
たいへいようせんそうまえ	太平洋戦争前
たいばんちゅうしゅつぶつ	胎盤抽出物
たいじゅうひじゅうりょう	体重比重量
たいしょうしゃしゅかんり	対象車種管理
たいきょようにゅうりょく	耐許容入力
たいきけんさいとつにゅう	大気圏再突入
たいいきてきかそうきおく	大域的仮想記憶
とんやせいかないこうぎょう	問屋制家内工業
とりしまりやくほんぶちょう	取締役本部長
とくべつちゅうかんかいさつ	特別中間改札
とくべつすいしんけんきゅう	特別推進研究
とくべつけんきゅうがくせい	特別研究学生
とくべつきゅうこうれっしゃ	特別急行列車
とうほくだいがくぶんがくぶ	東北大学文学部
とうほくだいがくびょういん	東北大学病院
とうほくだいがくせいきょう	東北大学生協
とうほくだいがくこうがくぶ	東北大学工学部
とうほくこうぎょうだいがく	東北工業大学
とうひょうひょうかきじゅん	投票評価基準
とうひょうしゅうりょうまえ	投票終了前
とうひょうしゅうりょうしゃ	投票終了者
とうちゃくれっしゃかんかく	到着列車間隔
とうだいじょうほうこうがく	東大情報工学
とうそくちょくせんうんどう	等速直線運動
とうせいれんしょうたんしき	頭制連勝単式
とうしばけんきゅうかいはつ	東芝研究開発
とうごうきょういくもんだい	統合教育問題
とうごうかいはつかんきょう	統合開発環境
とうきょうやまのてせんない	東京山手線内
とうきょうのうこうだいがく	東京農工大学
とうきょうにちにちしんぶん	東京日日新聞
とうきょうとすいどうきょく	東京都水道局
とうきょうとこうつうきょく	東京都交通局
とうきょうだいがくほんごう	東京大学本郷
とうきょうだいがくてんもん	東京大学天文
とうきょうだいがくせいさん	東京大学生産
とうきょうだいがくしゅうし	東京大学修士
とうきょうすいさんだいがく	東京水産大学
とうきょうしんがくだいがく	東京神学大学
とうきょうしょせきいんさつ	東京書籍印刷
とうきょうこくさいだいがく	東京国際大学
とうきょうこくさいくうこう	東京国際空港
とうきょうこうせいねんきん	東京厚生年金
とうきょうこうげいだいがく	東京工芸大学
とうきょうぎじゅつかいはつ	東京技術開発
とうきょうがくげいだいがく	東京学芸大学
とうきょういかしかだいがく	東京医科歯科大学
とうきゅうひゃっかてんまえ	東急百貨店前
とうきゅうしんたまがわせん	東急新玉川線
とうかせいはんていもんだい	等価性判定問題
てつどうこうあんしょくいん	鉄道公安職員
つうじょうこうかいてんいき	通常高回転域
つうしんもうけんきゅうしょ	通信網研究所
つうしょうさんぎょうしょう	通商産業省
ちょさくけんりょうしはらい	著作権料支払
ちょさくけんりょうさんてい	著作権料算定
ちょさくけんじょうもんだい	著作権上問題
ちょくれつきごうしょりけい	直列記号処理系
ちょくりゅうでんきてつどう	直流電気鉄道
ちょくせつはんばいじぎょう	直接販売事業
ちょうでんどうでんじしゃく	超伝導電磁石
ちょうせんはんとうぶんだん	朝鮮半島分断
ちょうせんしゃけっていせん	挑戦者決定戦
ちょうこうしゅうはつうしん	超高周波通信
ちょうこうきゅうりょうてい	超高級料亭
ちょうきしゅっちょうちゅう	長期出張中
ちょうかくじょうほうしょり	聴覚情報処理
ちょうおおぐちじぎょうしょ	超大口事業所
ちょうえいちゅうしゃじょう	町営駐車場
ちゅうとうふつうきょういく	中等普通教育
ちゅうちょうきてきてんぼう	中長期的展望
ちゅうじょうきゅうしゃよう	中上級者用
ちゅうしゃじょうりょうきん	駐車場料金
ちゅうしゃじょうかんきょう	駐車場環境
ちゅうごくぶっさんひんてん	中国物産品店
ちゅうごくちゅうおうせいふ	中国中央政府
ちゅうきょうじょしだいがく	中京女子大学
ちゅうがくにゅうしもんだい	中学入試問題
ちゅうがくにゅうがくとうじ	中学入学当時
ちゅうかんれべるがくしゅう	中間レベル学習
ちゅうおうしゅうちゅうがた	中央集中型
ちゅうおうけいばしょうたい	中央競馬招待
ちほうしょうたいきょうそう	地方招待競走
ちほうこうふぜいこうふきん	地方交付税交付金
ちきゅうわくせいぶつりがく	地球惑星物理学
たんじゅんしょうせんきょく	単純小選挙区
たんじくじょうかじくぶんし	単軸状仮軸分枝
たんきしゅうちゅうれんさい	短期集中連載
たにがわだけてんじんだいら	谷川岳天神平
たじゅうかいぞうどかいせき	多重解像度解析
たからづかしょうじょかげき	宝塚少女歌劇
たからずかしょうじょかげき	宝塚少女歌劇
たいようけいしょうてんたい	太陽系小天体
たいねつようせっちゃくざい	耐熱用接着剤
たいせんしゃぼしゅうちゅう	対戦者募集中
たいしゃくたいしょうひょう	貸借対照表
たいきだいじゅんかんもでる	大気大循環モデル
たいいきあっしゅくぎじゅつ	帯域圧縮技術
としょかんじょうほうだいがく	図書館情報大学
とくていほけんようしょくひん	特定保健用食品
とうきょうりっしょうこうこう	東京立正高校
とうきょうべいえぬけーほーる	東京ベイＮＫホール
とうきょうのうぎょうだいがく	東京農業大学
とうきょうだいがくものがたり	東京大学物語
とうきょうだいがくせいきょう	東京大学生協
とうきょうしょうせんだいがく	東京商船大学
とうきょうしょうがいとくべつ	東京障害特別
とうきょうこうぎょうだいがく	東京工業大学
とうきょうこうきょうがくだん	東京交響楽団
とうきょうきゅうこうでんてつ	東京急行電鉄
とうかいどうちゅうひざくりげ	東海道中膝栗毛
とうかいどうごじゅうさんつぎ	東海道五十三次
てんのうはいじゅんけっしょう	天皇杯準決勝
てっこつてっきんこんくりーと	鉄骨鉄筋コンクリート
てがきすうじにんしきもんだい	手書き数字認識問題
ていしゅつりょくこうひんしつ	低出力高品質
つつみちゅうなごんものがたり	堤中納言物語
つうしんきょういくきょうざい	通信教育教材
ちょっこうちょくせんざひょう	直交直線座標
ちょくこうりょうようでんしゃ	直交両用電車
ちょうこうそくだいようりょう	超高速大容量
ちょうおんぱつうしんこうがく	超音波通信工学
ちゅうごくきょうさんせいけん	中国共産政権
ちゅうがたじゃぐちちょっけつ	中型蛇口直結
ちゅうかじんみんきょうわこく	中華人民共和国
ちゅうおうろうどういいんかい	中央労働委員会
ちゅうおうじゅうてんそっこう	中央重点測光
ちゅうおうしゅうけんたいせい	中央集権体制
ちゅうおうしゅういきげんてき	中央周囲起源的
ちゅうおうけんきゅうじょまえ	中央研究所前
ちほうこうせいほごいいんかい	地方更生保護委員会
たじげんしゃくどこうせいほう	多次元尺度構成法
たいりょうこうにゅうわりびき	大量購入割引
とりつきょういくけんきゅうじょ	都立教育研究所
とよはしぎじゅつかがくだいがく	豊橋技術科学大学
とうきょうよみうりきょじんぐん	東京読売巨人軍
とうきょうげいじゅつげきじょう	東京芸術劇場
ちょっかんしゅぎめいだいろんり	直観主義命題論理
ちょうきこうはんいしんごうけい	長期広範囲信号系
ちゅうしょうきぎょうしんだんし	中小企業診断士
ちゅうしょうきぎょうきほんほう	中小企業基本法
ちゅうきょうだいがくきょうじゅ	中京大学教授
たんけいこうへきいけいさいぼう	短形厚壁異形細胞
たんおんせつめいりょうどしけん	単音節明瞭度試験
たいいきてきかそうかそうきおく	大域的仮想仮想記憶
とうきょうだいがくしゅっぱんかい	東京大学出版会
ていきょうぎじゅつかがくだいがく	帝京技術科学大学
ちょくりつほうしゃそしきさいぼう	直立放射組織細胞
ちゅうおうこうせいほごしんさかい	中央更生保護審査会
ちゅうおうだいがくすぎなみこうこう	中央大学杉並高校
たくしょくだいがくだいいちこうこう	拓殖大学第一高校
とうざいしゅうききょうかいじょうけん	東西周期境界条件
ちきゅうわくせいぶつりがくきょうしつ	地球惑星物理学教室
たんおんせつめいりょうどしけんけっか	単音節明瞭度試験結果
たいじんじらいぜんめんきんしじょうやく	対人地雷全面禁止条約
ちゅうしょうきぎょうちょうせんしえんほう	中小企業挑戦支援法
とうしじぎょうゆうげんせきにんくみあいほう	投資事業有限責任組合法
ちゅうしょうきぎょうとうきょうどうくみあい	中小企業等協同組合
とうほくだいがくでんきつうしんけんきゅうじょ	東北大学電気通信研究所
ちゅうしょうきぎょうとうきょうどうくみあいほう	中小企業等協同組合法
